Source,S_Port,Destination,D_Port,Packets,Bytes,Packets_sent,Bytes_sent,Packets_received,Bytes_received,Rel Start,Duration,Bits_sent_rate,Bits_received_rate,Label
172.30.6.255,57041,192.168.240.1,7680,3,198,3,198,0,0,1596.993566,9.00777,175.8481844,0,Benign
172.30.6.255,55638,35.186.249.84,80,86,67650,34,3483,52,64167,36.448377,22.16385,1257.182304,23160.95805,Benign
172.30.15.2348,51682,192.168.121.37,443,95,82309,34,3046,61,79263,5313.78717,4.092096,5954.894509,154958.2414,Benign
10.0.2.15,50719,119.254.87.201,80,11,1582,6,705,5,877,25327.81351,0.896225,6293.062568,7828.391308,Malicious
172.30.15.1555,50864,54.169.137.62,80,10,1888,6,998,4,890,3555.231347,1.830215,4362.329016,3890.253331,Benign
192.168.43.233,51299,172.217.161.3,443,23,2511,13,1522,10,989,2841.31955,189.778805,64.15890331,41.69064085,Benign
192.168.43.224,45036,172.82.254.215,443,43,17505,23,10108,20,7397,3267.270226,187.3583112,431.600816,315.8440083,Benign
10.0.2.15,34901,119.254.87.201,80,11,1579,6,705,5,874,12893.78299,4.160583,1355.579254,1680.533714,Malicious
10.0.2.15,52843,119.254.87.201,80,12,1653,7,779,5,874,9227.458667,4.429306,1406.992427,1578.57687,Malicious
172.30.6.255,56921,35.189.135.205,80,12,2433,7,1805,5,628,1386.697515,17.803342,811.0836718,282.1942083,Benign
172.30.15.1054,50360,157.240.16.39,443,7,402,4,228,3,174,3448.799706,8.348787,218.4748515,166.7308077,Benign
172.30.1.136,51524,40.77.226.13,443,29,14101,14,4225,15,9876,33.044414,135.406571,249.6186097,583.4871928,Benign
172.30.1.136,50423,74.125.24.188,5228,3,198,3,198,0,0,833.354728,9.001834,175.9641424,0,Benign
192.168.137.97,40450,104.17.161.9,443,22,6167,13,1323,9,4844,3521.181711,2.231335266,4743.348147,17367.17946,Benign
192.168.42.240,50956,13.35.130.15,443,289,172514,118,18951,171,153563,223.914223,71.921986,2107.95069,17081.06336,Benign
172.30.6.255,58391,216.58.196.162,80,59,16553,31,9286,28,7267,5526.256715,14.961871,4965.154425,3885.610296,Benign
10.0.2.15,50821,119.254.87.201,80,11,1585,6,705,5,880,19591.1819,2.044755,2758.276664,3442.955268,Malicious
192.168.43.224,57270,139.59.82.147,443,8,544,5,338,3,206,2571.251994,14.6962739,183.9922159,112.1372677,Benign
172.30.6.255,55606,172.217.166.197,443,2,108,2,108,0,0,2.582405,0.00014,0,0,Benign
172.30.6.255,58569,103.231.98.53,80,15,6261,8,5635,7,626,5879.859385,0.439768,102508.5954,11387.82267,Benign
192.168.215.49,44500,157.240.16.35,443,34,8266,18,2503,16,5763,118.2545935,66.29273213,302.0542276,695.4608524,Benign
192.168.137.97,36340,52.84.103.186,443,21,2297,16,1821,5,476,3757.631669,90.17843574,161.5463817,42.22739027,Benign
192.168.43.224,46280,52.20.114.147,443,37,8766,19,3015,18,5751,41.14842491,81.27422735,296.7730459,566.0835114,Benign
10.0.2.15,38750,119.254.87.201,80,11,1513,6,705,5,808,6769.765776,1.364587,4133.118665,4736.964371,Malicious
172.30.15.1907,51219,151.101.2.2,443,44,15773,21,3091,23,12682,3984.915637,2.363637,10461.84334,42923.68075,Benign
172.30.6.255,56295,52.212.77.226,80,6,348,4,228,2,120,569.160396,19.87842,91.75779564,48.29357665,Benign
192.168.137.97,36280,52.84.103.186,443,21,7396,12,1431,9,5965,3707.04186,0.928507158,12329.46876,51394.32646,Benign
172.30.15.1332,50640,52.220.69.147,443,18,6379,9,1761,9,4618,3489.868893,7.222709,1950.514689,5114.978327,Benign
172.30.15.1233,50541,42.125.207.29,80,11,1504,6,796,5,708,3468.47813,9.145553,696.294691,619.3173885,Benign
10.0.2.15,39641,119.254.87.201,80,11,1587,6,705,5,882,19654.07917,1.532897,3679.307873,4603.048998,Malicious
172.30.6.255,57534,210.176.156.62,80,14,5504,7,3896,7,1608,3133.859729,3.347926,9309.644239,3842.378834,Benign
10.0.2.15,37168,119.254.87.201,80,11,1579,6,705,5,874,8206.586913,1.355617,4160.467153,5157.798995,Malicious
10.0.2.15,55445,219.234.85.243,80,8,943,4,687,4,256,246.790003,0.620025,8864.158703,3303.092617,Malicious
172.30.1.136,50777,151.101.129.181,443,17,2441,9,1646,8,795,1921.487178,0.891245,14774.83745,7136.084915,Benign
172.30.15.1372,50680,209.191.163.213,443,6,348,4,228,2,120,3493.464521,3.902754,467.362278,245.9801463,Benign
10.0.2.15,38687,119.254.87.201,80,11,1582,6,705,5,877,17786.58195,0.823115,6852.019463,8523.717828,Malicious
192.168.215.49,37114,157.240.16.52,443,33,9333,16,2049,17,7284,634.2829749,65.15295282,251.5925877,894.3877058,Benign
10.0.2.15,42161,119.254.87.201,80,11,1582,6,705,5,877,1994.572163,1.907324,2957.022509,3678.452114,Malicious
172.30.6.255,58015,103.243.221.51,80,37,21077,20,8918,17,12159,4761.882547,12.165168,5864.612803,7995.943829,Benign
172.30.15.833,50134,52.84.108.149,443,15,4471,8,1437,7,3034,3200.183294,6.639324,1731.501581,3655.793873,Benign
10.0.2.15,44529,119.254.87.201,80,11,1579,6,705,5,874,21212.64335,1.442634,3909.515511,4846.690151,Malicious
192.168.43.233,50996,163.53.79.200,443,28,8313,14,1837,14,6476,514.181732,68.348602,215.0153708,757.996484,Benign
172.30.15.1078,50384,23.108.191.211,80,12,1401,7,928,5,473,3452.780868,6.42413,1155.642865,589.0291759,Benign
172.30.15.737,50025,157.240.16.52,443,43,23154,19,2014,24,21140,2495.830209,10.355702,1555.857826,16331.09952,Benign
172.30.6.255,58150,103.243.221.87,80,19,7345,10,5293,9,2052,4957.83744,1.244753,34017.99393,13188.15861,Benign
192.168.43.224,35264,205.185.216.10,443,7,410,4,236,3,174,106.5229509,55.774433,33.85063547,24.95767191,Benign
172.30.6.255,58231,172.217.166.206,443,39,6271,20,3783,19,2488,5182.407605,61.076254,495.5117254,325.887701,Benign
10.0.2.15,43625,119.254.87.201,80,11,1513,6,705,5,808,16315.04359,2.019614,2792.612846,3200.611602,Malicious
172.30.15.1527,50835,151.139.104.66,443,89,66112,38,3339,51,62773,3526.943991,0.992317,26918.81727,506072.1523,Benign
192.168.137.97,45512,108.177.12.94,443,20,6165,11,1521,9,4644,1948.657119,1.725926124,7050.127946,21525.83444,Benign
192.168.43.224,43192,185.199.109.153,80,29,4012,16,1542,13,2470,2602.744257,318.6276103,38.71604218,62.01596899,Benign
192.168.215.28,62395,157.240.16.11,443,17,1551,0,0,17,1551,661.5751315,398.5779721,0,31.13067171,Benign
10.0.2.15,37714,119.254.87.201,80,11,1579,6,705,5,874,10909.29345,1.89121,2982.217734,3697.10397,Malicious
172.30.15.534,49818,157.240.16.20,443,164,130921,64,4958,100,125963,2248.167073,7.926125,5004.210759,127137.031,Benign
192.168.137.97,36278,52.84.103.186,443,18,7234,10,1335,8,5899,3707.041803,14.15229776,754.6477738,3334.582186,Benign
172.30.6.255,57509,172.217.163.133,443,31,8359,17,5543,14,2816,3069.436787,70.732834,626.9224276,318.4942371,Benign
172.30.1.136,50300,52.213.11.166,443,31,12411,15,3178,16,9233,511.959128,8.161755,3115.016317,9050.014366,Benign
172.30.1.136,50676,172.217.161.14,443,29,7859,17,2785,12,5074,1804.192511,24.519538,908.6631241,1655.496119,Benign
10.0.2.15,58864,119.254.87.201,80,11,1579,6,705,5,874,2863.671901,0.944579,5970.914026,7402.239516,Malicious
172.30.6.255,57684,103.243.220.231,80,32,19003,16,9315,16,9688,3641.852507,37.168171,2004.941271,2085.225017,Benign
172.30.6.255,57007,103.243.221.51,80,24,14014,10,4551,14,9463,1497.851578,25.21335,1443.99693,3002.536355,Benign
192.168.43.233,51236,13.107.4.52,80,15,2781,9,843,6,1938,1632.552648,2.197873,3068.421151,7054.092752,Benign
172.30.6.255,56036,103.243.221.75,80,28,12556,14,6415,14,6141,252.845051,29.18047,1758.710535,1683.5918,Benign
192.168.215.49,46400,223.31.160.67,443,13,1606,7,1038,6,568,293.051678,17.23710462,481.7514417,263.6173592,Benign
192.168.137.97,56168,172.217.161.14,443,20,6925,11,1521,9,5404,342.076544,13.63432081,892.4536964,3170.82168,Benign
172.30.15.1004,50310,119.81.211.112,443,21,8278,12,2551,9,5727,3443.355585,3.707191,5504.976679,12358.68343,Benign
172.30.6.255,56578,176.34.147.227,443,56,14821,30,12113,26,2708,889.016559,261.224354,370.9608178,82.93254311,Benign
172.30.15.552,49836,23.56.26.209,443,22,8713,12,1817,10,6896,2252.764495,3.392636,4284.574001,16261.10199,Benign
10.0.2.15,37681,119.254.87.201,80,11,1513,6,705,5,808,15927.0602,0.930987,6058.08674,6943.168916,Malicious
10.0.2.15,49958,119.254.87.201,80,13,1730,8,853,5,877,10161.1051,10.172623,670.8201022,689.6942903,Malicious
192.168.43.224,50540,23.251.156.28,443,9,610,5,338,4,272,479.2825474,88.67914038,30.49195097,24.53790137,Benign
192.168.43.233,51239,54.152.236.192,443,26,8279,13,1963,13,6316,1539.733698,157.891027,99.46100357,320.0181857,Benign
172.30.6.255,56568,103.243.221.109,80,50,32843,25,17317,25,15526,887.913309,61.583068,2249.579381,2016.918027,Benign
10.0.2.15,54946,119.254.87.201,80,11,1513,6,705,5,808,2050.29006,2.02064,2791.194869,3198.98646,Malicious
192.168.137.97,50622,192.168.121.7,443,75,30602,45,14879,30,15723,2906.101486,16.62358632,7160.428422,7566.598298,Benign
192.168.215.49,42084,52.205.114.175,443,20,6586,12,2184,8,4402,612.2358557,7.309713229,2390.244248,4817.699258,Benign
10.0.2.15,48166,119.254.87.201,80,12,1659,7,779,5,880,6915.304546,4.220217,1476.701317,1668.160666,Malicious
192.168.137.97,37074,104.17.38.113,443,7,410,4,236,3,174,1767.496561,50.58746481,37.32149865,27.51669816,Benign
172.30.15.244,49513,23.198.126.238,443,17,6662,8,1324,9,5338,53.22302,0.671297,15778.41105,63614.1678,Benign
172.30.6.255,56841,115.114.126.194,443,294,207277,123,39320,171,167957,1338.777655,792.064432,397.1394085,1696.397346,Benign
192.168.43.233,51009,117.18.232.102,443,404,300970,185,13846,219,287124,546.791675,188.559255,587.4439841,12181.8046,Benign
10.0.2.15,47310,119.254.87.201,80,11,1582,6,705,5,877,19951.42341,1.421509,3967.614697,4935.600126,Malicious
172.30.6.255,56788,35.190.43.164,80,6,348,4,228,2,120,1253.869836,11.047358,165.1073496,86.89860508,Benign
192.168.43.224,46922,157.240.16.16,443,10,648,5,330,5,318,9.426099608,4.026016008,655.7350976,631.890185,Benign
192.168.43.224,53748,52.84.110.220,443,10,696,6,404,4,292,2921.439414,19.17208984,168.5783881,121.8437854,Benign
172.30.15.1258,50566,52.84.101.238,443,11,1405,7,958,4,447,3469.529572,7.42056,1032.806149,481.9043307,Benign
192.168.137.97,51454,157.240.16.17,443,167,97378,80,7515,87,89863,212.2981845,78.14009583,769.3873339,9200.193478,Benign
172.30.6.255,55769,195.201.82.80,80,13,2866,7,899,6,1967,62.26489,30.755776,233.8422545,511.6437316,Benign
172.30.15.416,49688,192.168.121.7,8080,191,180186,63,4603,128,175583,1590.232381,0.232662,158272.5155,6037358.916,Benign
172.30.15.2295,51623,172.217.166.196,443,18,3297,9,1424,9,1873,4923.37695,1.162985,9795.483175,12884.08707,Benign
192.168.43.224,58882,52.211.15.183,443,6,412,4,272,2,140,1635.731486,45.23802262,48.10112985,24.75793448,Benign
172.30.6.255,57135,172.217.166.206,443,17,1779,10,1150,7,629,1862.408745,67.764718,135.7638646,74.25693117,Benign
10.0.2.15,38474,119.254.87.201,80,12,1653,7,779,5,874,2080.317952,4.520488,1378.612221,1546.735662,Malicious
172.30.1.136,51806,172.217.160.227,443,11,642,6,348,5,294,2977.758545,36.242225,76.81647581,64.89667784,Benign
172.30.6.255,57367,103.243.221.17,80,59,40441,24,13747,35,26694,2580.864564,68.183654,1612.937904,3132.01167,Benign
172.30.6.255,57132,103.243.220.231,80,21,10656,10,4552,11,6104,1861.850642,14.181282,2567.891958,3443.412239,Benign
10.0.2.15,59042,119.254.87.201,80,11,1582,6,705,5,877,24126.4623,2.577702,2187.995354,2721.80415,Malicious
10.0.2.15,56782,119.254.87.201,80,11,1579,6,705,5,874,8241.271232,2.023005,2787.931814,3456.244547,Malicious
10.0.2.15,52256,119.254.87.201,80,11,1579,6,705,5,874,1512.042555,1.893898,2977.985087,3691.856689,Malicious
172.30.1.136,50451,157.240.16.20,443,3,198,3,198,0,0,857.412631,9.009229,175.8197067,0,Benign
10.0.2.15,49087,119.254.87.201,80,11,1579,6,705,5,874,20008.95992,1.781265,3166.289126,3925.300278,Malicious
172.30.6.255,58157,180.149.59.232,80,12,4895,8,3668,4,1227,4958.01919,0.892997,32860.13279,10992.19818,Benign
10.0.2.15,43331,119.254.87.201,80,11,1579,6,705,5,874,1209.350386,1.687939,3341.352975,4142.329788,Malicious
192.168.137.97,49714,104.237.191.1,443,49,10663,23,4566,26,6097,346.8044656,242.2618649,150.7789929,201.3358562,Benign
172.30.6.255,55719,104.36.113.23,80,7,402,4,228,3,174,57.574008,1.294263,1409.296256,1075.515564,Benign
172.30.15.578,49862,54.209.36.227,443,7,402,5,282,2,120,2260.918023,6.021152,374.6791312,159.4379282,Benign
172.30.6.255,56776,23.198.126.238,443,21,6611,10,1439,11,5172,1245.554959,1.536683,7491.460503,26925.52726,Benign
10.0.2.15,58011,119.254.87.201,80,11,1582,6,705,5,877,3762.26693,0.827221,6818.00873,8481.409442,Malicious
192.168.137.97,35642,151.101.193.69,443,28,7716,15,2231,13,5485,73.50344722,102.9537627,173.3593754,426.210746,Benign
10.0.2.15,34296,119.254.87.201,80,11,1579,6,705,5,874,8776.966426,1.966259,2868.391194,3555.991352,Malicious
172.30.15.1634,50944,184.29.25.7,443,62,47909,25,4305,37,43604,3575.537449,1.529169,22522.03648,228118.671,Benign
172.30.15.983,50289,87.248.118.23,443,30,13267,15,2935,15,10332,3442.682411,4.561354,5147.594333,18120.93514,Benign
172.30.6.255,57879,172.217.166.206,443,29,4548,16,3217,13,1331,4289.41429,60.798,423.3033981,175.13734,Benign
192.168.137.97,57760,23.111.9.35,443,11,682,6,364,5,318,0.480039838,15.86664038,183.5297158,160.3364001,Benign
172.30.15.765,50056,117.18.237.66,443,18,6710,10,1775,8,4935,2617.841807,8.390237,1692.443253,4705.468987,Benign
172.30.15.2352,51686,139.59.82.147,443,18,6891,10,1174,8,5717,5321.479151,6.2903,1493.092539,7270.877383,Benign
192.168.43.233,50954,104.20.23.135,80,54,36819,25,2451,29,34368,467.144937,8.948181,2191.283346,30726.24481,Benign
192.168.215.49,50458,172.217.161.14,443,58,12022,30,4314,28,7708,1399.954685,261.2399076,132.1084528,236.0435684,Benign
172.30.6.255,57792,103.243.221.46,80,17,5569,9,4288,8,1281,4041.849649,23.216754,1477.553667,441.4053748,Benign
192.168.43.233,51242,52.84.110.84,443,978,347774,447,87088,531,260686,1672.039924,1165.119059,597.9680743,1789.93553,Benign
192.168.43.224,46102,54.85.84.151,443,3,186,2,132,1,54,9.425938893,3.938511246,268.121616,109.6861156,Benign
192.168.43.233,51239,52.84.108.201,443,13551,11494839,5609,331791,7942,11163048,1634.691709,843.259259,3147.700985,105903.8286,Benign
172.30.15.2380,51714,14.139.45.128,80,11,1837,6,1094,5,743,5334.678148,0.940883,9301.900449,6317.469866,Benign
10.0.2.15,52290,119.254.87.201,80,11,1569,6,705,5,864,19564.01323,1.545777,3648.650485,4471.537615,Malicious
192.168.43.224,42024,23.251.156.28,443,16,1816,9,1178,7,638,1358.660232,20.34461562,463.2183855,250.8771901,Benign
172.30.6.255,58203,157.240.16.17,443,2230,1970995,868,54572,1362,1916423,5125.7982,38.178719,11435.06151,401568.8426,Benign
192.168.43.233,51523,13.107.3.254,443,52,18467,29,3428,23,15039,3962.052734,12.742971,2152.088394,9441.440305,Benign
172.30.6.255,56902,52.202.222.55,80,11,2289,6,1705,5,584,1385.360621,32.691039,417.2397213,142.9137814,Benign
192.168.43.224,58402,49.44.90.17,443,78,31310,43,5289,35,26021,9.412972718,126.3993251,334.7486227,1646.907527,Benign
192.168.43.224,35046,34.232.42.95,443,47,30613,24,4369,23,26244,3040.471022,3.902527366,8956.247253,53798.98212,Benign
172.30.1.136,50301,52.213.11.166,443,9,522,5,282,4,240,511.959463,21.37531,105.542329,89.8232587,Benign
10.0.2.15,56581,119.254.87.201,80,11,1582,6,705,5,877,18810.23664,1.458925,3865.860137,4809.02034,Malicious
192.168.215.49,47318,173.241.248.143,443,29,6227,16,2400,13,3827,612.7380851,67.90375778,282.7531292,450.8734273,Benign
172.30.15.488,49766,172.25.10.63,7680,3,198,3,198,0,0,1801.25912,9.014999,175.7071742,0,Benign
172.30.15.1118,50426,180.149.59.136,80,87,74241,33,3444,54,70797,3458.277476,8.754625,3147.136514,64694.49006,Benign
192.168.137.97,59192,18.210.21.97,443,9,626,6,412,3,214,8284.357942,13.0280801,252.9919968,131.4084643,Benign
192.168.137.97,37830,104.244.42.195,443,124,17998,64,7708,60,10290,147.1202619,1124.845402,54.81997784,73.18339023,Benign
192.168.43.224,45150,157.240.16.35,443,11,765,5,330,6,435,16.06740558,18.90639485,139.6352939,184.0647055,Benign
10.0.2.15,38793,119.254.87.201,80,12,1653,7,779,5,874,19798.7264,4.655113,1338.743012,1502.004355,Malicious
10.0.2.15,35882,119.254.87.201,80,11,1582,6,705,5,877,220.752358,1.841725,3062.346442,3809.472098,Malicious
172.30.15.2356,51690,52.114.88.20,443,20,7926,11,3232,9,4694,5321.899151,1.848427,13988.10989,20315.65217,Benign
10.0.2.15,49753,119.254.87.201,80,11,1582,6,705,5,877,5866.609311,1.686368,3344.465739,4160.420501,Malicious
10.0.2.15,45965,119.254.87.201,80,11,1582,6,705,5,877,13011.37078,2.309308,2442.290071,3038.139564,Malicious
172.30.15.1281,50589,192.229.237.25,443,16,5669,10,1219,6,4450,3469.556195,7.393684,1318.963591,4814.92041,Benign
172.30.6.255,57911,172.217.166.195,443,55,9740,25,3096,30,6644,4435.559876,282.707745,87.60990966,188.0104134,Benign
10.0.2.15,54196,119.254.87.201,80,11,1582,6,705,5,877,19888.84855,1.380926,4084.215954,5080.648782,Malicious
172.30.6.255,56560,157.240.16.16,443,62,7750,29,4283,33,3467,867.62879,316.648287,108.2083858,87.59245238,Benign
172.30.15.343,49611,172.217.31.14,443,16,5606,8,1219,8,4387,1064.682116,5.475461,1781.03725,6409.688609,Benign
192.168.43.224,36172,104.244.42.67,443,14,980,9,618,5,362,38.06370509,13.80548208,358.1186062,209.7717402,Benign
10.0.2.15,53881,119.254.87.201,80,11,1579,6,705,5,874,5924.240311,1.642569,3433.64571,4256.746596,Malicious
10.0.2.15,56602,119.254.87.201,80,11,1513,6,705,5,808,8421.462792,1.086629,5190.36396,5948.672454,Malicious
172.30.6.255,57016,103.243.221.51,80,19,9626,9,4216,10,5410,1522.839301,12.092383,2789.193826,3579.11257,Benign
192.168.137.97,57320,104.244.42.65,443,69,11235,36,3405,33,7830,289.6069502,900.2873482,30.25700634,69.5777855,Benign
10.0.2.15,35519,119.254.87.201,80,11,1579,6,705,5,874,8061.061694,1.490449,3784.094592,4691.203792,Malicious
10.0.2.15,57512,119.254.87.201,80,11,1579,6,705,5,874,8056.351428,1.831621,3079.239646,3817.383618,Malicious
192.168.43.233,51316,23.32.125.203,80,15,5625,7,603,8,5022,3349.043372,2.837259,1700.232513,14160.14541,Benign
192.168.137.97,40326,172.217.161.14,443,24,1660,12,816,12,844,10885.1205,42.48087408,153.6691544,158.9421156,Benign
192.168.43.233,51301,104.16.88.20,443,94,40909,43,3432,51,37477,2531.706929,402.00771,68.29719758,745.7966416,Benign
172.30.1.136,51533,52.84.108.135,443,2772,2494571,1063,64849,1709,2429722,595.112851,137.449955,3774.406474,141417.1143,Benign
172.30.15.752,50042,108.161.189.78,443,18,6846,10,1321,8,5525,2576.264136,9.900114,1067.462455,4464.595054,Benign
172.30.6.255,56742,172.30.16.59,7680,3,198,3,198,0,0,1235.933492,8.999616,176.0075097,0,Benign
172.30.6.255,56472,13.107.3.128,443,19,8809,8,1319,11,7490,776.253751,10.492818,1005.640239,5710.572698,Benign
172.30.15.2405,51739,14.139.45.128,80,238,209519,93,5873,145,203646,5344.425821,11.452524,4102.501772,142254.0568,Benign
192.168.137.97,41048,119.81.21.130,443,97,43637,50,5504,47,38133,78.53599753,100.2266246,439.3243831,3043.742133,Benign
192.168.43.233,51392,103.243.221.46,443,16,2182,6,338,10,1844,3479.168295,147.015688,18.39259495,100.3430328,Benign
172.30.15.1373,50681,35.190.74.53,443,8,480,5,294,3,186,3493.567534,3.465298,678.7295061,429.4002998,Benign
10.0.2.15,48381,119.254.87.201,80,11,1582,6,705,5,877,7970.968966,2.226272,2533.383163,3151.456785,Malicious
192.168.43.233,50692,151.101.152.188,443,14,8982,5,799,9,8183,1837.370152,0.664237,9623.071283,98555.18437,Benign
172.30.1.136,50180,172.217.161.4,443,13,774,7,414,6,360,356.824005,19.424106,170.5097779,148.2693721,Benign
192.168.43.233,51058,49.44.178.225,443,5,294,3,174,2,120,891.893057,16.015168,86.91760211,59.94317387,Benign
10.0.2.15,39272,119.254.87.201,80,11,1513,6,705,5,808,17966.74834,5.174028,1090.059814,1249.31678,Malicious
10.0.2.15,60878,119.254.87.201,80,11,1582,6,705,5,877,372.806974,1.429077,3946.603297,4909.462541,Malicious
172.30.1.136,50512,52.84.103.186,443,28,2962,13,1393,15,1569,990.571249,198.926351,56.02073302,63.09872944,Benign
172.30.6.255,57349,157.240.16.39,443,19,1933,10,1125,9,808,2497.089119,61.022663,147.4861889,105.9278583,Benign
192.168.43.224,46304,35.170.201.81,443,9,610,5,338,4,272,546.8209507,68.61043946,39.41091212,31.71529023,Benign
10.0.2.15,50398,119.254.87.201,80,11,1579,6,705,5,874,9047.281538,1.816349,3105.130126,3849.480469,Malicious
172.30.15.1445,50753,103.231.98.244,443,8,973,5,799,3,174,3501.829534,0.338177,18901.34456,4116.187677,Benign
172.30.6.255,56213,104.16.231.152,80,13,1751,7,801,6,950,469.888305,52.021177,123.1806039,146.0943492,Benign
172.30.6.255,55793,172.217.166.206,443,16,5627,8,1219,8,4408,80.058717,10.564993,923.0484109,3337.815747,Benign
172.30.6.255,58067,210.176.156.41,80,15,8531,10,8217,5,314,4826.89408,2.651372,24793.20141,947.4340078,Benign
172.30.15.1019,50325,173.241.248.143,80,17,5259,10,3300,7,1959,3445.435797,11.820076,2233.488177,1325.8798,Benign
192.168.43.224,33946,52.84.108.93,443,25,7565,14,1583,11,5982,2850.769025,31.78584852,398.416295,1505.575664,Benign
10.0.2.15,54531,119.254.87.201,80,13,1727,8,853,5,874,7488.297658,11.103457,614.583368,629.7137909,Malicious
192.168.43.224,37408,34.201.177.231,443,6,412,4,272,2,140,55.66799772,16.71291,130.1987506,67.01406279,Benign
172.30.15.1753,51065,184.29.25.7,443,6,348,4,228,2,120,3637.755463,9.413402,193.7662919,101.9822589,Benign
192.168.43.224,37992,117.18.232.205,443,15,5270,9,1149,6,4121,300.4156004,10.65669952,862.5559893,3093.640759,Benign
172.30.1.136,51500,52.84.110.12,443,25,1595,11,622,14,973,12.210781,145.967739,34.08972444,53.3268519,Benign
192.168.43.224,41940,34.232.42.95,443,24,6120,14,3198,10,2922,216.3003863,83.99082649,304.604694,278.3161087,Benign
192.168.137.97,45562,104.17.41.113,443,108,44057,56,4799,52,39258,1766.98439,467.5186624,82.118647,671.7678357,Benign
172.30.1.136,51486,172.217.161.10,443,58,25887,27,3847,31,22040,33.077812,253.153673,121.5704265,696.4939434,Benign
192.168.137.97,40182,157.240.16.20,443,13,862,7,470,6,392,23.14480995,16.7151542,224.9455767,187.6141831,Benign
172.30.6.255,58522,161.69.36.37,80,7,398,4,228,3,170,5775.422527,0.615827,2961.870785,2208.412428,Benign
172.30.6.255,56819,103.243.221.51,80,18,7020,10,5284,8,1736,1286.853935,3.585761,11788.8504,3873.096952,Benign
172.30.6.255,56643,192.168.1.44,7680,3,198,3,198,0,0,1035.106206,9.008379,175.8362964,0,Benign
10.0.2.15,59267,119.254.87.201,80,11,1513,6,705,5,808,5836.588117,1.425844,3955.55194,4533.455273,Malicious
10.0.2.15,44298,119.254.87.201,80,11,1579,6,705,5,874,671.291508,1.6295,3461.184412,4290.886775,Malicious
192.168.43.224,41446,52.10.2.252,443,23,7232,13,1485,10,5747,727.4668398,16.49567767,720.1886604,2787.154364,Benign
10.0.2.15,40571,119.254.87.201,80,13,1741,8,853,5,888,12443.31558,10.536611,647.6465725,674.2205819,Malicious
172.30.15.1872,51184,52.6.46.142,443,25,5004,14,3473,11,1531,3953.626207,3.894275,7134.575755,3145.12971,Benign
192.168.137.97,51842,103.102.166.224,443,10,672,6,404,4,268,5424.694442,114.3196775,28.2715983,18.75442659,Benign
172.30.1.136,50358,104.244.42.8,443,43,10565,25,4150,18,6415,650.260604,175.373455,189.3102921,292.6326564,Benign
172.30.15.2262,51579,104.121.244.70,443,215,176191,92,21142,123,155049,4487.731662,22.954336,7368.368225,54037.37229,Benign
10.0.2.15,59357,119.254.87.201,80,11,1579,6,705,5,874,552.950134,1.886045,2990.384641,3707.228619,Malicious
10.0.2.15,60023,119.254.87.201,80,11,1587,6,705,5,882,11184.49357,1.489476,3786.566551,4737.236451,Malicious
192.168.43.224,54510,125.56.225.203,443,19,5876,11,1545,8,4331,2279.960181,16.65271038,742.2215196,2080.622266,Benign
10.0.2.15,42513,119.254.87.201,80,11,1582,6,705,5,877,3676.29393,1.488202,3789.808104,4714.413769,Malicious
172.30.6.255,57324,103.231.98.53,80,51,23872,26,21566,25,2306,2467.885268,113.051057,1526.106916,163.1829059,Benign
172.30.6.255,57658,103.243.221.51,80,7,406,5,294,2,112,3537.855201,19.20689,122.4560561,46.64992615,Benign
172.30.6.255,56220,104.198.91.84,80,6,348,4,228,2,120,469.965651,21.019902,86.77490504,45.67100265,Benign
10.0.2.15,42495,119.254.87.201,80,11,1579,6,705,5,874,18897.74327,2.606422,2163.885971,2682.604736,Malicious
172.30.6.255,58541,184.29.25.201,443,20,5512,11,3415,9,2097,5811.086756,18.323892,1490.94963,915.5260247,Benign
10.0.2.15,41527,119.254.87.201,80,11,1585,6,705,5,880,308.428116,1.769553,3187.245593,3978.405846,Malicious
192.168.43.224,38900,54.77.4.53,443,8,544,5,338,3,206,1301.357189,54.17462548,49.91266623,30.42014569,Benign
10.0.2.15,50523,119.254.87.201,80,11,1513,6,705,5,808,13406.69692,4.308419,1309.06488,1500.31833,Malicious
172.30.15.750,50040,23.111.9.22,443,6,348,4,228,2,120,2576.241453,10.152273,179.6641993,94.56010491,Benign
172.30.15.1006,50312,104.121.243.213,80,7,402,4,228,3,174,3443.356302,3.660592,498.2800596,380.2663613,Benign
172.30.15.1462,50770,4.78.226.233,443,25,9010,12,1896,13,7114,3504.774888,2.471448,6137.292794,23027.79585,Benign
192.168.43.224,38686,52.76.199.39,443,6,412,4,272,2,140,54.41567872,21.11563056,103.051623,53.04127655,Benign
172.30.6.255,56614,172.217.166.210,443,50,8478,23,2887,27,5591,966.091994,184.018398,125.5091896,243.0626529,Benign
192.168.43.233,51199,172.217.161.14,443,49,9770,25,3273,24,6497,1162.532042,241.289159,108.5171008,215.4095949,Benign
192.168.43.224,57946,174.129.238.218,443,417,328172,189,23430,228,304742,46.51609065,128.1361867,1462.818622,19026.13199,Benign
10.0.2.15,41032,119.254.87.201,80,11,1582,6,705,5,877,7760.762513,2.178754,2588.635523,3220.189154,Malicious
192.168.43.224,45974,54.173.101.22,443,25,3189,13,1824,12,1365,1010.577415,61.87111807,235.8450995,176.4959215,Benign
172.30.6.255,58459,157.240.16.17,443,2512,2263344,958,58871,1554,2204473,5654.620515,34.444819,13673.11583,512001.0647,Benign
172.30.6.255,55949,54.236.156.42,443,29,7461,13,2157,16,5304,158.986032,60.933313,283.1948429,696.3678473,Benign
172.30.6.255,56075,13.228.225.25,80,13,2332,7,1212,6,1120,286.669523,82.26705,117.8600667,108.913593,Benign
192.168.43.224,51868,54.197.248.134,443,512,421210,213,30147,299,391063,2406.475769,107.5161259,2243.161182,29097.99786,Benign
10.0.2.15,49554,119.254.87.201,80,11,1579,6,705,5,874,1659.817404,2.546316,2214.964678,2745.927842,Malicious
172.30.1.136,50195,172.217.161.1,443,1856,1545255,791,47443,1065,1497812,357.869895,523.698568,724.7375173,22880.52084,Benign
172.30.15.2075,51387,54.85.199.48,443,6,348,4,228,2,120,4122.585667,4.991128,365.4484517,192.3412904,Benign
172.30.15.2251,51568,184.29.25.145,443,42,30135,16,2609,26,27526,4469.372275,8.325855,2506.889683,26448.69506,Benign
192.168.43.233,51391,52.7.220.66,443,11,632,6,338,5,294,3479.164255,147.019727,18.39208965,15.99785313,Benign
192.168.43.224,33638,18.211.245.141,443,43,10163,24,4364,19,5799,1571.167065,66.7651091,522.9078552,694.8539533,Benign
192.168.43.233,51030,163.53.78.128,443,21,7547,11,1261,10,6286,819.412809,18.886222,534.1460034,2662.681822,Benign
172.30.6.255,55843,180.149.59.232,80,115,72024,67,49804,48,22220,102.039934,309.572079,1287.041135,574.2119915,Benign
10.0.2.15,50453,119.254.87.201,80,11,1579,6,705,5,874,2202.858738,2.02253,2788.586572,3457.056261,Malicious
192.168.43.233,51257,157.240.16.39,443,43,7610,22,5176,21,2434,1945.962284,99.577354,415.8375206,195.5464693,Benign
172.30.6.255,56354,217.12.15.83,443,25,10065,14,2514,11,7551,607.586948,25.213946,797.6538063,2395.816982,Benign
192.168.43.224,42744,54.86.164.29,443,510,323722,245,23904,265,299818,3021.931124,85.41050053,2238.975288,28082.54237,Benign
192.168.137.97,33340,172.217.161.5,443,46,5960,24,3006,22,2954,399.816294,240.1027421,100.1571235,98.4245319,Benign
172.30.1.136,50362,172.217.161.14,443,32,7043,15,1927,17,5116,650.935375,270.295136,57.03395269,151.4196689,Benign
172.30.1.136,50687,151.101.0.188,443,29,12307,16,3602,13,8705,1806.182571,18.412089,1565.058696,3782.297598,Benign
172.30.1.136,51222,172.217.194.188,5228,1,66,1,66,0,0,1625.707917,0,0,0,Benign
172.30.6.255,56498,204.79.197.254,443,26,7812,13,1206,13,6606,821.684302,102.510394,94.11728532,515.5379658,Benign
172.30.6.255,57878,103.243.221.75,80,6,340,4,228,2,112,4284.904172,19.143612,95.27982494,46.80412453,Benign
172.30.15.2460,51794,14.139.45.128,80,10,1408,5,671,5,737,5421.032498,0.23406,22934.29035,25190.12219,Benign
192.168.43.233,51688,52.84.108.201,443,26306,23182208,10351,610849,15955,22571359,905.386256,860.309205,5680.273989,209890.666,Benign
172.30.6.255,56333,77.66.11.200,80,10,1557,6,815,4,742,591.729486,14.270971,456.8715051,415.9492721,Benign
172.30.15.2170,51482,52.84.108.186,443,127,102997,49,3868,78,99129,4245.573631,1.901568,16272.88638,417041.0945,Benign
192.168.43.233,51257,52.84.108.242,443,11,666,6,360,5,306,2295.302952,12.853933,224.0559368,190.4475463,Benign
192.168.137.97,34530,172.217.161.19,443,9,622,5,350,4,272,346.830674,16.86978028,165.9772655,128.9880463,Benign
10.0.2.15,39618,119.254.87.201,80,11,1587,6,705,5,882,12590.87674,1.894821,2976.534459,3723.8346,Malicious
192.168.43.233,51025,163.53.78.128,443,9,534,5,294,4,240,779.329341,39.458296,59.60723697,48.65896895,Benign
192.168.43.233,51426,52.230.84.217,443,33,10985,18,5387,15,5598,3774.024681,302.573166,142.4316656,148.0104815,Benign
172.30.6.255,57584,103.243.221.51,80,73,49828,43,41736,30,8092,3315.862332,44.206758,7552.872346,1464.391485,Benign
172.30.1.136,51514,204.79.197.222,443,1,54,0,0,1,54,113.668828,0,0,0,Benign
192.168.43.233,51055,49.44.170.52,443,24,9479,10,1195,14,8284,889.529212,0.419796,22772.96592,157867.1545,Benign
192.168.215.49,49098,172.217.161.4,443,126,69105,52,5704,74,63401,1270.292049,14.90654445,3061.205778,34025.86036,Benign
172.30.1.136,50783,13.107.4.52,80,2,132,2,132,0,0,1928.204874,5.999868,176.0038721,0,Benign
172.30.15.2389,51723,14.139.45.128,80,52,32712,26,2144,26,30568,5337.354064,2.251639,7617.56214,108607.108,Benign
192.168.43.233,50711,172.217.166.206,443,22,7148,11,1663,11,5485,1843.412888,11.574504,1149.422904,3791.091178,Benign
172.30.15.779,50071,52.84.108.93,443,49,30947,24,2495,25,28452,2660.239815,5.990818,3331.765378,37994.1437,Benign
10.0.2.15,47415,119.254.87.201,80,11,1513,6,705,5,808,7400.34049,1.647383,3423.611874,3923.799141,Malicious
192.168.43.233,51494,35.177.33.121,443,32,9913,16,2781,16,7132,3828.395531,163.004241,136.4872464,350.0277027,Benign
172.30.15.1335,50643,180.179.41.214,443,20,8121,10,1654,10,6467,3490.040479,0.296032,44697.8705,174764.8903,Benign
172.30.15.545,49829,205.180.87.201,443,6,344,4,228,2,116,2251.455925,4.865228,374.9053487,190.7413178,Benign
192.168.137.97,39318,172.217.160.238,443,116,21065,56,9462,60,11603,7319.396583,636.0911498,119.0018129,145.9287714,Benign
192.168.137.97,36952,52.22.149.115,443,33,11859,16,3142,17,8717,347.5368683,6.933076172,3625.519088,10058.45,Benign
172.30.1.136,50778,151.101.129.181,443,62,27751,31,3176,31,24575,1925.106828,40.795397,622.8153632,4819.171143,Benign
192.168.43.224,39046,103.37.200.184,443,539,415489,257,20554,282,394935,2476.382654,39.38043947,4175.473972,80229.67855,Benign
172.30.6.255,56331,203.174.85.172,80,6,348,4,228,2,120,591.896042,14.096648,129.3924627,68.10129614,Benign
172.30.6.255,57086,172.30.10.168,445,3,198,3,198,0,0,1716.331681,9.003311,175.9352754,0,Benign
172.30.6.255,57576,103.243.221.17,80,21,10387,10,4270,11,6117,3288.853173,27.53903,1240.421322,1776.968906,Benign
172.30.15.1168,50476,210.176.156.62,80,21,11375,10,3699,11,7676,3460.542249,6.724941,4400.336003,9131.381227,Benign
172.30.15.658,49945,52.84.110.77,443,33,12466,19,2302,14,10164,2396.681701,9.495142,1939.518124,8563.537017,Benign
172.30.6.255,57773,103.243.221.51,80,42,29464,19,5750,23,23714,3975.899529,1.059756,43406.21804,179014.7921,Benign
172.30.15.744,50033,158.85.224.180,443,25,7238,12,2570,13,4668,2547.616018,1.117118,18404.50158,33428.87681,Benign
172.30.15.356,49624,104.25.218.21,443,259,199783,99,7929,160,191854,1334.465127,5.91054,10732.01433,259677.1192,Benign
172.30.15.2489,51823,14.139.45.128,80,647,598337,236,13881,411,584456,5434.287429,4.470072,24842.55287,1045989.416,Benign
10.0.2.15,35618,119.254.87.201,80,11,1579,6,705,5,874,22326.98963,1.031994,5465.148053,6775.233189,Malicious
192.168.43.224,51472,54.197.248.134,443,27,8268,16,2208,11,6060,347.0282033,18.64816807,947.2244103,2599.71917,Benign
192.168.215.49,36834,169.60.79.3,443,30,8138,15,3186,15,4952,997.8350499,1.268894188,20086.78126,31220.88538,Benign
172.30.15.1080,50386,144.217.79.15,80,14,4184,8,2194,6,1990,3452.804655,4.547207,3859.951834,3501.050205,Benign
172.30.6.255,56154,172.217.166.210,443,6,348,4,228,2,120,406.059315,5.586802,326.4837379,171.8335463,Benign
172.30.6.255,55855,23.7.212.50,443,6,348,4,228,2,120,103.698616,10.253614,177.8884986,93.6255256,Benign
172.30.1.136,50744,52.230.83.250,443,53,16600,30,10420,23,6180,1891.20617,79.927758,1042.941803,618.5585739,Benign
192.168.43.224,46266,35.170.201.81,443,22,8433,12,2582,10,5851,360.476549,6.646129377,3107.974406,7042.8963,Benign
172.30.6.255,55812,119.81.99.200,443,28,7120,15,2208,13,4912,90.716428,222.174709,79.50499892,176.8698164,Benign
172.30.6.255,56231,18.214.153.193,80,14,1785,7,895,7,890,476.276334,60.873559,117.6208541,116.9637543,Benign
10.0.2.15,48567,119.254.87.201,80,11,1579,6,705,5,874,581.170475,1.758497,3207.284403,3976.122791,Malicious
10.0.2.15,39768,119.254.87.201,80,11,1582,6,705,5,877,17641.83518,2.450519,2301.553263,2863.066967,Malicious
172.30.1.136,50249,52.94.220.15,443,3,198,3,198,0,0,451.884068,9.000626,175.9877591,0,Benign
192.168.43.224,48526,209.197.3.15,443,133,95927,60,4458,73,91469,2475.490017,55.10379108,647.2149974,13279.52189,Benign
192.168.43.224,34090,52.84.108.208,443,59,35154,27,4240,32,30914,2890.748467,123.8405037,273.9006947,1997.020301,Benign
172.30.15.515,49798,162.247.242.19,443,38,17038,20,12709,18,4329,2056.851933,9.309643,10921.14918,3720.013753,Benign
10.0.2.15,52222,119.254.87.201,80,11,1551,6,705,5,846,20038.96405,1.224986,4604.134251,5524.961102,Malicious
172.30.6.255,55866,152.163.13.4,443,6,348,4,228,2,120,105.107614,11.08528,164.5425285,86.60133077,Benign
192.168.43.224,47178,54.161.64.12,443,197,30002,103,8837,94,21165,737.2961831,1715.649387,41.20655452,98.69149331,Benign
10.0.2.15,48748,119.254.87.201,80,12,1656,7,779,5,877,14815.69329,4.472388,1393.439031,1568.736881,Malicious
172.30.6.255,57954,103.243.221.17,80,27,17315,11,4616,16,12699,4586.851826,15.241844,2422.80396,6665.335244,Benign
172.30.15.1226,50534,50.116.239.135,443,8,452,5,282,3,170,3467.518798,10.007481,225.4313548,135.8983345,Benign
172.30.15.1447,50755,103.231.98.244,443,10,1081,6,853,4,228,3501.92025,0.85342,7996.0629,2137.282932,Benign
172.30.6.255,58093,172.217.166.206,443,17,1779,10,1150,7,629,4871.403517,134.042574,68.63490998,37.54031163,Benign
172.30.15.1712,51023,184.29.25.7,443,41,26794,17,6298,24,20496,3618.868723,8.212079,6135.35257,19966.68566,Benign
10.0.2.15,59580,119.254.87.201,80,11,1579,6,705,5,874,24333.73922,1.112532,5069.517102,6284.763045,Malicious
10.0.2.15,35532,119.254.87.201,80,11,1544,6,705,5,839,3912.384766,1.431854,3938.949083,4687.628767,Malicious
172.30.6.255,57411,192.168.1.35,7680,3,198,3,198,0,0,2760.636711,9.005099,175.9003427,0,Benign
172.30.15.1241,50549,173.241.248.143,80,10,1485,7,993,3,492,3469.043167,8.580928,925.7739955,458.6916473,Benign
192.168.137.97,49426,157.240.16.52,443,111,37557,57,6841,54,30716,6763.016096,132.395315,413.3681014,1856.017337,Benign
10.0.2.15,57521,119.254.87.201,80,11,1579,6,705,5,874,12803.7237,1.369671,4117.777189,5104.87555,Malicious
192.168.43.233,51272,52.84.108.135,443,6130,5196067,2553,153038,3577,5043029,2652.235066,452.07921,2708.162581,89241.51146,Benign
172.30.6.255,57384,103.243.221.17,80,29,15669,15,8539,14,7130,2648.876147,16.185585,4220.545627,3524.123472,Benign
10.0.2.15,59638,119.254.87.201,80,11,1582,6,705,5,877,18059.35519,1.217076,4634.057364,5764.635898,Malicious
172.30.1.136,50810,172.217.161.14,443,27,3864,15,2321,12,1543,1952.395273,12.518716,1483.219206,986.0436166,Benign
192.168.137.97,46816,52.84.110.231,443,12,1532,7,1038,5,494,1334.611185,20.9346521,396.6629089,188.7779162,Benign
172.30.6.255,55630,157.240.16.63,443,52,23051,31,17307,21,5744,15.361552,43.241566,3201.91919,1062.681217,Benign
192.168.43.224,42028,23.251.156.28,443,14,1824,8,1116,6,708,1379.823443,21.08563253,423.4162759,268.6189277,Benign
172.30.6.255,57045,103.243.221.17,80,47,29597,23,10049,24,19548,1614.860422,49.169979,1634.981378,3180.477258,Benign
10.0.2.15,60704,119.254.87.201,80,11,1560,6,705,5,855,21152.61922,1.087276,5187.275356,6290.950964,Malicious
192.168.43.233,51646,172.217.166.206,443,11,642,6,348,5,294,851.836257,13.70494,203.1384304,171.6169498,Benign
192.168.215.49,60996,52.3.188.193,443,37,7821,18,2652,19,5169,612.6353863,5.661505814,3747.412914,7304.063858,Benign
10.0.2.15,36346,119.254.87.201,80,11,1582,6,705,5,877,24754.13537,2.487102,2267.699515,2820.953865,Malicious
172.30.15.1279,50587,104.18.255.119,80,9,522,5,282,4,240,3469.553231,7.954923,283.5979682,241.3599729,Benign
192.168.43.224,36054,34.204.88.0,443,15,1922,9,1134,6,788,32.6858986,13.72759504,660.8586554,459.2210057,Benign
172.30.6.255,55799,104.36.113.23,443,4,240,2,120,2,120,89.36124,10.576739,90.76521601,90.76521601,Benign
172.30.6.255,56431,35.201.123.46,443,18,5644,11,2027,7,3617,679.144914,10.61955,1526.995023,2724.78589,Benign
192.168.43.233,51274,13.107.21.200,443,93,49430,50,30261,43,19169,2696.043006,1201.9018,201.4207816,127.5911227,Benign
192.168.43.224,35888,172.217.166.206,443,6,420,4,272,2,148,9.687355683,5.683265001,382.8785038,208.3309506,Benign
10.0.2.15,49997,119.254.87.201,80,11,1579,6,705,5,874,9082.105576,1.95,2892.307692,3585.641026,Malicious
10.0.2.15,47318,119.254.87.201,80,11,1513,6,705,5,808,16705.52895,2.111203,2671.462668,3061.76147,Malicious
192.168.137.97,45552,192.168.121.7,8080,1187,970601,522,47690,665,922911,2901.845705,124.6898766,3059.751205,59213.21124,Benign
172.30.6.255,56385,151.101.2.2,80,6,348,4,228,2,120,650.763285,26.146579,69.76056026,36.71608435,Benign
192.168.137.97,34390,172.217.161.3,443,27,8523,15,1584,12,6939,281.1473145,1.744435866,7264.239544,31822.32209,Benign
172.30.6.255,58552,180.149.59.210,80,12,4894,8,3669,4,1225,5814.054681,5.000975,5869.255495,1959.617875,Benign
172.30.1.136,50826,52.114.75.78,443,40,15513,21,7791,19,7722,1976.19937,8.083451,7710.568172,7642.280506,Benign
172.30.1.136,51521,52.84.108.135,443,27,7590,14,1564,13,6026,25.140087,174.791203,71.58254984,275.8033538,Benign
192.168.43.224,34628,172.217.166.206,443,30,3920,16,2209,14,1711,3249.049131,91.9148236,192.2649613,148.9204838,Benign
172.30.6.255,57059,172.30.10.168,7680,3,198,3,198,0,0,1677.32957,9.005735,175.8879203,0,Benign
192.168.137.97,52076,172.217.161.3,443,13,894,7,494,6,400,7413.296103,62.95869292,62.77131587,50.82697642,Benign
172.30.15.2172,51484,52.84.108.186,443,17,6861,8,1099,9,5762,4245.574628,0.252531,34815.5276,182536.0055,Benign
10.0.2.15,57444,119.254.87.201,80,11,1579,6,705,5,874,881.492307,1.668528,3380.224965,4190.520027,Malicious
192.168.137.97,36330,52.84.103.186,443,24,2564,18,1929,6,635,3757.33029,90.47979913,170.5574078,56.14512906,Benign
172.30.15.1792,51104,104.244.42.133,443,23,3491,12,1898,11,1593,3643.23598,3.951913,3842.189846,3224.767347,Benign
172.30.15.945,50251,103.15.158.128,443,6,348,3,174,3,174,3441.193839,10.3614,134.3447797,134.3447797,Benign
172.30.6.255,58095,172.217.166.197,443,17,1779,10,1150,7,629,4872.41926,132.986252,69.18008337,37.83849777,Benign
10.0.2.15,58502,119.254.87.201,80,11,1579,6,705,5,874,18603.00323,3.278634,1720.228607,2132.595465,Malicious
172.30.6.255,57700,103.243.221.87,80,15,5419,9,4245,6,1174,3678.865235,34.182332,993.4957042,274.7618273,Benign
172.30.6.255,57898,157.240.16.39,443,19,1933,10,1125,9,808,4388.092528,61.047547,147.426071,105.8846803,Benign
172.30.15.2525,51859,23.61.93.124,443,118,97473,43,3730,75,93743,5490.921985,6.958553,4288.247858,107772.981,Benign
10.0.2.15,56598,119.254.87.201,80,11,1582,6,705,5,877,16017.02434,2.015938,2797.705088,3480.265762,Malicious
10.0.2.15,44657,119.254.87.201,80,11,1582,6,705,5,877,6527.247244,2.153603,2618.86708,3257.796353,Malicious
172.30.6.255,56011,35.187.209.5,443,30,13691,16,2219,14,11472,227.862074,10.778726,1646.947886,8514.549864,Benign
10.0.2.15,51283,119.254.87.201,80,11,1582,6,705,5,877,15088.82398,1.625007,3470.75428,4317.519863,Malicious
172.30.15.269,49532,117.18.237.29,80,180,170338,59,3462,121,166876,123.98745,60.356466,458.873785,22118.72378,Benign
172.30.15.1983,51295,52.84.110.163,443,20,7621,11,1285,9,6336,4076.905643,0.341655,30088.8323,148360.1879,Benign
192.168.137.97,47634,157.240.16.39,443,28,5697,14,3085,14,2612,739.3361682,65.18646709,378.6061908,320.5573324,Benign
172.30.6.255,55997,13.107.3.128,443,31,21674,10,1445,21,20229,221.943315,17.357269,666.0033903,9323.586562,Benign
172.30.6.255,58572,103.243.221.51,80,16,5621,9,5239,7,382,5879.867856,1.613703,25972.56125,1893.78095,Benign
192.168.43.233,51309,172.217.166.206,443,20,6702,10,1340,10,5362,2535.533093,55.880244,191.8388187,767.6416016,Benign
10.0.2.15,34072,119.254.87.201,80,11,1513,6,705,5,808,22621.81161,1.487799,3790.834649,4344.672903,Malicious
172.30.15.1756,51068,184.29.25.7,443,32,20561,14,6140,18,14421,3638.213106,8.95846,5483.085262,12878.10628,Benign
172.30.15.474,49749,23.9.250.106,443,7,402,4,228,3,174,1725.489846,10.129453,180.0689534,137.4210434,Benign
192.168.43.224,45814,54.173.101.22,443,6,412,4,272,2,140,697.810536,29.65466784,73.37799268,37.76808447,Benign
172.30.6.255,57360,172.217.166.194,80,20,1780,11,1091,9,689,2535.445965,257.473833,33.89859039,21.40800071,Benign
172.30.15.1022,50328,151.101.130.49,80,10,1601,5,929,5,672,3446.505577,0.755587,9836.061235,7114.998008,Benign
172.30.1.136,50514,52.84.103.186,443,26,3110,13,1898,13,1212,992.592837,24.185481,627.8146794,400.9016815,Benign
172.30.1.136,50229,172.217.161.14,443,2,132,2,132,0,0,387.361395,3.006109,351.2846673,0,Benign
192.168.137.97,47430,161.202.24.166,443,45,18390,29,4513,16,13877,179.4143497,91.08315328,396.3850471,1218.8423,Benign
172.30.6.255,56473,40.121.213.159,443,25,17073,11,1636,14,15437,776.378454,10.367951,1262.351645,11911.32173,Benign
192.168.137.97,60736,23.57.218.60,443,30,2840,15,1087,15,1753,0.992029616,402.9796866,21.57925148,34.80076159,Benign
10.0.2.15,59667,119.254.87.201,80,11,1582,6,705,5,877,16680.63396,1.215573,4639.787162,5771.763604,Malicious
10.0.2.15,50027,119.254.87.201,80,11,1579,6,705,5,874,10613.9334,1.24653,4524.560179,5609.171059,Malicious
192.168.215.49,34314,52.86.98.206,443,373,41259,219,20111,154,21148,1584.837112,268.3401578,599.56736,630.4833439,Benign
172.30.15.1622,50932,103.254.155.35,443,6,348,4,228,2,120,3574.177846,3.000688,607.8605973,319.9266302,Benign
172.30.1.136,50762,74.125.68.188,5228,3,198,1,66,2,132,1914.245221,16.578642,31.84820566,63.69641132,Benign
172.30.6.255,55864,52.203.61.66,443,7,402,4,228,3,174,105.084266,4.984593,365.9275692,279.2605133,Benign
192.168.43.224,47488,157.240.16.16,443,8,552,5,338,3,214,1206.971663,43.07064915,62.78057223,39.74864632,Benign
10.0.2.15,59773,119.254.87.201,80,11,1582,6,705,5,877,12953.87382,1.433907,3933.309482,4892.925413,Malicious
172.30.15.792,50084,34.200.202.18,443,18,4397,11,2698,7,1699,2676.379042,11.516301,1874.212909,1180.240079,Benign
10.0.2.15,60482,119.254.87.201,80,11,1579,6,705,5,874,21963.51692,0.98337,5735.379359,7110.243347,Malicious
192.168.215.49,47108,157.240.16.39,443,36,7420,19,4213,17,3207,513.948949,66.71848835,505.1673207,384.5410865,Benign
172.30.15.206,49486,162.125.34.129,443,23,7339,11,2741,12,4598,7.954233,88.492725,247.7943808,415.6725878,Benign
172.30.15.1695,51006,184.29.25.7,443,133,105335,53,22582,80,82753,3609.560694,7.568231,23870.30734,87474.07419,Benign
10.0.2.15,42409,115.182.31.2,80,10,1663,5,658,5,1005,15.734649,0.825825,6374.231829,9735.718827,Malicious
10.0.2.15,59717,119.254.87.201,80,11,1582,6,705,5,877,1724.262339,1.376916,4096.110438,5095.445183,Malicious
172.30.15.2355,51689,139.59.82.147,443,6,348,4,228,2,120,5321.73112,6.178323,295.2257433,155.3819702,Benign
10.0.2.15,38837,119.254.87.201,80,12,1653,7,779,5,874,12055.29994,4.457239,1398.174969,1568.684111,Malicious
172.30.15.1691,51002,184.29.25.7,443,133,109630,54,25016,79,84614,3609.471119,7.656577,26138.05099,88409.21994,Benign
172.30.15.2060,51372,52.84.108.91,443,63,41310,30,2777,33,38533,4103.856399,3.454409,6431.201401,89237.84068,Benign
172.30.15.2117,51429,204.79.197.200,443,21,10081,10,1174,11,8907,4178.088444,9.261048,1014.140084,7694.161611,Benign
172.30.6.255,58222,13.107.5.88,443,29,8739,14,1824,15,6915,5166.22058,125.654755,116.1277184,440.2539323,Benign
192.168.215.49,46412,223.31.160.67,443,84,48870,40,5067,44,43803,334.9774144,125.5521068,322.8619657,2791.064276,Benign
192.168.43.224,37792,4.31.198.61,443,51,27290,25,3305,26,23985,744.4168136,59.84675302,441.7950627,3206.18898,Benign
172.30.15.1065,50371,23.237.44.42,80,13,1453,7,926,6,527,3452.679757,10.18437,727.3891267,413.9676779,Benign
172.30.1.136,50399,157.240.16.20,443,2142,1642903,964,60427,1178,1582476,777.136579,52.370579,9230.678928,241735.1162,Benign
10.0.2.15,33192,119.254.87.201,80,11,1579,6,705,5,874,16049.824,2.174034,2594.255656,3216.141054,Malicious
172.30.15.1050,50356,151.139.104.143,80,339,341168,101,6354,238,334814,3448.440716,8.819774,5763.412985,303693.9495,Benign
192.168.43.233,51689,172.217.166.206,443,29,6447,15,1603,14,4844,1018.78141,289.78659,44.25325547,133.7259947,Benign
172.30.15.2234,51551,104.121.244.70,443,339,258282,160,29246,179,229036,4457.930046,10.367126,22568.26048,176740.2075,Benign
172.30.15.1571,50880,172.217.166.202,443,111,94384,38,3525,73,90859,3560.255062,6.762349,4170.148568,107488.0933,Benign
192.168.137.97,51978,172.217.161.3,443,9,606,5,338,4,268,6555.384082,56.76791065,47.63254397,37.76781593,Benign
172.30.15.2439,51773,14.139.45.128,80,16,7928,7,767,9,7161,5418.726647,0.326581,18788.60068,175417.4309,Benign
172.30.6.255,57155,103.243.220.231,80,21,10669,10,4552,11,6117,1921.882135,20.200919,1802.690264,2422.464047,Benign
10.0.2.15,50558,119.254.87.201,80,11,1582,6,705,5,877,9650.653248,1.880452,2999.278897,3731.017862,Malicious
192.168.215.49,60106,192.82.210.131,443,14,2960,8,2060,6,900,1293.023666,4.466447965,3689.732899,1612.019228,Benign
192.168.43.233,50736,151.139.105.14,443,16,4786,8,1087,8,3699,1861.615389,12.05838,721.1582319,2454.060993,Benign
172.30.15.373,49641,62.210.213.13,80,18,9014,8,839,10,8175,1443.110451,7.443419,901.7361511,8786.284905,Benign
192.168.43.233,51110,52.84.110.8,443,9,534,5,294,4,240,918.970648,21.344336,110.1931679,89.95360643,Benign
172.30.15.327,49593,104.25.218.21,443,16,6377,8,1037,8,5340,865.269473,0.498005,16658.46728,85782.27126,Benign
192.168.43.233,51281,13.107.21.200,443,35,11771,19,3600,16,8171,2432.500998,60.562413,475.5424788,1079.349332,Benign
172.30.15.1528,50836,34.199.78.214,443,23,3976,12,2215,11,1761,3527.04648,5.704307,3106.424672,2469.712798,Benign
172.30.6.255,57136,103.243.221.75,80,6,340,4,228,2,112,1863.025132,13.008825,140.2125096,68.8763205,Benign
172.30.6.255,58435,35.190.43.164,80,10,1573,6,1119,4,454,5616.836937,2.208605,4053.237224,1644.476944,Benign
192.168.43.233,51492,23.43.115.95,443,9,534,5,294,4,240,3819.023708,72.347126,32.50992997,26.53871835,Benign
172.30.15.826,50125,172.217.166.196,443,21,3348,11,1544,10,1804,3102.165165,1.101646,11212.31321,13100.39704,Benign
192.168.137.97,40110,172.217.161.14,443,7,466,4,272,3,194,8016.097356,56.11751309,38.77577391,27.65625051,Benign
192.168.43.224,51246,18.210.21.97,443,15,1038,9,618,6,420,935.8954442,67.21042158,73.56002066,49.99224705,Benign
172.30.15.1029,50335,173.241.248.143,443,25,5693,14,1998,11,3695,3446.931257,10.324564,1548.152542,2863.074896,Benign
172.30.15.1531,50839,104.20.90.77,443,18,3305,11,1619,7,1686,3527.903399,9.096066,1423.912272,1482.838845,Benign
10.0.2.15,41548,119.254.87.201,80,11,1579,6,705,5,874,15839.51812,2.21915,2541.513643,3150.75592,Malicious
10.0.2.15,58054,119.254.87.201,80,11,1582,6,705,5,877,10999.37096,4.541943,1241.759309,1544.713353,Malicious
172.30.1.136,51483,52.84.110.12,443,8,693,0,0,8,693,91.84794,3.876524,0,1430.147214,Benign
172.30.1.136,50759,172.217.161.3,443,15,1743,9,1101,6,642,1907.670477,6.912413,1274.229419,743.0111598,Benign
192.168.137.97,57558,104.197.3.80,80,11,977,6,491,5,486,8123.813158,1.765763305,2224.533712,2201.88062,Benign
172.30.6.255,56379,103.243.221.17,80,50,36705,30,32396,20,4309,648.841905,28.224655,9182.326586,1221.343538,Benign
192.168.43.224,45478,54.173.101.22,443,6,412,4,272,2,140,44.58382759,11.78589992,184.627395,95.02880626,Benign
172.30.6.255,56001,103.243.221.75,80,14,3768,8,2587,6,1181,223.86379,14.178454,1459.679596,666.3632015,Benign
192.168.215.49,56336,52.206.174.32,443,39,8575,21,3568,18,5007,243.2357083,301.6562638,94.62425757,132.7868996,Benign
172.30.6.255,57827,103.243.221.46,80,35,23864,18,9685,17,14179,4102.838343,19.31223,4011.965475,5873.583734,Benign
192.168.43.224,60930,151.101.1.69,443,23,8046,13,1686,10,6360,1202.704254,11.31336177,1192.21857,4497.336956,Benign
192.168.43.224,52000,34.207.29.244,443,9,610,5,338,4,272,1012.090276,61.95271976,43.64618714,35.12355888,Benign
192.168.137.97,35524,161.202.24.167,443,69,31790,39,4708,30,27082,288.5361087,53.65399109,701.9794657,4038.022067,Benign
10.0.2.15,48882,119.254.87.201,80,11,1587,6,705,5,882,14185.11337,1.092795,5161.077787,6456.837742,Malicious
10.0.2.15,45301,119.254.87.201,80,11,1582,6,705,5,877,8566.776305,1.08546,5195.953789,6463.619111,Malicious
192.168.137.97,35266,172.217.161.16,443,65130,63266166,22023,1459602,43107,61806564,2244.958184,333.6616709,34995.97652,1481897.848,Benign
172.30.6.255,56181,103.243.221.17,80,82,59236,32,17883,50,41353,464.86925,26.167288,5467.284191,12642.65521,Benign
10.0.2.15,59102,119.254.87.201,80,11,1579,6,705,5,874,14695.61113,1.71679,3285.200869,4072.717106,Malicious
192.168.43.224,45826,104.237.191.1,443,10,684,5,350,5,334,3076.435669,19.11582974,146.4754624,139.7794412,Benign
10.0.2.15,44296,219.234.85.240,80,11,1631,6,796,5,835,17.884465,3.888854,1637.500405,1717.729696,Malicious
172.30.6.255,57230,172.217.166.206,443,17,1779,10,1150,7,629,2172.418514,87.744914,104.8493819,57.34805324,Benign
172.30.15.912,50218,67.202.94.86,80,8,1358,5,982,3,376,3439.752884,1.185428,6627.142264,2537.480134,Benign
172.30.6.255,56118,103.243.221.87,80,15,4446,8,2866,7,1580,324.111285,16.340863,1403.108269,773.5209579,Benign
192.168.137.97,39358,172.217.161.4,443,45,6700,27,3289,18,3411,138.985892,140.1604283,187.7277369,194.6911859,Benign
192.168.43.233,51222,157.240.16.20,443,16,4975,8,1025,8,3950,1291.271391,27.430562,298.9366386,1151.999729,Benign
172.30.15.261,49524,172.217.166.197,443,46,12790,21,5326,25,7464,91.25731,3.335075,12775.72468,17904.24503,Benign
172.30.6.255,56502,52.109.120.3,443,57,41437,30,23258,27,18179,823.919668,2.238928,83104.05694,64956.08613,Benign
172.30.1.136,50605,172.217.161.5,443,27,1566,15,858,12,708,1610.555732,61.418042,111.7586914,92.22045861,Benign
172.30.6.255,57032,172.217.166.206,443,35,5994,19,3730,16,2264,1570.43412,114.03166,261.6817119,158.833082,Benign
10.0.2.15,40338,119.254.87.201,80,12,1653,7,779,5,874,21029.94652,6.860376,908.4050204,1019.18612,Malicious
172.30.6.255,56701,52.213.19.114,443,54,21138,30,13879,24,7259,1157.351536,85.363857,1300.690994,680.2879115,Benign
172.30.6.255,56965,103.243.221.51,80,45,29062,26,24807,19,4255,1417.833784,18.395558,10788.2566,1850.446722,Benign
172.30.15.1803,51115,180.149.59.203,443,15192,16014789,4163,240736,11029,15774053,3687.188703,50.378048,38228.71422,2504908.964,Benign
10.0.2.15,55976,119.254.87.201,80,11,1582,6,705,5,877,8931.87711,0.957074,5892.961255,7330.676625,Malicious
172.30.6.255,58404,103.243.221.109,80,16,7940,10,6794,6,1146,5550.868441,8.359379,6501.918384,1096.732185,Benign
172.30.6.255,56821,103.243.221.51,80,16,6913,9,5231,7,1682,1286.863091,3.592054,11650.15893,3746.046134,Benign
192.168.137.97,51152,119.81.16.4,443,24,7207,13,2050,11,5157,3532.580505,27.1136921,604.8604498,1521.592849,Benign
192.168.43.233,51354,52.216.18.144,443,61,27395,28,2844,33,24551,3436.219,28.608059,795.3003732,6865.478011,Benign
10.0.2.15,56415,119.254.87.201,80,11,1513,6,705,5,808,20735.20615,1.250734,4509.352108,5168.165253,Malicious
172.30.15.1108,50416,103.243.220.231,80,58,27639,33,17537,25,10102,3458.266466,13.767619,10190.28781,5870.005554,Benign
172.30.15.645,49932,50.17.52.222,443,17,7116,9,1153,8,5963,2395.341737,0.819167,11260.21922,58234.76776,Benign
10.0.2.15,54517,119.254.87.201,80,11,1552,6,705,5,847,25540.38047,0.825152,6835.10432,8211.820368,Malicious
172.30.1.136,50552,104.113.230.86,443,34,5247,17,2847,17,2400,1471.781028,72.945119,312.2347364,263.2115797,Benign
192.168.137.97,50634,192.168.121.7,443,816,719390,308,33029,508,686361,2922.976367,30.72570061,8599.706264,178706.6817,Benign
192.168.43.224,39090,103.37.200.184,443,20,2060,12,1336,8,724,2571.001493,16.04455283,666.1450843,360.9947912,Benign
172.30.15.711,49998,35.161.126.85,443,21,9129,11,2381,10,6748,2404.943654,11.520561,1653.391705,4685.882918,Benign
10.0.2.15,55298,119.254.87.201,80,11,1513,6,705,5,808,2262.893648,1.714941,3288.742878,3769.22588,Malicious
192.168.215.49,51222,52.74.145.58,443,32,8736,16,2349,16,6387,480.1317083,60.32220796,311.5270584,847.0512225,Benign
192.168.43.233,50895,54.239.25.120,443,1,66,1,66,0,0,168.198758,0,0,0,Benign
172.30.6.255,58277,52.213.19.114,443,22,8557,11,3080,11,5477,5288.737872,35.380887,696.4212062,1238.408749,Benign
172.30.6.255,58229,157.240.16.39,443,27,5328,16,3329,11,1999,5181.394735,61.119388,435.7373474,261.6518346,Benign
10.0.2.15,60850,119.254.87.201,80,11,1579,6,705,5,874,8629.569547,2.018731,2793.834344,3463.56201,Malicious
172.30.1.136,51877,74.125.68.188,5228,19,2277,10,1337,9,940,4345.549283,55.438436,192.9347357,135.6459623,Benign
172.30.1.136,51819,23.21.249.197,443,40,12281,19,3371,21,8910,3031.762767,173.926742,155.053787,409.8277193,Benign
172.30.6.255,55646,122.15.34.40,80,211,222174,52,6867,159,215307,36.774988,21.803048,2519.647712,79000.69752,Benign
172.30.1.136,50436,54.72.236.219,443,152,61959,82,49736,70,12223,854.093916,349.941452,1137.013057,279.4296001,Benign
192.168.43.224,46268,35.170.201.81,443,9,626,6,412,3,214,360.6713791,29.66256372,111.1164912,57.71584737,Benign
192.168.43.233,50955,104.20.23.135,80,15,2220,8,768,7,1452,470.614819,108.748119,56.49752894,106.8156406,Benign
172.30.6.255,57850,103.243.221.109,80,7,406,5,294,2,112,4223.862632,14.19507,165.691328,63.12050592,Benign
10.0.2.15,46486,119.254.87.201,80,11,1579,6,705,5,874,8661.640255,2.052843,2747.409325,3406.008156,Malicious
172.30.6.255,57020,103.243.221.51,80,78,53935,47,45806,31,8129,1548.839091,45.252602,8097.832695,1437.088634,Benign
10.0.2.15,53278,119.254.87.201,80,11,1579,6,705,5,874,13912.51858,1.628246,3463.850057,4294.191418,Malicious
172.30.15.2470,51804,14.139.45.128,80,13,3201,6,1068,7,2133,5423.045472,0.826501,10337.55555,20646.07302,Benign
192.168.43.233,50874,157.240.16.39,443,39,9273,20,6182,19,3091,20.945462,66.279559,746.1727378,373.0863689,Benign
192.168.43.224,47436,104.16.121.145,443,16,5616,9,1116,7,4500,152.9431076,13.17451596,677.6719563,2732.548211,Benign
172.30.1.136,50830,74.125.68.188,443,10,648,6,384,4,264,1986.72306,3.365108,912.8978921,627.6173008,Benign
192.168.43.233,51359,139.59.72.43,443,31,8981,15,2477,16,6504,3137.073751,134.936064,146.8547356,385.6048447,Benign
172.30.15.1283,50591,50.31.185.52,443,9,510,5,282,4,228,3469.782298,8.037795,280.6739908,226.9279075,Benign
172.30.6.255,56427,107.178.242.85,80,16,1888,9,981,7,907,678.944725,177.169973,44.2964452,40.9550212,Benign
172.30.15.1222,50530,72.247.228.146,80,11,2394,6,1480,5,914,3467.287405,10.219734,1158.542874,715.4785046,Benign
10.0.2.15,45031,119.254.87.201,80,11,1579,6,705,5,874,278.392623,1.757279,3209.507426,3978.87871,Malicious
10.0.2.15,41523,119.254.87.201,80,11,1579,6,705,5,874,3646.289655,1.815874,3105.942373,3850.487424,Malicious
172.30.15.2045,51357,157.240.16.20,443,49,24884,23,2267,26,22617,4090.96157,6.713436,2701.44826,26951.32567,Benign
172.30.6.255,58402,210.176.156.21,80,15,4407,8,3970,7,437,5550.848482,1.475017,21531.95522,2370.142175,Benign
192.168.137.97,39780,172.217.161.14,443,15,1066,11,774,4,292,3775.833455,72.25475857,85.69677793,32.33005059,Benign
172.30.6.255,56638,103.243.221.17,80,46,32430,19,12774,27,19656,1024.849022,47.225362,2163.922004,3329.736255,Benign
172.30.6.255,56073,52.0.91.50,80,6,348,4,228,2,120,286.645654,17.606117,103.6003566,54.52650349,Benign
192.168.137.97,42468,52.84.110.205,443,237,172698,109,10019,128,162679,382.0661025,162.8661575,492.1341625,7990.806809,Benign
172.30.15.1253,50561,104.18.255.119,80,9,522,5,282,4,240,3469.523252,7.984985,282.530274,240.451297,Benign
192.168.43.224,44420,172.217.166.238,443,9,618,5,338,4,280,3062.457459,13.99462049,193.2171009,160.0615037,Benign
192.168.137.97,50870,103.211.218.251,443,170,116058,87,11671,83,104387,593.6559389,9.242464211,10102.06779,90354.25845,Benign
192.168.137.97,34766,172.217.161.10,443,16,1131,7,474,9,657,31.93337552,194.828757,19.46324587,26.97753699,Benign
192.168.43.233,51117,34.251.148.205,443,7,402,4,228,3,174,919.973489,19.938751,91.4801534,69.81380128,Benign
192.168.43.224,36316,52.20.136.189,443,306,226986,146,19542,160,207444,2844.399522,139.3958011,1121.525891,11905.32274,Benign
172.30.15.505,49787,172.25.10.224,7680,3,198,3,198,0,0,2002.643745,9.000245,175.995209,0,Benign
10.0.2.15,50592,119.254.87.201,80,11,1582,6,705,5,877,9382.453592,1.226965,4596.708138,5718.17452,Malicious
172.30.15.608,49895,104.31.90.207,80,228,179867,102,17348,126,162519,2387.209107,9.080472,15283.78701,143181.1034,Benign
172.30.15.1221,50529,50.116.239.135,443,23,8325,12,2296,11,6029,3467.267572,6.150828,2986.264613,7841.545886,Benign
10.0.2.15,33422,119.254.87.201,80,13,1741,8,853,5,888,11720.12902,10.577525,645.1414674,671.6126882,Malicious
192.168.43.224,37500,157.240.16.20,443,33,7885,16,1345,17,6540,44.08554725,1.586116445,6783.865103,32986.22883,Benign
172.30.15.1830,51142,104.16.121.145,443,16,5620,9,1120,7,4500,3864.107186,2.983485,3003.199279,12066.42567,Benign
172.30.6.255,57329,172.217.166.197,443,17,1779,10,1150,7,629,2468.42366,68.02785,135.2387294,73.96970505,Benign
192.168.43.233,51255,163.53.78.128,80,8,668,5,282,3,386,1939.520364,10.897246,207.0247841,283.3743498,Benign
172.30.6.255,55677,172.217.166.198,443,7,402,4,228,3,174,41.552318,11.505259,158.5361964,120.9881499,Benign
172.30.15.1973,51285,52.207.90.113,443,6,348,4,228,2,120,4076.531666,1.0272,1775.700935,934.5794393,Benign
10.0.2.15,40249,119.254.87.201,80,11,1582,6,705,5,877,16079.88431,2.210593,2551.351606,3173.809019,Malicious
10.0.2.15,35570,119.254.87.201,80,11,1582,6,705,5,877,20672.08482,6.507918,866.636611,1078.071359,Malicious
10.0.2.15,44625,119.254.87.201,80,11,1579,6,705,5,874,19681.22579,2.277939,2475.922314,3069.44128,Malicious
172.30.6.255,57805,103.243.221.87,80,20,10117,11,9627,9,490,4042.079856,1.514978,50836.38178,2587.49632,Benign
172.30.6.255,57813,103.243.221.87,80,31,18125,18,15013,13,3112,4043.461895,21.604718,5559.156107,1152.340891,Benign
192.168.215.49,35116,13.127.174.179,443,17,5664,10,1254,7,4410,1245.340679,0.240493309,41714.25825,146698.468,Benign
192.168.43.224,43752,172.217.166.196,443,10,692,6,412,4,280,24.95239059,12.49980643,263.6840834,179.2027751,Benign
172.30.6.255,55785,35.190.43.164,80,90,26841,46,19921,44,6920,64.453525,347.188842,459.0239683,159.4521289,Benign
10.0.2.15,57133,119.254.87.201,80,12,1587,7,779,5,808,5358.253123,5.186811,1201.508981,1246.237814,Malicious
172.30.6.255,57139,172.217.166.197,443,31,8297,18,5577,13,2720,1867.426312,62.751129,710.9991599,346.7666693,Benign
192.168.137.97,42472,52.84.110.205,443,144,98072,69,6959,75,91113,382.2947605,162.6375324,342.3072103,4481.769916,Benign
172.30.1.136,50580,157.240.16.39,443,13,726,6,336,7,390,1593.396623,23.577795,114.0055718,132.3278958,Benign
10.0.2.15,51443,119.254.87.201,80,11,1559,6,705,5,854,21690.70381,278.257549,20.26899188,24.552793,Malicious
172.30.1.136,51812,74.125.68.188,5228,18,2660,9,1573,9,1087,3009.955422,4.474261,2812.5315,1943.561183,Benign
172.30.6.255,56882,172.217.166.226,80,29,6584,15,3990,14,2594,1384.329776,279.545566,114.1853203,74.23476715,Benign
172.30.6.255,55788,180.149.59.80,443,76,79785,16,3348,60,76437,79.974616,32.572987,822.2764464,18773.10177,Benign
10.0.2.15,55707,119.254.87.201,80,11,1582,6,705,5,877,16615.44613,1.286911,4382.587452,5451.814461,Malicious
172.30.6.255,56959,54.201.177.109,80,7,402,4,228,3,174,1390.793893,13.863597,131.5675867,100.4068425,Benign
172.30.15.1204,50512,103.243.220.231,443,19,5359,10,2750,9,2609,3466.149007,11.310702,1945.060528,1845.33197,Benign
172.30.15.873,50179,151.139.104.143,80,14,5068,7,841,7,4227,3435.469579,1.679112,4006.879827,20139.21644,Benign
172.30.6.255,57299,103.243.221.51,80,34,22897,15,5581,19,17316,2402.88009,1.311245,34050.08217,105646.1607,Benign
172.30.6.255,57804,161.69.226.23,443,19,5126,10,2321,9,2805,4042.018784,257.06929,72.22955336,87.29164032,Benign
172.30.1.136,50807,157.240.16.16,443,18,5119,11,1223,7,3896,1947.927081,32.68477,299.3443124,953.5939828,Benign
10.0.2.15,40871,119.254.87.201,80,12,1656,7,779,5,877,15266.18137,4.094844,1521.9139,1713.374185,Malicious
172.30.6.255,55878,54.207.34.156,443,4,236,2,120,2,116,108.339951,10.714727,89.59630983,86.60976617,Benign
192.168.137.97,44628,151.101.193.170,443,19,7875,11,1368,8,6507,21.0044565,10.90219948,1003.834136,4774.816319,Benign
172.30.1.136,50664,172.217.161.14,443,80,31406,43,16869,37,14537,1798.103044,35.691357,3781.083471,3258.379893,Benign
10.0.2.15,43604,119.254.87.201,80,11,1579,6,705,5,874,14395.38571,1.425377,3956.847908,4905.368895,Malicious
172.30.15.1236,50544,52.198.219.213,8088,14,1980,8,1400,6,580,3468.584478,9.134165,1226.16572,507.982941,Benign
10.0.2.15,34686,119.254.87.201,80,11,1582,6,705,5,877,23943.21968,11.217389,502.790801,625.4574928,Malicious
10.0.2.15,56470,119.254.87.201,80,11,1582,6,705,5,877,11091.922,1.282949,4396.121748,5468.650741,Malicious
172.30.6.255,57814,172.217.166.206,443,17,1783,10,1154,7,629,4060.43806,69.733309,132.3901036,72.16063704,Benign
10.0.2.15,58242,119.254.87.201,80,11,1579,6,705,5,874,23978.7012,2.052409,2747.990288,3406.728386,Malicious
192.168.43.224,44588,192.168.121.2,443,7,518,7,518,0,0,2461.522658,64.80165881,63.94898026,0,Benign
10.0.2.15,37202,119.254.87.201,80,11,1582,6,705,5,877,17546.46384,1.485737,3796.09581,4722.235497,Malicious
10.0.2.15,33672,119.254.87.201,80,11,1513,6,705,5,808,15659.32776,2.363467,2386.324836,2734.965202,Malicious
172.30.15.682,49969,151.139.104.40,443,78,47554,41,3578,37,43976,2398.652165,8.233296,3476.614955,42729.91035,Benign
192.168.43.233,50916,66.77.51.230,80,5,294,3,174,2,120,372.298709,25.868164,53.81131804,37.11125382,Benign
192.168.43.233,51381,34.225.143.92,443,11,632,6,338,5,294,3477.599977,148.584007,18.19845927,15.82942907,Benign
172.30.6.255,57758,157.240.16.39,443,28,5779,15,3671,13,2108,3900.080579,61.037548,481.1464576,276.2889492,Benign
10.0.2.15,51716,119.254.87.201,80,13,1727,8,853,5,874,1359.523719,9.802413,696.1551202,713.2937574,Malicious
172.30.15.755,50045,104.25.149.25,443,26,7576,14,1776,12,5800,2582.039005,4.214691,3371.065637,11009.11075,Benign
172.30.15.1996,51308,52.86.72.168,443,19,6781,9,1141,10,5640,4077.500813,5.066592,1801.605497,8905.394395,Benign
10.0.2.15,49041,119.254.87.201,80,11,1579,6,705,5,874,5413.869207,1.911922,2949.911137,3657.052955,Malicious
172.30.6.255,56153,172.217.166.210,443,32,6969,15,2189,17,4780,406.059295,5.597375,3128.609393,6831.773823,Benign
172.30.6.255,58207,173.241.248.220,80,10,2494,6,1300,4,1194,5155.861532,8.221141,1265.031216,1161.882517,Benign
10.0.2.15,43812,119.254.87.201,80,11,1513,6,705,5,808,11299.6897,0.828017,6811.454354,7806.603005,Malicious
172.30.15.2354,51688,139.59.82.147,443,6,348,4,228,2,120,5321.730401,6.18302,295.0014718,155.2639325,Benign
192.168.137.97,35138,104.198.143.177,80,11,977,6,491,5,486,6323.810018,0.988904211,3972.073287,3931.624476,Benign
172.30.15.272,49535,172.217.166.206,443,97,50815,47,7416,50,43399,179.904761,4.73946,12517.88178,73255.60296,Benign
10.0.2.15,49473,119.254.87.201,80,11,1579,6,705,5,874,5624.033512,2.660471,2119.925382,2628.106076,Malicious
192.168.43.233,51125,182.161.72.84,443,18,7283,8,1996,10,5287,921.259968,13.467665,1185.654677,3140.559258,Benign
192.168.137.97,39780,192.168.125.6,80,283,223970,138,10216,145,213754,8327.920862,78.69942089,1038.482864,21728.64782,Benign
10.0.2.15,49340,119.254.87.201,80,11,1579,6,705,5,874,21936.57535,1.098325,5135.092072,6366.057406,Malicious
172.30.1.136,51809,52.84.108.135,443,19157,16952790,7468,437508,11689,16515282,2983.843254,849.803484,4118.674571,155473.8931,Benign
172.30.15.1985,51297,35.172.175.129,443,6,348,4,228,2,120,4077.019814,5.547524,328.7953328,173.0501752,Benign
172.30.15.1476,50784,23.8.189.227,443,31,9597,15,2259,16,7338,3509.558703,7.479222,2416.294101,7848.944716,Benign
172.30.1.136,50161,180.149.59.201,80,44,37941,15,1192,29,36749,149.490378,3.98951,2390.268479,73691.25532,Benign
172.30.1.136,51815,13.107.4.52,80,18,2820,9,700,9,2120,3011.250846,5.374027,1042.0491,3155.920132,Benign
172.30.6.255,56503,52.109.124.1,443,16,8359,8,1139,8,7220,824.019052,49.564632,183.8407677,1165.347097,Benign
192.168.137.97,36338,52.84.103.186,443,30,3098,21,2103,9,995,3757.631497,108.9821755,154.3738682,73.0394669,Benign
192.168.137.97,49082,52.84.109.5,443,20,8156,11,1389,9,6767,3705.730613,15.46355416,718.5928851,3500.876928,Benign
172.30.6.255,58090,210.176.156.41,80,16,4465,9,4028,7,437,4857.693063,7.971316,4042.494364,438.5725017,Benign
192.168.215.49,35742,172.217.194.189,443,43,10388,21,4069,22,6319,1545.056779,240.3361754,135.4436133,210.3387054,Benign
10.0.2.15,60986,119.254.87.201,80,11,1582,6,705,5,877,7370.336967,1.898278,2971.11382,3695.981305,Malicious
192.168.43.224,39684,54.243.243.77,443,9,610,5,338,4,272,174.9032706,78.22923608,34.56508251,27.8156877,Benign
172.30.15.520,49803,162.247.242.19,443,19,3062,9,2196,10,866,2126.136718,10.092368,1740.721305,686.4593126,Benign
172.30.6.255,58263,172.217.166.197,443,32,6802,17,3962,15,2840,5269.086808,54.909136,577.2445591,413.7744946,Benign
172.30.15.1850,51162,35.161.208.104,443,15,2805,8,1989,7,816,3887.7307,9.766844,1629.185436,668.3837686,Benign
172.30.1.136,50405,172.217.161.14,443,2,132,2,132,0,0,795.950231,3.000318,351.962692,0,Benign
172.30.15.1657,50968,184.29.25.7,443,42,25303,19,5456,23,19847,3587.346888,19.698204,2215.83653,8060.430281,Benign
10.0.2.15,59513,119.254.87.201,80,11,1513,6,705,5,808,8209.250312,1.491234,3782.102608,4334.665116,Malicious
192.168.43.233,51160,104.198.94.254,443,18,2617,10,1630,8,987,951.153629,57.448802,226.9847159,137.4441194,Benign
172.30.15.1229,50537,103.15.158.128,80,15,5361,8,2180,7,3181,3468.182952,10.266377,1698.749228,2478.771235,Benign
192.168.43.233,51358,172.217.160.238,443,18,5759,9,1285,9,4474,3436.2916,28.536387,360.2418204,1254.258291,Benign
192.168.215.49,51856,172.217.161.3,443,47,9340,24,3375,23,5965,1399.232454,240.4267088,112.3003353,198.4804444,Benign
172.30.6.255,57809,52.213.19.114,443,22,7159,12,1856,10,5303,4042.782668,23.070805,643.5839582,1838.860846,Benign
172.30.6.255,58311,103.243.221.51,80,33,19257,17,5743,16,13514,5353.882416,5.281157,8699.608817,20471.27173,Benign
192.168.43.224,60676,54.165.86.233,443,58,9534,32,3429,26,6105,42.53987731,622.5016277,44.06735466,78.45762618,Benign
192.168.43.224,42782,172.217.166.197,443,1382,1138463,554,99563,828,1038900,49.98338804,316.7911512,2514.287401,26235.5813,Benign
172.30.15.1300,50608,204.79.197.200,443,68,23324,32,11029,36,12295,3473.111747,4.394982,20075.62261,22380.06891,Benign
172.30.15.2278,51597,87.250.251.119,443,6,348,4,228,2,120,4538.278356,9.473402,192.5390689,101.336352,Benign
172.30.15.2171,51483,52.84.108.186,443,18,6927,9,1165,9,5762,4245.574163,0.277337,33605.32493,166209.341,Benign
10.0.2.15,39095,119.254.87.201,80,11,1579,6,705,5,874,911.497998,1.815535,3106.52232,3851.206394,Malicious
172.30.1.136,50325,104.244.46.103,443,29,11235,16,2486,13,8749,568.373026,36.631015,542.9278987,1910.730565,Benign
10.0.2.15,37708,119.254.87.201,80,11,1579,6,705,5,874,9682.839377,0.826124,6827.062281,8463.620473,Malicious
172.30.6.255,57402,103.243.221.75,80,6,340,4,228,2,112,2711.555062,10.478995,174.0624936,85.50438282,Benign
172.30.6.255,56417,205.180.87.204,80,11,1476,6,844,5,632,678.978696,1.685016,4007.083612,3000.56498,Benign
192.168.137.97,45262,52.84.108.195,443,12,2525,7,1642,5,883,1947.956957,0.083051277,158167.3452,85055.88662,Benign
10.0.2.15,47018,119.254.87.201,80,11,1579,6,705,5,874,21032.50204,1.29576,4352.6579,5396.060999,Malicious
172.30.6.255,56596,52.175.23.79,443,30,10184,16,2281,14,7903,914.667769,70.23121,259.827504,900.2265517,Benign
192.168.137.97,42486,216.58.196.202,443,17,1178,9,630,8,548,3833.314062,33.81525629,149.0451516,129.6456239,Benign
172.30.15.2192,51504,31.24.224.56,443,19,7774,10,1186,9,6588,4282.612086,0.792452,11972.96492,66507.49825,Benign
172.30.1.136,50321,104.244.46.103,443,27,8340,18,3755,9,4585,568.128657,40.971721,733.1886303,895.2516298,Benign
172.30.15.1890,51202,23.57.208.237,443,51,36318,21,2222,30,34096,3974.677766,2.668393,6661.68739,102221.8241,Benign
172.30.6.255,57715,103.243.221.87,80,16,6241,9,5064,7,1177,3714.594991,24.458626,1656.348153,384.976654,Benign
192.168.137.97,43328,169.60.79.77,443,11,766,8,560,3,206,4041.184609,20.58076447,217.6789888,80.07477089,Benign
192.168.43.224,45812,54.173.101.22,443,40,9177,21,3825,19,5352,697.6145592,62.27237661,491.3896284,687.5600761,Benign
172.30.1.136,51792,54.255.158.169,443,52,14338,30,5556,22,8782,2977.306869,41.459851,1072.073317,1694.555053,Benign
10.0.2.15,41375,119.254.87.201,80,13,1661,8,853,5,808,8451.632911,10.909393,625.5160118,592.5169256,Malicious
172.30.6.255,57005,103.243.221.51,80,21,11091,10,4552,11,6539,1497.846604,25.218325,1444.029292,2074.364574,Benign
10.0.2.15,53046,119.254.87.201,80,11,1513,6,705,5,808,13887.39961,1.935719,2913.646041,3339.327661,Malicious
192.168.215.49,53862,54.165.86.233,443,52,8506,26,2892,26,5614,555.8338456,610.895935,37.87224415,73.51824988,Benign
172.30.6.255,56441,52.68.71.55,443,7,402,4,228,3,174,700.568648,8.465471,215.4634987,164.4326701,Benign
172.30.15.1904,51216,205.185.216.42,443,26,8805,12,1682,14,7123,3984.829154,2.567346,5241.210184,22195.68379,Benign
172.30.15.1516,50824,151.101.65.140,443,25,7976,13,1820,12,6156,3525.461995,1.576301,9236.814542,31242.76391,Benign
172.30.15.1191,50499,103.71.26.125,80,11,1928,6,1077,5,851,3465.313613,1.909385,4512.447725,3565.545974,Benign
172.30.1.136,50574,52.84.103.186,443,38,19010,23,6324,15,12686,1574.142624,33.68581,1501.878684,3012.78194,Benign
10.0.2.15,32957,119.254.87.201,80,11,1582,6,705,5,877,11274.57918,1.713901,3290.738497,4093.585335,Malicious
10.0.2.15,43797,119.254.87.201,80,11,1582,6,705,5,877,6674.984864,2.155321,2616.779589,3255.199574,Malicious
172.30.6.255,55810,204.2.197.204,80,6,348,4,228,2,120,91.006107,11.098887,164.3408028,86.49515938,Benign
172.30.1.136,51829,52.84.110.227,443,13,1537,7,970,6,567,3304.976071,2.423057,3202.566015,1872.015392,Benign
172.30.15.2330,51663,52.84.108.208,443,1805,1641465,683,40919,1122,1600546,5082.37348,15.381585,21282.07204,832447.8914,Benign
172.30.6.255,55964,52.220.13.130,443,23,8515,12,1999,11,6516,166.030486,61.368016,260.5917715,849.4327077,Benign
192.168.137.97,56428,172.217.161.5,443,9,610,5,350,4,260,980.9912319,55.98636027,50.0121813,37.15190611,Benign
192.168.215.49,41198,54.86.213.171,443,9,610,5,338,4,272,551.2070593,83.29288502,32.46375725,26.12468039,Benign
172.30.6.255,56794,210.176.156.41,80,176,103876,90,74949,86,28927,1253.9228,729.041361,822.4389343,317.4250631,Benign
172.30.6.255,55984,103.243.221.75,80,6,340,4,228,2,112,183.047652,30.986561,58.86422827,28.91576126,Benign
172.30.15.2208,51523,13.107.21.200,443,121,91993,46,3947,75,88046,4432.810291,5.360387,5890.619465,131402.4528,Benign
172.30.15.324,49590,172.217.166.206,443,27,7614,13,2596,14,5018,814.227216,5.919332,3508.504,6781.84633,Benign
10.0.2.15,48140,119.254.87.201,80,11,1582,6,705,5,877,13346.61007,6.134824,919.3417774,1143.63509,Malicious
172.30.6.255,57883,103.243.221.75,80,33,18507,17,5735,16,12772,4303.840173,41.191391,1113.824974,2480.51832,Benign
172.30.6.255,57263,157.240.16.39,443,19,1933,10,1125,9,808,2253.094649,61.025092,147.4803184,105.923642,Benign
192.168.43.224,46176,157.240.16.16,443,318,68962,180,29929,138,39033,45.70525179,1501.178015,159.4960742,208.0126387,Benign
172.30.15.855,50161,204.79.197.200,443,563,333008,229,29698,334,303310,3427.93861,9.113805,26068.58497,266242.2556,Benign
172.30.15.1813,51125,184.29.24.149,443,12,1433,6,914,6,519,3743.356661,3.73071,1959.948642,1112.924886,Benign
10.0.2.15,53085,119.254.87.201,80,11,1593,6,705,5,888,21483.02986,2.219264,2541.383089,3201.061253,Malicious
10.0.2.15,54507,119.254.87.201,80,11,1579,6,705,5,874,12020.3811,1.360223,4146.378939,5140.333607,Malicious
172.30.15.346,49614,172.217.166.197,443,53,29387,23,4309,30,25078,1090.915049,9.304836,3704.740202,21561.26126,Benign
172.30.15.1016,50322,52.85.51.95,443,21,8579,11,1813,10,6766,3444.612206,2.612884,5550.954424,20715.80675,Benign
192.168.43.224,51292,74.125.130.188,5228,78,12177,41,3520,37,8657,5.955757645,1215.941822,23.15900275,56.95667239,Benign
172.30.6.255,57712,103.243.221.87,80,7,406,5,294,2,112,3713.849413,25.204255,93.31757673,35.54955304,Benign
172.30.15.2491,51825,14.139.45.128,80,10,1434,5,701,5,733,5434.713359,0.383131,14637.29116,15305.46993,Benign
172.30.6.255,56378,103.243.221.46,80,23,13083,11,4930,12,8153,632.126859,17.355266,2272.509105,3758.167694,Benign
10.0.2.15,53293,119.254.87.201,80,11,1582,6,705,5,877,2475.032741,1.288785,4376.214807,5443.887072,Malicious
192.168.43.233,50904,172.217.166.195,443,11,642,6,348,5,294,295.11227,39.802108,69.94604406,59.09234757,Benign
192.168.137.97,50058,104.237.191.1,443,7,518,7,518,0,0,1822.587167,63.78223098,64.97107323,0,Benign
192.168.137.97,50874,103.211.218.251,443,149,101587,74,8849,75,92738,593.6738256,9.224654597,7674.216878,80426.20915,Benign
192.168.137.97,41576,54.210.3.254,443,28,7809,13,3004,15,4805,6965.840742,4.384043431,5481.697519,8768.161312,Benign
192.168.137.97,35832,103.102.166.240,443,11,738,6,404,5,334,5424.696911,114.3175905,28.27211443,23.37348074,Benign
172.30.6.255,58276,35.190.43.164,80,14,2984,8,2196,6,788,5288.08533,35.907557,489.2563423,175.5619298,Benign
10.0.2.15,45388,119.254.87.201,80,11,1579,6,705,5,874,10939.30793,1.222502,4613.489385,5719.418046,Malicious
172.30.15.588,49873,23.198.129.83,443,32,13016,16,2074,16,10942,2313.225458,3.03009,5475.744945,28888.91089,Benign
172.30.15.546,49830,204.11.109.66,443,21,8994,10,2362,11,6632,2251.817067,4.498366,4200.636409,11794.50494,Benign
192.168.43.224,49184,172.217.166.234,80,109,68630,55,4039,54,64591,804.2978565,269.5221385,119.8862556,1917.200579,Benign
172.30.15.1489,50797,151.101.193.2,443,12,1425,6,904,6,521,3520.963561,6.164892,1173.094354,676.0864586,Benign
192.168.137.97,39898,172.217.161.14,443,19,6009,10,1443,9,4566,4954.500945,52.43498764,220.1583431,696.6340919,Benign
10.0.2.15,55976,119.254.87.201,80,11,1582,6,705,5,877,26318.9828,1.360703,4144.916268,5156.158251,Malicious
172.30.6.255,56929,54.169.236.196,80,10,2160,6,1696,4,464,1387.022978,17.414427,779.1241136,213.1565971,Benign
10.0.2.15,55861,119.254.87.201,80,11,1513,6,705,5,808,16767.78674,3.245094,1738.008206,1991.929972,Malicious
172.30.15.1593,50902,52.84.101.37,443,148,122058,58,4213,90,117845,3572.5043,4.508115,7476.295525,209125.1,Benign
10.0.2.15,46438,119.254.87.201,80,11,1569,6,705,5,864,11212.0974,1.424392,3959.584159,4852.596757,Malicious
172.30.6.255,56237,103.243.221.17,80,31,22385,11,4240,20,18145,500.85749,21.594694,1570.756224,6722.021623,Benign
10.0.2.15,47913,119.254.87.201,80,11,1568,6,705,5,863,7280.352697,2.317604,2433.54775,2978.938593,Malicious
172.30.6.255,58176,173.241.248.220,80,13,2669,7,1355,6,1314,5023.848723,66.176049,163.805488,158.849012,Benign
172.30.6.255,57780,103.243.221.51,80,21,10661,10,4541,11,6120,3981.84036,13.210322,2749.970818,3706.192779,Benign
172.30.6.255,57836,157.240.16.39,443,28,5421,15,3274,13,2147,4144.392197,60.739693,431.2171943,282.7804875,Benign
192.168.43.224,32878,172.217.166.195,443,20,6735,11,1356,9,5379,12.90249052,2.468601931,4394.390146,17431.72905,Benign
172.30.6.255,56642,172.30.6.35,445,3,198,3,198,0,0,1032.387744,9.000178,175.9965192,0,Benign
10.0.2.15,44948,119.254.87.201,80,11,1558,6,705,5,853,22266.95282,2.155396,2616.688534,3166.007546,Malicious
172.30.6.255,58523,161.69.36.37,80,7,398,4,228,3,170,5775.952436,0.611336,2983.629297,2224.635879,Benign
192.168.137.97,53198,52.84.108.11,443,24,3335,13,2038,11,1297,5666.972753,212.3672843,76.77265381,48.85874975,Benign
172.30.15.301,49564,131.247.120.10,443,85,51924,28,3926,57,47998,666.304495,3.845018,8168.492319,99865.33223,Benign
172.30.6.255,56190,151.101.66.49,80,10,1609,5,941,5,668,466.617251,0.510589,14743.75672,10466.34377,Benign
192.168.43.224,38496,140.98.193.112,443,32,15084,17,4366,15,10718,3265.895138,9.475452948,3686.156239,9049.066094,Benign
192.168.43.233,51398,172.217.161.14,443,27,9329,13,2300,14,7029,3626.455048,20.096533,915.5808119,2798.094577,Benign
172.30.6.255,56539,23.198.119.247,443,21,9385,11,1300,10,8085,832.151469,41.434849,250.9964499,1561.004844,Benign
192.168.137.97,41178,23.57.218.60,443,35,8664,20,6310,15,2354,81.5723026,105.2885353,479.444413,178.8608793,Benign
10.0.2.15,42324,119.254.87.201,80,11,1568,6,705,5,863,14725.71184,1.772792,3181.422299,3894.421906,Malicious
10.0.2.15,49592,119.254.87.201,80,11,1582,6,705,5,877,23372.59782,2.080832,2710.45428,3371.728232,Malicious
172.30.1.136,50581,52.84.103.186,443,4233,3219217,1955,138198,2278,3081019,1593.399657,202.446545,5461.115674,121751.4085,Benign
192.168.43.224,35166,35.171.73.174,443,16,5004,9,1258,7,3746,1252.713151,27.09427376,371.4437999,1106.06397,Benign
192.168.43.224,51230,54.236.156.42,443,40,8415,20,3018,20,5397,44.38449163,63.98819282,377.3196106,674.7494826,Benign
192.168.43.233,51192,192.229.237.96,443,7,402,4,228,3,174,1102.53017,35.870891,50.84902965,38.80583842,Benign
192.168.137.97,47624,104.198.143.177,80,10,911,5,425,5,486,1542.316864,0.786604667,4322.374558,4942.762436,Benign
192.168.137.97,55960,169.44.84.154,443,892,484314,424,38507,468,445807,2848.247077,232.1894389,1326.744237,15360.11292,Benign
172.30.15.1862,51174,35.161.208.104,443,6,348,4,228,2,120,3919.511266,7.991016,228.2563319,120.1349115,Benign
192.168.43.224,33942,52.84.108.93,443,24,7491,14,1583,10,5908,2848.511493,34.04317039,371.9982556,1388.354829,Benign
10.0.2.15,55239,119.254.87.201,80,11,1579,6,705,5,874,19624.01831,1.414983,3985.913612,4941.402123,Malicious
172.30.6.255,56747,13.107.4.52,80,10,1476,5,393,5,1083,1243.49165,0.127835,24594.20347,67774.86604,Benign
192.168.43.224,50576,49.44.150.71,443,557,382402,278,36931,279,345471,2283.052873,525.4837163,562.2400672,5259.474108,Benign
172.30.15.759,50049,169.55.60.80,443,6,348,4,228,2,120,2589.227327,7.16699,254.5001458,133.9474452,Benign
192.168.43.233,51363,52.216.18.144,443,17,1006,10,588,7,418,3436.470979,28.357594,165.8814919,117.9225572,Benign
172.30.6.255,58244,103.243.221.75,80,8,448,5,282,3,166,5222.093247,40.080085,56.28730578,33.13366227,Benign
172.30.6.255,56004,199.166.0.200,443,19,8827,9,1711,10,7116,225.297846,0.617089,22181.56538,92252.49518,Benign
172.30.15.364,49632,195.154.150.142,80,6,348,4,228,2,120,1401.806352,8.710367,209.4056427,110.2134962,Benign
172.30.6.255,58560,157.240.16.17,443,371,308279,154,10588,217,297691,5841.4523,7.640493,11086.19562,311698.2111,Benign
172.30.6.255,56547,52.114.74.43,443,32,14715,19,7504,13,7211,833.273241,40.315697,1489.047802,1430.906676,Benign
192.168.43.224,58622,104.197.3.80,80,10,911,5,425,5,486,323.814038,1.348677015,2520.98906,2882.825137,Benign
10.0.2.15,38279,119.254.87.201,80,11,1582,6,705,5,877,23252.46162,1.594283,3537.640431,4400.724338,Malicious
172.30.1.136,51873,172.217.160.228,443,14,1743,7,1181,7,562,4185.846094,19.336881,488.5999971,232.5090587,Benign
172.30.6.255,56474,52.114.76.35,443,25,11329,14,3327,11,8002,777.577072,9.168559,2902.964359,6982.122272,Benign
192.168.43.224,36800,169.55.74.36,443,6,412,4,272,2,140,1154.430788,73.1864853,29.73226534,15.30337187,Benign
172.30.15.1424,50732,159.127.41.201,443,6,344,4,228,2,116,3500.406313,6.835286,266.8505751,135.7660821,Benign
172.30.15.1001,50307,188.125.88.204,443,7,402,4,228,3,174,3443.293122,3.967354,459.7522681,350.8635731,Benign
192.168.43.224,33104,54.243.243.77,443,587,426698,282,71488,305,355210,680.9578123,502.9503218,1137.098388,5650.021238,Benign
192.168.215.49,38590,104.113.142.99,443,138,119122,47,5520,91,113602,1251.961891,330.7389007,133.5192199,2747.83522,Benign
10.0.2.15,55268,119.254.87.201,80,11,1582,6,705,5,877,24309.07617,2.14603,2628.108647,3269.292601,Malicious
192.168.43.224,39074,103.37.200.184,443,18,1980,9,1182,9,798,2514.138834,27.8148044,339.9628436,229.5180619,Benign
192.168.137.97,60970,206.189.157.46,443,170,146359,63,5893,107,140466,420.4983447,147.8441071,318.8764228,7600.762872,Benign
192.168.43.224,41930,23.251.156.28,443,8,544,5,338,3,206,893.1759811,51.93960095,52.06046928,31.72916175,Benign
192.168.43.233,51188,151.101.153.170,443,9,534,5,294,4,240,1082.306744,21.456188,109.6187263,89.48467454,Benign
172.30.15.581,49866,14.139.45.149,80,33,20264,16,1398,17,18866,2298.411956,1.499401,7458.978619,100658.8631,Benign
172.30.1.136,51817,74.125.68.188,5228,29,2915,15,1645,14,1270,3015.774457,288.011414,45.69263356,35.27637971,Benign
10.0.2.15,35508,119.254.87.201,80,11,1582,6,705,5,877,23763.00752,2.218269,2542.523021,3162.82651,Malicious
192.168.43.224,40192,54.243.243.77,443,6,412,4,272,2,140,2640.056985,11.39800835,190.9105463,98.26278116,Benign
192.168.43.233,51691,23.66.249.177,80,17,6299,8,681,9,5618,1145.761211,62.805121,86.74451881,715.6104357,Benign
10.0.2.15,36660,119.254.87.201,80,11,1582,6,705,5,877,23795.99842,1.166126,4836.527099,6016.502505,Malicious
172.30.1.136,50415,172.217.161.4,443,35,6017,16,2637,19,3380,827.347993,4.054258,5203.418233,6669.531145,Benign
172.30.15.205,49485,180.149.59.227,80,12,1734,7,960,5,774,6.314178,60.047555,127.8986297,103.1182702,Benign
172.30.15.2412,51746,172.217.166.195,443,118,78798,50,4546,68,74252,5345.67473,12.177371,2986.523117,48780.31555,Benign
172.30.6.255,57290,103.243.221.46,80,40,24209,23,20055,17,4154,2369.83187,33.229683,4828.213378,1000.069727,Benign
192.168.43.224,42746,54.86.164.29,443,23,9112,13,1647,10,7465,3021.931217,14.08546973,935.4320624,4239.830204,Benign
172.30.6.255,58200,157.240.16.17,443,1990,1692911,814,57956,1176,1634955,5101.17252,22.806148,20329.95664,573513.7736,Benign
172.30.6.255,57563,103.243.221.17,80,23,10805,14,8623,9,2182,3253.846558,28.221382,2444.387734,618.5380999,Benign
192.168.43.233,51119,49.44.170.41,443,35,10665,17,2283,18,8382,920.25671,315.915787,57.8128753,212.259098,Benign
192.168.43.233,51075,151.101.154.110,443,83,26118,40,3175,43,22943,915.730526,601.607029,42.22025139,305.0895205,Benign
192.168.43.224,39064,103.37.200.184,443,71,40072,36,3629,35,36443,2513.961662,7.83806233,3703.976669,37195.92773,Benign
10.0.2.15,38214,119.254.87.201,80,12,1656,7,779,5,877,20551.94227,4.453546,1399.334373,1575.373871,Malicious
10.0.2.15,51102,119.254.87.201,80,11,1579,6,705,5,874,22684.56445,1.621433,3478.404596,4312.234918,Malicious
172.30.15.2459,51793,14.139.45.128,80,10,1394,5,664,5,730,5420.973914,0.152782,34768.49367,38224.39816,Benign
192.168.43.233,51351,52.216.18.144,443,32,9175,15,2042,17,7133,3424.001594,10.553544,1547.916037,5407.093579,Benign
10.0.2.15,59570,119.254.87.201,80,11,1513,6,705,5,808,1479.576464,1.68815,3340.935343,3829.043628,Malicious
172.30.15.338,49606,104.25.219.21,443,18,6485,10,1145,8,5340,982.64361,7.494953,1222.155763,5699.835609,Benign
10.0.2.15,51341,119.254.87.201,80,11,1582,6,705,5,877,20339.222,3.583926,1573.693207,1957.629706,Malicious
192.168.43.224,48210,104.237.191.1,443,6,408,3,206,3,202,1355.574445,1.309527631,1258.469055,1234.032762,Benign
10.0.2.15,57712,119.254.87.201,80,11,1579,6,705,5,874,522.919175,1.025422,5500.174562,6818.656124,Malicious
172.30.6.255,57608,172.217.166.206,443,17,1779,10,1150,7,629,3376.414131,93.792501,98.08886533,53.6503446,Benign
10.0.2.15,45643,119.254.87.201,80,11,1582,6,705,5,877,22141.20854,2.820114,1999.919152,2487.84269,Malicious
10.0.2.15,48222,119.254.87.201,80,11,1579,6,705,5,874,16891.02816,1.371219,4113.128537,5099.112541,Malicious
172.30.6.255,55654,159.180.93.4,443,48,24489,23,2695,25,21794,37.398433,21.264216,1013.909941,8199.314755,Benign
192.168.43.233,51462,157.240.16.16,443,7,402,4,228,3,174,3813.640991,15.530035,117.4498319,89.63276644,Benign
192.168.43.224,41888,23.251.156.28,443,803,666705,325,31762,478,634943,714.9335232,172.9582958,1469.117158,29368.60575,Benign
172.30.15.1368,50676,151.101.128.166,443,8,480,5,294,3,186,3493.434098,3.598928,653.5279394,413.4564515,Benign
10.0.2.15,57989,219.234.85.243,80,7,428,4,236,3,192,89.555332,0.405203,4659.392946,3790.692566,Malicious
192.168.43.224,36156,104.244.42.67,443,71,12287,36,4700,35,7587,37.91180546,906.9531966,41.45748661,66.92296828,Benign
10.0.2.15,43905,119.254.87.201,80,11,1579,6,705,5,874,22023.58084,2.12175,2658.183104,3295.392954,Malicious
192.168.43.224,51804,54.173.101.22,443,184,40906,98,19352,86,21554,34.0487616,100.4500993,1541.222966,1716.593624,Benign
172.30.6.255,56189,192.132.33.27,443,35,15248,21,2582,14,12666,466.791698,96.950879,213.0563458,1045.147822,Benign
10.0.2.15,40046,119.254.87.201,80,11,1513,6,705,5,808,11845.07551,1.42368,3961.564396,4540.346145,Malicious
192.168.43.233,51353,52.216.18.144,443,7,409,4,228,3,181,3424.069293,12.996179,140.3489441,111.4173635,Benign
10.0.2.15,54940,119.254.87.201,80,11,1582,6,705,5,877,19828.73336,2.331704,2418.831893,3008.958255,Malicious
172.30.6.255,56720,34.210.162.213,443,6,340,4,228,2,112,1191.015173,11.187831,163.0342825,80.08701597,Benign
10.0.2.15,40510,119.254.87.201,80,11,1534,6,705,5,829,10338.70038,0.886218,6364.122597,7483.486005,Malicious
172.30.15.1574,50883,104.16.208.165,443,20,4283,10,1756,10,2527,3560.563734,6.45305,2176.955083,3132.782173,Benign
172.30.15.1456,50764,103.231.98.244,443,18,6185,9,844,9,5341,3502.910349,1.028667,6563.834555,41537.25161,Benign
172.30.15.390,49658,62.210.213.13,80,18,8496,8,829,10,7667,1466.474226,4.0453,1639.433417,15162.2871,Benign
172.30.6.255,56093,54.193.113.6,80,13,1900,7,860,6,1040,305.960619,63.15399,108.9400686,131.7414783,Benign
192.168.43.233,51147,173.241.248.143,443,39,6465,20,2251,19,4214,925.765356,89.503129,201.1996698,376.6572228,Benign
192.168.42.240,50561,52.230.84.217,443,15,2338,8,505,7,1833,144.81936,470.695254,8.583048088,31.15391514,Benign
172.30.15.729,50016,162.125.82.3,443,6,348,4,228,2,120,2434.00658,0.337818,5399.35705,2841.766869,Benign
10.0.2.15,38094,119.254.87.201,80,11,1513,6,705,5,808,20251.72131,1.662458,3392.56691,3888.218529,Malicious
172.30.15.1960,51272,54.236.156.42,443,6,348,4,228,2,120,4073.403525,4.1373,440.8672323,232.0353854,Benign
172.30.6.255,56839,104.122.112.145,443,34,7519,17,2342,17,5177,1328.287682,336.165035,55.73452932,123.2013912,Benign
10.0.2.15,57367,119.254.87.201,80,11,1582,6,705,5,877,24877.28529,2.088981,2699.880947,3358.575305,Malicious
192.168.42.240,50926,104.25.219.21,443,19,1062,8,432,11,630,103.04956,5.601185,617.0122929,899.8095939,Benign
172.30.15.1259,50567,151.139.104.143,80,7,402,5,282,2,120,3469.531167,7.9949,282.1798897,120.0765488,Benign
192.168.43.224,58636,172.217.167.14,443,17,5876,9,1377,8,4499,36.55586702,11.67728483,943.3699836,3082.223352,Benign
192.168.43.224,57464,172.217.166.197,443,7,466,4,272,3,194,743.8244646,56.0522811,38.82090001,27.68843604,Benign
192.168.43.224,50960,23.251.156.28,443,6,412,4,272,2,140,2651.912844,11.16178261,194.950939,100.342395,Benign
192.168.43.224,32838,151.101.112.193,443,192,127155,87,7349,105,119806,807.1476906,603.4891764,97.42013991,1588.177614,Benign
192.168.215.49,49836,172.217.161.14,443,31,6864,16,1839,15,5025,979.8116702,249.5782826,58.94743665,161.071707,Benign
10.0.2.15,49609,119.254.87.201,80,11,1582,6,705,5,877,12956.08319,1.955619,2883.997343,3587.610879,Malicious
10.0.2.15,40607,119.254.87.201,80,11,1579,6,705,5,874,8476.699606,1.969122,2864.220703,3550.821127,Malicious
172.30.6.255,56192,151.101.130.2,80,25,2665,12,1256,13,1409,466.791856,303.230242,33.13653656,37.17307326,Benign
172.30.15.1735,51046,131.253.61.98,443,79,30387,33,7687,46,22700,3625.337252,66.700845,921.9673304,2722.604189,Benign
172.30.15.606,49893,104.31.90.207,80,125,101007,53,15808,72,85199,2387.120935,9.168586,13793.18469,74339.92548,Benign
172.30.15.1726,51037,184.29.25.7,443,78,57866,36,12256,42,45610,3619.631957,7.403794,13242.94004,49282.84066,Benign
10.0.2.15,37318,119.254.87.201,80,11,1579,6,705,5,874,10461.36986,0.846527,6662.516376,8259.63023,Malicious
172.30.6.255,57632,103.243.221.75,80,8,449,5,283,3,166,3451.094232,45.97473,49.24444363,28.88543337,Benign
10.0.2.15,44974,119.254.87.201,80,11,1582,6,705,5,877,19774.21661,2.204727,2558.139851,3182.253404,Malicious
10.0.2.15,50270,119.254.87.201,80,11,1579,6,705,5,874,1870.092057,0.886564,6361.638866,7886.627474,Malicious
172.30.15.768,50059,104.244.42.8,443,34,9010,18,3225,16,5785,2623.027748,3.360358,7677.753382,13772.34211,Benign
172.30.6.255,56895,122.15.34.17,80,27,6156,15,4188,12,1968,1384.802686,311.003551,107.7286735,50.6232162,Benign
10.0.2.15,42885,119.254.87.201,80,11,1579,6,705,5,874,19318.16961,2.318745,2432.350258,3015.424292,Malicious
10.0.2.15,52720,119.254.87.201,80,11,1579,6,705,5,874,23492.74504,2.11636,2664.953033,3303.785745,Malicious
192.168.137.97,37674,172.217.194.189,443,15,1030,8,572,7,458,102.809806,37.74799707,121.224975,97.06475269,Benign
172.30.15.387,49655,62.210.213.13,80,44,31825,18,2151,26,29674,1466.058807,4.466224,3852.919155,53152.73036,Benign
10.0.2.15,38058,119.254.87.201,80,11,1513,6,705,5,808,7968.848567,2.326591,2424.147605,2778.313851,Malicious
192.168.43.224,33048,35.171.73.174,443,30,6656,16,2098,14,4558,1246.710195,61.82176738,271.4901354,589.8246126,Benign
10.0.2.15,37241,119.254.87.201,80,11,1579,6,705,5,874,11574.96243,1.419593,3972.969717,4925.355366,Malicious
172.30.6.255,56913,63.251.88.56,80,9,506,7,390,2,116,1385.846719,27.73624,112.4882104,33.4580318,Benign
172.30.6.255,57605,103.243.221.87,80,14,6072,8,4444,6,1628,3375.88606,3.63264,9786.821705,3585.271318,Benign
172.30.6.255,56932,103.15.158.189,80,11,2978,6,1762,5,1216,1387.581409,10.267735,1372.844157,947.433879,Benign
192.168.43.233,51099,162.247.242.20,443,4,236,2,120,2,116,918.15014,11.127931,86.26940624,83.39375936,Benign
172.30.15.1526,50834,104.244.42.72,443,27,6448,15,5071,12,1377,3526.782481,10.35222,3918.772978,1064.11958,Benign
192.168.43.224,45536,172.217.166.196,443,19,6017,10,1443,9,4574,1253.995037,25.81264268,447.2227096,1417.599912,Benign
172.30.15.326,49592,104.25.218.21,443,110,45163,51,4994,59,40169,865.268666,4.932577,8099.620138,65148.90695,Benign
172.30.15.1892,51204,52.84.108.203,443,111,90581,41,3651,70,86930,3976.724288,10.529585,2773.898496,66046.28767,Benign
172.30.6.255,55972,104.122.118.96,443,30,7116,15,2271,15,4845,166.860915,244.766086,74.22596936,158.3552715,Benign
172.30.1.136,50148,172.217.194.154,443,19,5287,10,1597,9,3690,121.474407,10.579885,1207.574562,2790.200461,Benign
10.0.2.15,35502,119.254.87.201,80,12,1656,7,779,5,877,5236.051559,3.841589,1622.245378,1826.327595,Malicious
172.30.6.255,57507,161.69.38.37,80,7,398,4,228,3,170,3067.299885,0.606136,3009.225652,2243.720881,Benign
172.30.1.136,50393,172.217.161.14,443,3,198,3,198,0,0,754.219577,9.000541,175.9894211,0,Benign
192.168.43.224,41090,103.102.166.224,443,351,248648,149,13051,202,235597,730.1098296,225.6084324,462.7841206,8354.191284,Benign
172.30.1.136,50543,172.217.161.14,443,27,3400,13,1881,14,1519,1339.942229,63.467515,237.0976711,191.468029,Benign
192.168.137.97,39756,172.217.161.14,443,18,1240,12,860,6,380,3758.369678,89.70523451,76.69563586,33.88876933,Benign
192.168.137.97,60762,172.217.161.3,80,28,2317,17,1492,11,825,3775.954193,285.6777142,41.78134803,23.10295719,Benign
10.0.2.15,33153,119.254.87.201,80,11,1579,6,705,5,874,2925.47948,1.614422,3493.510371,4330.961793,Malicious
10.0.2.15,53647,119.254.87.201,80,11,1579,6,705,5,874,19530.99123,1.418122,3977.090829,4930.464375,Malicious
172.30.6.255,56952,52.221.102.82,443,20,7251,11,2630,9,4621,1389.478028,64.776482,324.8092417,570.7009529,Benign
172.30.1.136,50523,157.240.16.39,443,81,25749,39,15640,42,10109,1031.085885,97.029763,1289.501243,833.476219,Benign
172.30.6.255,56422,35.201.123.46,443,7,402,4,228,3,174,679.144675,18.768416,97.18454663,74.16715401,Benign
192.168.137.97,34188,192.229.237.96,443,1214,857948,491,38844,723,819104,144.4498536,427.947391,726.1453313,15312.23729,Benign
192.168.43.233,51370,151.101.152.65,443,49,16298,24,3335,25,12963,3470.720491,324.848183,82.13067333,319.2383563,Benign
172.30.6.255,55869,210.176.156.55,443,85,47715,47,31391,38,16324,105.374932,306.694931,818.8201845,425.8042335,Benign
192.168.43.224,56910,167.114.119.85,443,46,13155,25,4280,21,8875,2479.221425,365.0957132,93.78362648,194.4695526,Benign
172.30.6.255,55856,172.217.167.34,80,51,17286,26,11886,25,5400,103.711993,307.902015,308.8255204,140.3043757,Benign
192.168.43.233,51216,40.114.211.99,443,22,9095,12,2138,10,6957,1247.271051,123.189263,138.8432692,451.7926209,Benign
172.30.15.754,50044,34.213.23.47,443,6,340,4,228,2,112,2578.703722,7.816163,233.3625847,114.6342521,Benign
10.0.2.15,45449,119.254.87.201,80,11,1579,6,705,5,874,8296.666614,2.016984,2796.254209,3466.561956,Malicious
192.168.137.97,48784,23.57.214.252,443,65,13205,35,9114,30,4091,902.7322002,908.8638405,80.2232378,36.00979436,Benign
172.30.1.136,51770,52.84.110.12,443,46,13577,20,2286,26,11291,2965.976348,200.086913,91.40028064,451.4438183,Benign
10.0.2.15,57006,119.254.87.201,80,11,1579,6,705,5,874,20882.3169,10.593664,532.3937025,660.0171574,Malicious
192.168.43.224,58298,23.23.105.113,443,25,8325,14,1551,11,6774,93.63177626,13.13782084,944.4488662,4124.88499,Benign
192.168.43.233,51386,172.217.161.2,443,22,5194,11,1384,11,3810,3478.370928,147.064212,75.28684137,207.2564058,Benign
172.30.1.136,50639,172.217.161.3,443,154,120544,61,5425,93,115119,1745.580437,51.103282,849.260523,18021.38657,Benign
10.0.2.15,44988,119.254.87.201,80,11,1579,6,705,5,874,20582.00185,1.617513,3486.834418,4322.685505,Malicious
10.0.2.15,50447,119.254.87.201,80,11,1579,6,705,5,874,5178.108624,3.98411,1415.623565,1754.971625,Malicious
172.30.1.136,50410,74.125.24.188,5228,26,3341,15,2147,11,1194,827.097032,36.300543,473.1609662,263.1365597,Benign
192.168.43.233,51211,52.114.14.1,443,3,198,1,66,2,132,1242.871823,3.143016,167.9915088,335.9830176,Benign
192.168.43.233,51148,173.241.248.143,443,7,402,4,228,3,174,925.827842,14.740285,123.7425192,94.43508046,Benign
172.30.15.678,49965,52.84.114.151,443,24,10025,13,2767,11,7258,2397.932762,8.212728,2695.328519,7070.001588,Benign
10.0.2.15,57581,219.234.85.243,80,8,944,4,688,4,256,251.40131,77.348537,71.15842411,26.47755316,Malicious
192.168.137.97,43316,169.60.79.77,443,599,438404,238,20358,361,418046,4022.69127,24.82346307,6560.889571,134726.0852,Benign
172.30.1.136,50207,172.217.161.14,443,149,55295,69,13829,80,41466,363.44149,18.674133,5924.344654,17764.03756,Benign
192.168.137.97,43270,108.177.122.94,443,18,5951,10,1443,8,4508,341.2144767,14.49662677,796.3231851,2487.751156,Benign
172.30.6.255,55947,52.23.112.47,443,6,348,4,228,2,120,153.143971,11.259852,161.991472,85.25866947,Benign
172.30.1.136,51804,172.217.160.227,443,53,12633,25,5305,28,7328,2977.688288,38.489977,1102.624717,1523.097818,Benign
10.0.2.15,38620,119.254.87.201,80,12,1653,7,779,5,874,17308.36569,4.606474,1352.878579,1517.863772,Malicious
10.0.2.15,35750,119.254.87.201,80,11,1582,6,705,5,877,26381.49439,1.420613,3970.117125,4938.713077,Malicious
172.30.6.255,56856,103.243.220.231,80,6,340,4,228,2,112,1353.091483,22.968003,79.41482766,39.01079254,Benign
172.30.15.662,49949,172.217.166.193,443,21,8007,11,1393,10,6614,2397.030425,9.073154,1228.238824,5831.709679,Benign
192.168.215.49,43006,172.217.161.13,443,17,5068,9,1212,8,3856,574.396924,10.28565807,942.6718189,2999.127503,Benign
172.30.15.1307,50615,151.101.193.2,443,34,13228,17,2153,17,11075,3486.794186,10.364588,1661.812317,8548.33786,Benign
192.168.42.240,50992,216.58.221.46,443,38,10428,18,3406,20,7022,331.290371,39.850757,683.7511267,1409.659545,Benign
172.30.6.255,58092,172.217.166.206,443,54,9840,30,6097,24,3743,4871.403517,134.042972,363.8833075,223.3910481,Benign
192.168.215.49,50206,152.195.61.54,443,19,6201,11,1341,8,4860,788.5403847,0.028257811,379647.2416,1375902.755,Benign
172.30.15.2441,51775,14.139.45.128,80,24,7340,10,1298,14,6042,5418.869669,1.275679,8139.978788,37890.40973,Benign
172.30.15.1987,51299,52.218.248.232,443,26,6008,12,1339,14,4669,4077.201499,5.442089,1968.361782,6863.54082,Benign
172.30.1.136,50317,157.240.16.35,443,10,564,5,282,5,282,567.404824,28.735208,78.50995893,78.50995893,Benign
172.30.6.255,58198,103.243.221.46,80,6,340,4,228,2,112,5090.091772,11.294884,161.4890423,79.3279506,Benign
172.30.6.255,57889,103.243.221.75,80,24,10841,14,8253,10,2588,4344.841808,17.227815,3832.40707,1201.777474,Benign
172.30.15.2408,51742,14.139.45.128,80,313,280056,120,7555,193,272501,5344.431745,6.609201,9144.827037,329844.4093,Benign
172.30.6.255,57003,103.243.221.51,80,6,348,4,228,2,120,1485.198514,12.830199,142.1645915,74.82346922,Benign
10.0.2.15,53828,119.254.87.201,80,3,222,3,222,0,0,17581.75279,9.042574,196.4042539,0,Malicious
172.30.15.1134,50442,184.29.24.49,443,13,1477,6,904,7,573,3458.30425,8.969901,806.2519308,511.0424296,Benign
172.30.1.136,50746,52.229.168.53,443,22,9733,12,1190,10,8543,1893.391112,16.389955,580.8435716,4169.871119,Benign
172.30.6.255,56544,23.198.119.247,443,13,3297,7,1177,6,2120,832.256414,41.331327,227.8175099,410.3424988,Benign
172.30.15.1607,50917,54.201.247.66,443,18,5317,10,1333,8,3984,3573.728973,3.243198,3288.112536,9827.337091,Benign
172.30.15.458,49732,23.9.250.106,443,12,1490,6,931,6,559,1641.20754,0.193037,38583.27678,23166.5432,Benign
192.168.43.224,46046,35.170.201.81,443,11,742,6,404,5,338,34.19695721,13.38112155,241.534313,202.0757371,Benign
10.0.2.15,52455,119.254.87.201,80,11,1582,6,705,5,877,3344.122951,0.819615,6881.279625,8560.11664,Malicious
192.168.137.97,39878,104.113.219.221,443,32,8348,17,2657,15,5691,374.9727238,71.85276155,295.8271824,633.6290912,Benign
172.30.6.255,56866,103.243.220.231,80,15,6136,9,4508,6,1628,1375.864321,3.55613,10141.36154,3662.408292,Benign
192.168.137.97,59500,13.228.177.65,443,9,610,5,338,4,272,34.98955091,61.79971716,43.75424556,35.21051714,Benign
172.30.1.136,50271,104.17.162.9,443,8,492,4,252,4,240,481.96065,9.220793,218.636293,208.2250409,Benign
172.30.6.255,57578,103.243.221.17,80,17,5858,10,4269,7,1589,3288.863884,27.538616,1240.149469,461.6063494,Benign
192.168.215.49,52040,104.198.143.177,80,10,911,5,425,5,486,262.7547169,0.789236906,4307.958706,4926.277485,Benign
172.30.15.1840,51152,104.16.120.145,443,784,675729,296,19306,488,656423,3868.023142,9.16892,16844.73199,572737.4653,Benign
172.30.6.255,58160,176.34.147.227,443,35,13546,19,7499,16,6047,4958.721205,155.38954,386.0748928,311.3208264,Benign
172.30.6.255,56433,103.243.221.75,443,6,340,4,228,2,112,681.037406,17.01504,107.1992778,52.65929437,Benign
172.30.6.255,55995,103.243.221.46,80,6,348,4,228,2,120,184.07883,29.955792,60.8897271,32.04722479,Benign
192.168.43.224,34094,52.84.108.208,443,12,1535,7,1041,5,494,2892.93905,16.14532633,515.814907,244.7767186,Benign
172.30.6.255,57487,157.240.16.39,443,27,5330,15,3275,12,2055,3046.097289,61.01128,429.4287876,269.458369,Benign
192.168.43.233,50116,13.107.21.200,443,1,54,1,54,0,0,44.741761,0,0,0,Benign
192.168.43.224,50582,104.16.1.35,443,59,11908,30,3375,29,8533,1202.843245,403.4870083,66.91665269,169.1851252,Benign
192.168.43.224,41716,34.232.42.95,443,150,98228,75,8575,75,89653,28.81530396,81.85481583,838.0691998,8762.147868,Benign
172.30.1.136,50518,13.107.4.52,80,11,1573,6,490,5,1083,1024.333006,0.17172,22827.85931,50454.22781,Benign
172.30.15.2146,51458,52.20.111.213,443,15,4740,8,1087,7,3653,4178.924971,8.424311,1032.25059,3469.007733,Benign
172.30.15.1268,50576,157.240.16.63,443,15,4976,8,1025,7,3951,3469.541523,7.408125,1106.89277,4266.666667,Benign
192.168.137.97,41518,35.171.73.174,443,3,214,2,140,1,74,1955.961203,0.510657754,2193.249767,1159.289163,Benign
192.168.137.97,56308,172.217.161.14,443,127,28863,62,8875,65,19988,357.033785,543.1347009,130.7226364,294.409471,Benign
172.30.1.136,50288,52.84.103.186,443,14,1603,9,1090,5,513,487.363606,20.014406,435.6861752,205.0523008,Benign
172.30.6.255,56244,103.243.221.46,80,29,19544,15,6355,14,13189,527.879403,39.972779,1271.865536,2639.596311,Benign
10.0.2.15,56861,119.254.87.201,80,11,1582,6,705,5,877,6524.85312,2.017677,2795.293796,3477.266183,Malicious
172.30.15.800,50092,52.84.108.164,443,11,1345,6,907,5,438,2680.203778,6.022494,1204.816476,581.8187615,Benign
172.30.15.1362,50670,67.231.251.190,443,22,9169,11,1972,11,7197,3493.274365,3.818324,4131.655669,15078.86706,Benign
172.30.15.1805,51117,157.240.16.39,443,26,7667,14,5413,12,2254,3701.079186,6.295175,6878.919172,2864.416001,Benign
192.168.137.97,48472,172.217.194.189,443,26,1780,15,1070,11,710,3758.265751,89.81455065,95.30749682,63.24142312,Benign
172.30.15.811,50106,34.200.202.18,443,17,4268,10,2663,7,1605,2856.642104,9.999729,2130.457735,1284.034797,Benign
10.0.2.15,46739,119.254.87.201,80,11,1585,6,705,5,880,8957.192141,4.49569,1254.534899,1565.944271,Malicious
192.168.43.224,34234,172.217.166.206,443,21,6164,11,1517,10,4647,1171.118009,31.3638172,386.9426966,1185.314905,Benign
192.168.43.224,57164,172.217.166.202,443,2,120,1,66,1,54,15.55542465,0.83175211,634.8045213,519.3855174,Benign
10.0.2.15,48171,119.254.87.201,80,11,1582,6,705,5,877,2713.513797,0.967102,5831.856412,7254.663934,Malicious
10.0.2.15,49073,119.254.87.201,80,11,1593,6,705,5,888,7305.547611,1.819088,3100.454733,3905.253622,Malicious
192.168.137.97,33162,172.217.161.5,443,55,10145,27,4217,28,5928,96.70360571,241.4981444,139.6946551,196.3741797,Benign
172.30.15.932,50238,13.107.21.200,443,32,12055,15,2266,17,9789,3440.980791,6.009566,3016.523989,13031.22389,Benign
192.168.43.224,57728,13.32.226.81,443,46,11088,23,2798,23,8290,106.28706,182.7196403,122.5046195,362.9604344,Benign
172.30.15.1763,51075,184.29.25.7,443,26,14170,14,7621,12,6549,3638.771688,8.397357,7260.379665,6239.105947,Benign
172.30.15.2454,51788,14.139.45.128,80,9,1346,5,667,4,679,5420.752946,0.158701,33622.97654,34227.88766,Benign
10.0.2.15,38613,119.254.87.201,80,11,1585,6,705,5,880,668.707811,1.74606,3230.129549,4031.934756,Malicious
10.0.2.15,46942,119.254.87.201,80,11,1579,6,705,5,874,12052.90449,1.483497,3801.827708,4713.187826,Malicious
172.30.6.255,57498,103.231.98.53,80,39,17419,20,15673,19,1746,3057.857839,65.06891,1926.941761,214.6647301,Benign
10.0.2.15,42642,119.254.87.201,80,11,1513,6,705,5,808,13166.3476,1.690112,3337.056952,3824.598606,Malicious
192.168.43.233,51151,74.125.158.119,443,24,8973,11,2619,13,6354,476.169334,7.599987,2756.846821,6688.432493,Benign
192.168.43.224,50172,52.207.90.113,443,6,412,4,272,2,140,369.0543208,36.91960716,58.93887199,30.33618411,Benign
192.168.215.49,36824,169.60.79.3,443,30,8178,15,3226,15,4952,689.132824,1.319849844,19553.73948,30015.53562,Benign
172.30.1.136,50185,172.217.161.5,443,26,5548,14,3192,12,2356,353.057341,13.194093,1935.411551,1428.51805,Benign
172.30.6.255,57050,192.168.1.44,7680,3,198,3,198,0,0,1637.154144,9.009671,175.8110812,0,Benign
172.30.15.2334,51667,172.25.10.224,7680,3,198,3,198,0,0,5110.772349,9.006354,175.8758317,0,Benign
10.0.2.15,45517,119.254.87.201,80,11,1513,6,705,5,808,13707.13387,1.81635,3105.128417,3558.785476,Malicious
172.30.1.136,50354,52.84.103.186,443,338,193391,167,20022,171,173369,639.9231,202.197467,792.1760959,6859.393545,Benign
192.168.137.97,57588,72.247.219.151,443,16,1787,9,1134,7,653,376.5785502,14.43555165,628.448446,361.8843344,Benign
10.0.2.15,52338,119.254.87.201,80,12,1653,7,779,5,874,3792.291573,3.83137,1626.572218,1824.934684,Malicious
192.168.137.97,37770,117.18.237.70,443,29,8140,16,1869,13,6271,285.3043407,28.98560456,515.8422682,1730.790189,Benign
172.30.15.503,49785,172.25.10.63,7680,3,198,3,198,0,0,1962.319467,9.016832,175.6714553,0,Benign
10.0.2.15,49948,119.254.87.201,80,11,1582,6,705,5,877,2715.209099,0.950974,5930.761514,7377.699075,Malicious
10.0.2.15,41907,119.254.87.201,80,11,1582,6,705,5,877,25960.99789,0.822395,6858.018349,8531.180272,Malicious
172.30.15.500,49780,23.198.119.161,80,14,5564,7,603,7,4961,1904.719753,60.406453,79.85901771,657.0158986,Benign
172.30.6.255,56002,52.109.120.4,443,17,8977,8,2132,9,6845,225.248614,14.052961,1213.694395,3896.68768,Benign
10.0.2.15,58079,119.254.87.201,80,11,1582,6,705,5,877,26501.6982,0.826656,6822.66868,8487.206287,Malicious
172.30.15.1774,51086,184.29.25.7,443,21,8671,10,3694,11,4977,3641.698229,5.473269,5399.332647,7274.628746,Benign
10.0.2.15,50319,119.254.87.201,80,11,1579,6,705,5,874,6259.203347,1.220242,4622.03399,5730.010932,Malicious
192.168.137.97,49206,52.84.109.5,443,13,1637,8,1080,5,557,3808.372171,1.618188137,5339.304993,2753.697112,Benign
192.168.42.240,51016,172.217.166.206,443,32,11392,16,2485,16,8907,417.297276,37.721483,527.020637,1889.003144,Benign
10.0.2.15,40139,119.254.87.201,80,11,1579,6,705,5,874,21120.04382,1.885052,2991.959903,3709.181497,Malicious
172.30.15.1314,50622,180.179.41.214,443,14,3402,7,2137,7,1265,3487.653649,4.268166,4005.467454,2371.041801,Benign
172.30.6.255,58389,157.240.16.17,443,23,5182,12,1779,11,3403,5523.72001,15.340676,927.7296515,1774.628445,Benign
172.30.15.1604,50914,152.195.61.100,443,27,7941,14,1915,13,6026,3573.655461,3.357084,4563.484262,14360.08155,Benign
172.30.15.2401,51735,14.139.45.128,80,81,74919,27,1860,54,73059,5343.485318,0.126791,117358.4876,4609727.82,Benign
192.168.43.224,36314,52.20.136.189,443,116,79617,59,6589,57,73028,2844.399418,6.23263395,8457.419515,93736.29266,Benign
172.30.15.1689,51000,184.29.25.7,443,119,90744,52,24997,67,65747,3609.454998,7.671292,26068.09909,68564.20014,Benign
172.30.15.1645,50955,184.29.25.7,443,1094,1000312,404,98053,690,902259,3577.140025,29.896864,26237.66827,241432.4124,Benign
192.168.137.97,42042,18.210.21.97,443,16,1560,9,740,7,820,9.275648922,60.33572962,98.11764997,108.7249635,Benign
10.0.2.15,49152,119.254.87.201,80,11,1513,6,705,5,808,10010.96969,2.155365,2616.726169,2999.028007,Malicious
172.30.6.255,57162,176.34.147.227,443,19,6444,10,1207,9,5237,1942.797021,40.865787,236.2856734,1025.20967,Benign
10.0.2.15,52022,119.254.87.201,80,11,1579,6,705,5,874,17731.93063,0.954236,5910.487552,7327.327831,Malicious
192.168.137.97,43484,104.31.93.239,80,7,410,4,236,3,174,5243.603178,62.1728207,30.36696709,22.38920455,Benign
192.168.43.233,51177,172.217.161.1,443,23,6245,10,893,13,5352,567.546285,5.935801,1203.544391,7213.179822,Benign
172.30.6.255,56454,103.243.221.75,443,6,340,4,228,2,112,707.346035,39.725045,45.91561822,22.55504053,Benign
192.168.43.233,51304,52.175.39.99,443,18,7292,10,1421,8,5871,2902.488494,9.071892,1253.101338,5177.310312,Benign
192.168.137.97,53236,104.244.43.3,443,118,60153,54,4962,64,55191,217.5544347,641.2607586,61.90305498,688.5311382,Benign
10.0.2.15,42674,119.254.87.201,80,11,1582,6,705,5,877,6439.322213,2.013612,2800.936824,3484.28595,Malicious
172.30.6.255,58512,180.149.59.210,80,12,4896,8,3669,4,1227,5748.027823,1.002219,29287.01212,9794.266523,Benign
172.30.15.542,49826,104.122.118.96,443,29,9450,15,3103,14,6347,2250.650196,5.442882,4560.819066,9328.88128,Benign
192.168.137.97,48930,172.217.166.234,443,9,606,5,338,4,268,420.3708462,56.22029108,48.0965137,38.13569725,Benign
10.0.2.15,51633,119.254.87.201,80,11,1582,6,705,5,877,13822.39748,1.822272,3095.037404,3850.138728,Malicious
172.30.1.136,50459,157.240.16.39,443,2,132,2,132,0,0,857.976207,3.001071,351.8743808,0,Benign
172.30.6.255,57728,157.240.16.39,443,19,1971,10,1163,9,808,3778.096709,61.035467,152.4359599,105.9056368,Benign
172.30.6.255,57864,103.243.221.109,80,17,5591,9,4309,8,1282,4237.840672,39.186062,879.7005425,261.7257126,Benign
172.30.15.2512,51846,14.139.45.128,80,10,1434,5,701,5,733,5476.219678,0.044374,126380.3128,132149.4569,Benign
172.30.1.136,51843,52.84.110.84,443,576,169749,271,111596,305,58153,3485.876972,346.388824,2577.357981,1343.068736,Benign
10.0.2.15,35934,119.254.87.201,80,11,1582,6,705,5,877,19323.78582,2.250616,2505.980585,3117.368756,Malicious
172.30.15.2387,51721,14.139.45.128,80,133,112911,53,3562,80,109349,5336.176061,1.489491,19131.3677,587309.356,Benign
10.0.2.15,50702,119.254.87.201,80,11,1582,6,705,5,877,13376.66515,4.526416,1246.018925,1550.012195,Malicious
172.30.15.1590,50899,103.254.155.35,443,22,7891,12,2171,10,5720,3572.41452,4.756221,3651.638559,9621.083629,Benign
192.168.43.224,36202,43.245.63.29,443,22,7647,12,1410,10,6237,2469.914291,60.67965509,185.8942669,822.2854914,Benign
172.30.6.255,55970,52.76.187.108,443,25,8351,13,2839,12,5512,166.158118,61.240092,370.8681561,720.0511717,Benign
10.0.2.15,52978,119.254.87.201,80,11,1554,6,705,5,849,20461.85944,1.678174,3360.795722,4047.256125,Malicious
172.30.6.255,58456,157.240.16.17,443,6,348,4,228,2,120,5644.012903,5.058537,360.5785625,189.7781908,Benign
172.30.1.136,50473,157.240.16.20,443,152,55626,71,5821,81,49805,899.967729,54.859916,848.852922,7262.862014,Benign
10.0.2.15,57541,119.254.87.201,80,11,1579,6,705,5,874,25360.20507,0.856368,6585.953702,8164.714235,Malicious
10.0.2.15,58873,119.254.87.201,80,13,1727,8,853,5,874,4997.809195,10.824574,630.4174187,645.93766,Malicious
10.0.2.15,40430,119.254.87.201,80,11,1579,6,705,5,874,10188.5907,1.827563,3086.076923,3825.859902,Malicious
192.168.137.97,49702,104.237.191.1,443,7,518,7,518,0,0,346.631179,65.17822355,63.57951743,0,Benign
172.30.1.136,50293,119.81.119.12,443,9,534,5,294,4,240,492.505294,15.782856,149.0224583,121.6509864,Benign
172.30.6.255,55940,52.68.71.55,80,7,402,4,228,3,174,152.511247,6.533269,279.1864226,213.0633225,Benign
192.168.215.49,33738,18.208.55.232,443,29,7957,14,2516,15,5441,1582.809496,60.92676895,330.3638179,714.4314519,Benign
172.30.6.255,58376,180.149.59.232,80,12,4896,8,3669,4,1227,5485.031938,3.995249,7346.726074,2456.918205,Benign
192.168.137.97,38774,157.240.16.16,443,30,5068,21,3957,9,1111,184.7815331,89.81188872,352.4700399,98.96239937,Benign
192.168.43.233,50910,52.230.80.159,443,65,15207,41,7785,24,7422,338.635923,2148.253833,28.99098749,27.63919193,Benign
172.30.1.136,50206,172.217.161.14,443,68,16015,33,6628,35,9387,360.181404,23.072599,2298.137284,3254.769868,Benign
172.30.6.255,57851,103.243.221.51,80,7,406,5,294,2,112,4223.863124,14.194351,165.699721,63.12370323,Benign
172.30.6.255,58555,173.241.248.220,80,7,601,5,294,2,307,5814.105365,5.083597,462.6645267,483.122482,Benign
172.30.15.1993,51305,205.185.216.42,443,21,6415,10,1195,11,5220,4077.466847,4.963785,1925.949653,8412.934887,Benign
192.168.137.97,46214,13.228.212.129,443,43,12692,23,5102,20,7590,346.430117,182.2520122,223.9536316,333.1650458,Benign
172.30.6.255,58212,35.190.43.164,80,10,1573,6,1119,4,454,5155.945795,8.048856,1112.207747,451.2442514,Benign
172.30.6.255,57788,157.240.16.39,443,27,5329,16,3329,11,2000,4022.102969,61.510841,432.964329,260.1167492,Benign
192.168.43.233,51154,74.125.158.136,443,2518,2067665,1109,70664,1409,1997001,476.299012,87.890001,6432.039977,181772.7593,Benign
192.168.137.97,38018,104.113.235.6,443,9,618,5,338,4,280,16.89977967,18.05056746,149.8013847,124.0958217,Benign
172.30.1.136,51906,157.240.16.39,443,38,5166,18,3027,20,2139,5417.828926,116.854653,207.2317993,146.438328,Benign
10.0.2.15,60595,119.254.87.201,80,11,1582,6,705,5,877,2563.354771,0.960767,5870.309867,7302.498941,Malicious
192.168.137.97,51626,104.244.42.195,443,9,626,6,412,3,214,38.13473512,14.95006909,220.4672085,114.5145209,Benign
172.30.15.734,50021,104.31.90.207,80,13,2670,8,1932,5,738,2491.365993,5.261661,2937.475447,1122.079131,Benign
172.30.6.255,58335,103.243.221.109,80,39,24579,23,20487,16,4092,5419.834289,9.369621,17492.27637,3493.844628,Benign
10.0.2.15,37418,119.254.87.201,80,11,1579,6,705,5,874,25384.756,2.018101,2794.706509,3464.643246,Malicious
172.30.1.136,51225,52.175.23.79,443,1,66,1,66,0,0,1627.353819,0,0,0,Benign
192.168.42.240,50978,13.35.130.79,443,11,1401,7,958,4,443,296.119203,13.669061,560.682259,259.27165,Benign
192.168.215.49,52480,104.198.143.177,80,10,911,5,425,5,486,1462.772627,0.778796365,4365.711183,4992.319141,Benign
192.168.43.233,51103,172.217.160.227,443,11,696,5,273,6,423,41.762269,104.643884,20.87078496,32.33824922,Benign
192.168.137.97,45554,192.168.121.7,8080,9585,8356369,3946,292513,5639,8063856,2901.856812,104.5185358,22389.36838,617219.2092,Benign
10.0.2.15,49505,119.254.87.201,80,11,1579,6,705,5,874,23615.82285,0.831421,6783.566929,8409.698576,Malicious
192.168.137.97,34186,192.229.237.96,443,21,7397,12,1479,9,5918,144.4497953,10.87240829,1088.259352,4354.509025,Benign
172.30.15.539,49823,63.131.135.113,443,3,198,3,198,0,0,2249.211825,9.002259,175.9558351,0,Benign
172.30.15.2149,51461,52.20.111.213,443,6,348,4,228,2,120,4179.175065,8.455007,215.7301585,113.5421887,Benign
172.30.15.1192,50500,34.228.252.44,80,10,1539,6,958,4,581,3465.344926,2.296764,3336.868742,2023.716847,Benign
192.168.43.233,51649,204.79.197.200,443,49,14251,24,2993,25,11258,855.777901,166.195115,144.0716233,541.9172519,Benign
192.168.43.224,57286,139.59.82.147,443,10,692,6,412,4,280,2583.983317,14.76442567,223.2392966,151.7160268,Benign
192.168.43.233,51435,151.101.193.69,443,9,534,5,294,4,240,3795.085472,16.650727,141.2550935,115.3102804,Benign
172.30.6.255,57994,104.121.241.30,443,21,8944,10,1008,11,7936,4722.948426,60.313245,133.7019754,1052.637775,Benign
192.168.43.233,50960,163.53.78.128,80,14,1810,8,758,6,1052,476.103181,103.346594,58.67634109,81.43471085,Benign
192.168.215.49,41196,111.119.15.128,443,748,617963,313,23878,435,594085,583.9955704,3.689558743,51774.21294,1288143.198,Benign
172.30.6.255,56158,103.243.221.17,80,13,4016,8,2896,5,1120,406.952686,4.84045,4786.331849,1851.067566,Benign
172.30.15.1852,51164,35.161.208.104,443,15,2813,8,1989,7,824,3898.237997,9.245221,1721.105423,713.0170279,Benign
10.0.2.15,35274,119.254.87.201,80,11,1579,6,705,5,874,20069.00831,1.429244,3946.142156,4892.096801,Malicious
172.30.15.986,50292,173.241.248.220,80,11,3436,7,2892,4,544,3442.725077,4.515778,5123.369661,963.7320524,Benign
192.168.137.97,50082,104.237.191.1,443,44,5762,22,3041,22,2721,2151.852652,243.6791152,99.83621281,89.33059358,Benign
192.168.43.233,51264,49.44.170.2,443,98,51934,44,11674,54,40260,1950.531862,333.667075,279.8957614,965.273544,Benign
172.30.15.2120,51432,104.113.220.53,443,13,1517,6,904,7,613,4178.126305,9.495138,761.6529639,516.4748527,Benign
192.168.43.224,48806,34.227.208.227,443,16,4997,9,1251,7,3746,361.4756741,44.1233058,226.8189071,679.1875508,Benign
172.30.1.136,51864,172.217.160.228,443,13,1485,8,1031,5,454,4168.839467,15.79277,522.264302,229.9786548,Benign
172.30.6.255,57913,216.239.32.62,443,41,7446,20,2387,21,5059,4448.034517,240.370787,79.4439301,168.3732059,Benign
10.0.2.15,48850,119.254.87.201,80,11,1579,6,705,5,874,15326.2737,1.084639,5199.886783,6446.384465,Malicious
172.30.15.529,49813,52.5.46.238,443,28,13707,14,2713,14,10994,2246.44302,9.834044,2207.026936,8943.62482,Benign
172.30.15.1358,50666,54.169.20.177,443,30,9175,15,3060,15,6115,3493.151327,3.941295,6211.156485,12412.16402,Benign
172.30.15.1530,50838,117.18.237.66,443,17,6735,9,1801,8,4934,3527.41392,9.567444,1505.940354,4125.657804,Benign
192.168.137.97,39734,192.168.125.6,80,17,5822,9,1196,8,4626,8296.007861,3.897308811,2455.027421,9495.78332,Benign
192.168.137.97,39738,192.168.125.6,80,279,214903,140,10726,139,204177,8296.743175,33.21272362,2583.588175,49180.42913,Benign
192.168.43.233,51241,157.240.16.16,443,29,4278,14,2157,15,2121,1592.791527,65.505721,263.427373,259.0308105,Benign
172.30.6.255,58382,157.240.16.39,443,29,5490,16,3341,13,2149,5486.087126,61.0702,437.6602664,281.5120959,Benign
172.30.1.136,50608,157.240.16.20,443,46,12465,24,4217,22,8248,1613.469739,78.265417,431.0460647,843.0799008,Benign
192.168.43.224,35948,192.229.237.25,443,34,9744,19,3879,15,5865,302.971595,183.0607399,169.5175056,256.3083708,Benign
192.168.43.224,52632,192.229.237.96,443,19,5993,10,1287,9,4706,977.7095672,0.420914684,24461.01405,89443.30391,Benign
192.168.42.240,50971,216.58.221.46,443,16,1949,9,1318,7,631,285.140604,11.39208,925.5552981,443.1148658,Benign
192.168.43.224,38422,18.205.91.83,443,38,8251,21,2910,17,5341,358.1964673,64.15527102,362.8696384,666.0091886,Benign
172.30.6.255,56091,52.198.158.144,80,6,348,4,228,2,120,305.824948,18.160571,100.4373706,52.861774,Benign
192.168.137.97,42168,151.101.129.69,443,55,9598,29,3165,26,6433,24.30860533,601.5027947,42.09456751,85.55903723,Benign
192.168.43.224,54498,216.58.221.42,443,69,10840,34,3920,35,6920,126.990686,325.9388104,96.21437829,169.8478311,Benign
172.30.15.901,50207,103.243.220.231,80,13,4627,8,3558,5,1069,3438.497305,8.764461,3247.661208,975.7588059,Benign
172.30.6.255,57226,192.168.1.35,7680,3,198,3,198,0,0,2158.77206,9.00468,175.9085276,0,Benign
192.168.43.233,50942,49.44.178.243,80,15,858,7,402,8,456,453.341201,16.000166,200.9979146,227.9976345,Benign
10.0.2.15,52705,119.254.87.201,80,13,1730,8,853,5,877,16555.36485,13.482111,506.1521894,520.3932826,Malicious
192.168.43.233,51375,52.212.88.15,443,18,1754,10,1122,8,632,3477.110797,148.325936,60.51537743,34.08709317,Benign
192.168.137.97,37768,117.18.237.70,443,31,8398,17,2049,14,6349,285.3029486,28.98691969,565.4964438,1752.238615,Benign
172.30.15.942,50248,13.228.144.151,443,29,11846,15,6355,14,5491,3441.172199,5.890286,8631.159845,7457.702393,Benign
172.30.6.255,56943,103.15.158.188,80,9,2797,5,1635,4,1162,1387.978483,10.26339,1274.432717,905.7436188,Benign
10.0.2.15,36960,119.254.87.201,80,11,1579,6,705,5,874,13191.61202,1.889279,2985.265808,3700.882718,Malicious
10.0.2.15,42482,119.254.87.201,80,11,1582,6,705,5,877,21570.59022,1.688031,3341.170867,4156.321774,Malicious
192.168.215.49,58282,157.240.16.16,443,280,53584,159,19948,121,33636,23.77438631,1644.095967,97.06489354,163.6692781,Benign
192.168.137.97,57538,169.60.79.147,443,1042,494666,556,48851,486,445815,6766.230523,1641.793329,238.0372689,2172.331887,Benign
172.30.6.255,58329,157.240.16.17,443,5588,4918348,2185,136322,3403,4782026,5385.920004,133.119679,8192.44764,287382.0632,Benign
172.30.6.255,58068,173.241.248.220,80,17,6680,10,3393,7,3287,4826.904012,45.758521,593.2009909,574.6689234,Benign
192.168.43.233,51230,52.230.85.180,443,80,21382,49,13312,31,8070,1630.874187,2144.385085,49.66272184,30.10653285,Benign
192.168.137.97,44038,172.217.161.10,443,18,1256,9,626,9,630,3876.369495,110.2963228,45.40495886,45.69508639,Benign
172.30.15.1842,51154,104.16.124.127,443,84,31740,40,4481,44,27259,3868.888934,8.296986,4320.605097,26283.27925,Benign
10.0.2.15,54148,119.254.87.201,80,11,1579,6,705,5,874,19891.40663,6.079941,927.6405807,1150.01116,Malicious
192.168.43.233,51291,74.207.230.33,443,9,534,5,294,4,240,2492.164043,25.986555,90.50834172,73.88436059,Benign
172.30.1.136,50337,172.217.161.3,443,31,3252,14,2126,17,1126,596.098743,19.458764,874.0534599,462.9276556,Benign
192.168.137.97,52310,172.217.161.3,443,22,2849,13,1866,9,983,10888.63333,244.8780367,60.96095919,32.11394581,Benign
172.30.15.2469,51803,14.139.45.128,80,54,44340,20,1830,34,42510,5423.027379,0.99336,14737.85939,342353.2254,Benign
192.168.137.97,54946,172.217.161.3,443,51,12640,25,6011,26,6629,302.8567356,240.7898594,199.7094069,220.241833,Benign
10.0.2.15,48999,119.254.87.201,80,11,1513,6,705,5,808,1299.501468,1.624924,3470.931564,3978.032203,Malicious
192.168.43.224,43190,185.199.109.153,80,42,8109,22,4351,20,3758,2602.426386,318.8242241,109.1761459,94.29647351,Benign
192.168.215.49,54236,157.240.16.20,443,18,5377,10,1261,8,4116,118.5956913,23.71830291,425.3255404,1388.294944,Benign
172.30.6.255,57204,103.243.221.109,80,6,348,4,228,2,120,2088.739044,11.287348,161.5968605,85.0509792,Benign
172.30.6.255,56097,54.169.211.49,443,6,348,4,228,2,120,305.825612,18.095382,100.7991984,53.05220967,Benign
192.168.43.224,41324,52.10.2.252,443,8,544,5,338,3,206,116.1681872,58.83743626,45.95713498,28.00937812,Benign
172.30.6.255,56760,23.198.126.238,443,17,6653,8,1326,9,5327,1244.684335,0.762087,13919.67059,55920.12461,Benign
172.30.1.136,50132,119.81.119.5,80,11,1667,6,1039,5,628,112.760285,34.528283,240.7301863,145.5039047,Benign
172.30.1.136,50480,172.217.161.3,443,67,24267,27,14050,40,10217,922.694567,162.290403,692.5856238,503.6403785,Benign
172.30.6.255,56094,18.195.210.3,80,13,1959,7,1144,6,815,305.960839,63.022043,145.2190307,103.4558654,Benign
192.168.215.49,56152,104.197.3.80,80,10,911,5,425,5,486,358.7397323,0.779626343,4361.063515,4987.004396,Benign
192.168.43.233,51048,172.217.160.238,443,16,979,8,436,8,543,18.434956,151.421517,23.03503537,28.68812891,Benign
192.168.43.233,51135,52.220.119.167,443,30,10192,15,3165,15,7027,924.502536,83.885112,301.8414042,670.1546754,Benign
172.30.6.255,57886,157.240.16.39,443,18,1879,9,1071,9,808,4327.092965,61.069124,140.3000312,105.8472691,Benign
192.168.137.97,56720,104.113.232.176,443,102,59339,52,5041,50,54298,4.45594127,70.50589962,571.980504,6160.959613,Benign
192.168.137.97,33450,52.94.216.31,443,14,791,8,452,6,339,3721.69631,74.1330608,48.77715773,36.5828683,Benign
192.168.43.224,56904,172.217.166.197,443,637,351521,284,64706,353,286815,3.779329708,382.609885,1352.939431,5997.022267,Benign
10.0.2.15,43711,119.254.87.201,80,12,1656,7,779,5,877,17306.26489,4.945148,1260.225174,1418.764413,Malicious
192.168.137.97,58368,13.228.153.206,443,18,5261,10,1311,8,3950,1766.990452,50.73600281,206.7171125,622.8318798,Benign
10.0.2.15,60099,119.254.87.201,80,11,1579,6,705,5,874,15419.11701,1.030473,5473.214728,6785.233577,Malicious
192.168.43.224,60110,104.19.195.151,443,16,5892,9,1087,7,4805,2280.07922,16.37901098,530.9233879,2346.906052,Benign
172.30.15.551,49835,151.101.112.84,443,71,56877,27,2484,44,54393,2252.762278,3.424635,5802.662182,127062.8841,Benign
10.0.2.15,35042,219.234.85.240,80,11,1857,6,795,5,1062,17.853297,1.741375,3652.286268,4878.903166,Malicious
10.0.2.15,54871,119.254.87.201,80,11,1579,6,705,5,874,19173.58355,1.844479,3057.774038,3790.772354,Malicious
172.30.6.255,58256,157.240.16.17,443,23,4076,12,1771,11,2305,5260.779621,8.219282,1723.751539,2243.504968,Benign
10.0.2.15,37786,119.254.87.201,80,11,1593,6,705,5,888,17876.64052,1.618642,3484.402357,4388.864245,Malicious
10.0.2.15,41359,119.254.87.201,80,11,1582,6,705,5,877,8541.518883,1.622344,3476.451357,4324.606865,Malicious
10.0.2.15,59977,119.254.87.201,80,11,1579,6,705,5,874,18332.72268,1.434977,3930.376584,4872.551964,Malicious
172.30.15.1145,50453,157.240.16.20,443,12,1688,7,971,5,717,3458.351008,8.594831,903.7990392,667.3778693,Benign
172.30.15.804,50096,192.168.1.44,7680,3,198,3,198,0,0,2694.44195,9.001646,175.9678174,0,Benign
192.168.43.233,50968,49.44.170.2,443,85,46840,40,5930,45,40910,489.889924,328.837726,144.2656856,995.262934,Benign
172.30.15.1122,50430,151.139.104.143,80,6,348,4,228,2,120,3458.282488,8.997672,202.7191033,106.6942649,Benign
192.168.43.224,57186,139.59.82.147,443,32,8286,17,1857,15,6429,2458.825368,34.40992006,431.7359638,1494.685251,Benign
172.30.15.2477,51811,14.139.45.128,80,16,7791,7,746,9,7045,5424.241997,0.268736,22207.66849,209722.553,Benign
172.30.15.1867,51179,52.6.46.142,443,23,4419,14,3008,9,1411,3937.620737,9.84223,2444.97436,1146.894555,Benign
172.30.6.255,56577,176.34.147.227,443,110,42538,67,36932,43,5606,888.827228,261.414092,1130.222161,171.5592287,Benign
172.30.6.255,56858,52.213.19.114,443,20,6522,11,1285,9,5237,1354.659484,22.887792,449.1477378,1830.495489,Benign
192.168.137.97,42478,52.84.110.205,443,36,15870,18,2580,18,13290,382.295046,162.6371552,126.90827,653.7251583,Benign
192.168.43.224,35054,34.232.42.95,443,131,95694,63,5499,68,90195,3040.472776,3.724297729,11812.15982,193743.9089,Benign
10.0.2.15,54770,119.254.87.201,80,11,1513,6,705,5,808,6917.675259,1.368564,4121.107964,4723.198915,Malicious
172.30.6.255,57667,103.243.221.46,80,21,9754,11,4324,10,5430,3571.837029,11.628314,2974.80787,3735.709235,Benign
172.30.15.239,49508,23.198.126.238,443,17,6382,8,1318,9,5064,53.198656,0.681232,15477.84015,59468.72725,Benign
172.30.15.2073,51385,52.7.89.176,443,24,4652,13,3019,11,1633,4122.430573,5.146043,4693.314844,2538.649599,Benign
10.0.2.15,42858,119.254.87.201,80,11,1579,6,705,5,874,402.962201,2.379584,2370.16218,2938.328716,Malicious
172.30.15.384,49652,62.210.213.13,80,30,19891,13,1902,17,17989,1455.405312,5.145289,2957.268289,27969.66312,Benign
172.30.1.136,51841,13.107.4.52,80,16,2822,8,764,8,2058,3478.55618,0.793963,7698.091725,20736.48268,Benign
10.0.2.15,48070,119.254.87.201,80,11,1579,6,705,5,874,17696.55209,1.754934,3213.796074,3984.195417,Malicious
192.168.137.97,56426,172.217.161.5,443,149,58178,67,18656,82,39522,980.9007956,255.1060596,585.0429435,1239.390395,Benign
172.30.15.2132,51444,13.56.57.63,443,6,348,4,228,2,120,4178.53593,9.135962,199.6505677,105.0792462,Benign
172.30.6.255,57607,172.217.166.206,443,24,3159,13,1864,11,1295,3376.41408,93.792835,158.9886903,110.4561985,Benign
10.0.2.15,59970,119.254.87.201,80,12,1587,7,779,5,808,21035.46722,4.066737,1532.432513,1589.480707,Malicious
10.0.2.15,36003,119.254.87.201,80,11,1552,6,705,5,847,10013.16088,1.830138,3081.73482,3702.453039,Malicious
172.30.15.209,49476,52.229.207.60,443,1,54,1,54,0,0,9.437573,0,0,0,Benign
172.30.15.1458,50766,111.221.29.253,443,24,6388,14,1870,10,4518,3504.266188,0.646776,23130.10996,55883.33519,Benign
172.30.6.255,56708,172.217.166.210,443,45,8207,21,2811,24,5396,1169.988738,72.892052,308.511002,592.2182023,Benign
172.30.6.255,56015,54.183.78.192,443,6,340,4,228,2,112,228.101729,10.819305,168.5875387,82.81493127,Benign
10.0.2.15,48046,119.254.87.201,80,11,1579,6,705,5,874,7550.543858,1.595546,3534.840111,4382.198946,Malicious
172.30.15.1171,50479,172.217.166.193,80,11,2992,6,805,5,2187,3460.758157,6.464045,996.280193,2706.664326,Benign
10.0.2.15,60969,119.254.87.201,80,11,1579,6,705,5,874,3193.967037,1.349045,4180.735261,5182.925699,Malicious
192.168.43.224,50180,49.44.90.17,443,6217,5999516,2089,143086,4128,5856430,37.91251136,130.2796953,8786.388375,359621.9649,Benign
192.168.137.97,45662,104.197.3.80,80,11,977,6,491,5,486,1962.830331,1.45488947,2699.861454,2672.367957,Benign
10.0.2.15,49763,119.254.87.201,80,11,1582,6,705,5,877,13491.99668,1.887638,2987.86102,3716.814347,Malicious
10.0.2.15,54394,119.254.87.201,80,11,1579,6,705,5,874,10881.71599,2.088119,2700.995489,3348.468167,Malicious
10.0.2.15,59329,119.254.87.201,80,11,1582,6,705,5,877,15389.06327,1.382587,4079.309295,5074.545038,Malicious
10.0.2.15,46826,119.254.87.201,80,11,1513,6,705,5,808,11544.90727,1.553196,3631.222331,4161.741339,Malicious
172.30.6.255,57046,103.243.221.17,80,24,10906,14,8316,10,2590,1614.860665,49.169504,1353.033783,421.3994105,Benign
10.0.2.15,40138,119.254.87.201,80,11,1579,6,705,5,874,16530.40908,0.957205,5892.154763,7304.600373,Malicious
192.168.137.97,34524,172.217.161.19,443,11,742,6,416,5,326,346.81437,17.5261671,189.8874968,148.8060672,Benign
10.0.2.15,47939,119.254.87.201,80,3,222,3,222,0,0,14633.30587,9.050631,196.2294121,0,Malicious
192.168.137.97,60532,151.101.1.69,443,15,5832,9,1236,6,4596,8.249909354,13.64218438,724.8106111,2695.169554,Benign
172.30.6.255,58320,52.213.19.114,443,6,348,4,228,2,120,5354.935402,4.215264,432.7131112,227.7437427,Benign
192.168.137.97,44556,74.125.24.188,443,47,4620,25,2730,22,1890,11615.7372,673.6698582,32.41944067,22.44422816,Benign
172.30.15.2492,51826,14.139.45.128,80,10,1411,5,683,5,728,5438.879299,0.06939,78743.33477,83931.40222,Benign
10.0.2.15,48391,119.254.87.201,80,11,1579,6,705,5,874,6048.974205,1.846549,3054.346243,3786.52286,Malicious
172.30.15.1198,50506,151.101.130.49,80,6,348,4,228,2,120,3465.37778,2.187828,833.7035635,438.7913492,Benign
10.0.2.15,38014,119.254.87.201,80,11,1582,6,705,5,877,9350.332779,1.888993,2985.717787,3714.148226,Malicious
172.30.1.136,50813,172.217.161.14,443,27,3864,15,2321,12,1543,1952.395929,12.516869,1483.438071,986.1891181,Benign
192.168.43.233,51265,52.84.110.78,443,11,644,6,350,5,294,2307.274821,122.403531,22.87515709,19.21513196,Benign
172.30.1.136,50374,157.240.16.20,443,3,198,3,198,0,0,671.726736,9.000931,175.9817957,0,Benign
10.0.2.15,34893,119.254.87.201,80,11,1579,6,705,5,874,13461.93436,2.109085,2674.145423,3315.181702,Malicious
172.30.1.136,51512,13.107.18.11,443,1,54,0,0,1,54,116.055498,0,0,0,Benign
172.30.6.255,58481,210.176.156.21,80,15,5583,9,4024,6,1559,5682.841229,6.89656,4667.834399,1808.43783,Benign
172.30.15.2425,51759,14.139.45.128,443,3,198,3,198,0,0,5364.963118,9.002884,175.9436198,0,Benign
172.30.6.255,58089,122.15.34.40,80,34,26236,13,1146,21,25090,4857.692686,14.824619,618.4307334,13539.6397,Benign
172.30.15.603,49889,13.107.21.200,443,6,348,3,174,3,174,2367.982993,8.166691,170.4484717,170.4484717,Benign
192.168.43.224,57228,139.59.82.147,443,11,774,7,486,4,288,2493.488804,17.19490369,226.1135084,133.9931902,Benign
192.168.137.97,46596,172.217.161.14,443,465,113406,222,54990,243,58416,888.1361453,871.4603826,504.8078017,536.2584569,Benign
172.30.15.1242,50550,173.241.248.143,443,12,3724,8,1046,4,2678,3469.256167,7.69289,1087.757657,2784.909182,Benign
192.168.43.233,51318,117.18.237.70,443,2049,1549731,805,56495,1244,1493236,2956.055679,204.013994,2215.338228,58554.2578,Benign
192.168.43.224,45540,104.237.191.1,443,8,552,5,338,3,214,2144.307639,46.00424917,58.77717926,37.21395373,Benign
172.30.6.255,57512,103.243.221.109,80,24,10468,14,8232,10,2236,3072.840534,50.188437,1312.174755,356.4167579,Benign
172.30.6.255,58235,210.176.156.41,80,14,5528,8,3970,6,1558,5221.848498,37.250497,852.606074,334.5995625,Benign
172.30.15.2194,51506,77.88.21.119,443,16,7859,8,1087,8,6772,4282.777295,4.638011,1874.941651,11680.86923,Benign
172.30.6.255,56534,23.198.119.247,443,13,3297,7,1177,6,2120,832.1359,41.450211,227.164103,409.165589,Benign
192.168.137.97,59384,34.205.118.138,443,43,9063,23,3426,20,5637,4063.94156,14.06293057,1948.953659,3206.728481,Benign
172.30.15.1450,50758,103.231.98.244,443,15,1250,8,860,7,390,3502.039565,0.763142,9015.360182,4088.361013,Benign
172.30.1.136,50196,172.217.161.1,443,25,7465,13,1561,12,5904,357.871025,7.936427,1573.504047,5951.292691,Benign
192.168.215.49,59114,52.84.108.195,443,30,8867,15,2254,15,6613,1529.130757,210.8794553,85.50856686,250.8731822,Benign
192.168.43.224,38246,140.98.193.112,443,27,11844,15,6930,12,4914,2296.970395,4.870538783,11382.72427,8071.386299,Benign
192.168.43.224,51396,18.210.21.97,443,6,412,4,272,2,140,1473.488702,19.8603737,109.5649071,56.39370219,Benign
192.168.43.224,51154,23.251.156.28,443,5,346,3,206,2,140,3315.984481,47.73856586,34.52135544,23.46111534,Benign
172.30.6.255,56391,173.239.42.221,443,7,402,4,228,3,174,650.88881,27.057451,67.41211506,51.44608781,Benign
192.168.43.224,58490,52.24.249.177,443,176,119872,88,9225,88,110647,93.14242579,81.50974892,905.4131681,10859.75619,Benign
192.168.137.97,48496,185.199.110.153,80,11,774,6,412,5,362,0.256031144,16.00064862,205.9916494,180.9926628,Benign
10.0.2.15,59745,119.254.87.201,80,11,1582,6,705,5,877,1153.642922,1.901298,2966.394537,3690.110651,Malicious
192.168.43.233,51637,13.107.4.52,80,10,1476,5,393,5,1083,838.73251,0.221986,14163.05533,39029.48835,Benign
172.30.15.1147,50455,50.31.185.52,443,7,402,4,228,3,174,3458.520202,8.032265,227.0841413,173.3010552,Benign
192.168.137.97,37442,172.217.161.3,443,17,1185,7,474,10,711,25.53332952,196.5480729,19.29298997,28.93948496,Benign
10.0.2.15,42140,119.254.87.201,80,11,1582,6,705,5,877,10133.2459,1.624947,3470.882435,4317.679284,Malicious
172.30.15.2306,51635,87.250.251.119,443,17,5071,10,3309,7,1762,4998.476563,9.291099,2849.178553,1517.150985,Benign
172.30.6.255,57828,103.243.221.46,80,3,198,3,198,0,0,4106.857845,9.002632,175.9485448,0,Benign
192.168.43.233,51266,52.84.108.85,443,43,19657,20,2245,23,17412,2310.274494,212.761395,84.41381013,654.7052392,Benign
172.30.15.1704,51015,184.29.25.7,443,12,1423,6,904,6,519,3612.073336,5.054559,1430.787533,821.4366476,Benign
172.30.6.255,56105,75.98.70.37,80,13,1591,8,917,5,674,306.362824,105.465651,69.55819198,51.12565038,Benign
10.0.2.15,48279,119.254.87.201,80,11,1513,6,705,5,808,11182.03813,1.479988,3810.84171,4367.602981,Malicious
172.30.6.255,56361,172.217.166.226,80,6,348,4,228,2,120,607.829,24.099685,75.68563656,39.83454556,Benign
172.30.6.255,57559,52.175.23.79,443,29,10142,15,2238,14,7904,3245.949285,63.588622,281.5598048,994.3917325,Benign
172.30.15.2110,51422,52.7.89.176,443,18,3786,10,2359,8,1427,4177.843414,9.787177,1928.237325,1166.42419,Benign
192.168.137.97,49474,157.240.16.52,443,11,737,6,404,5,333,6968.020873,105.7639112,30.55862782,25.1881759,Benign
192.168.43.224,51574,54.197.248.134,443,23,7471,13,1485,10,5986,741.4476492,20.33565665,584.195544,2354.878469,Benign
192.168.43.224,35070,34.232.42.95,443,14,1660,8,1080,6,580,3058.608875,27.72371596,311.6465344,167.3657314,Benign
192.168.43.233,51512,131.253.61.80,443,157,55666,74,12029,83,43637,3901.785287,79.418096,1211.713764,4395.673248,Benign
172.30.6.255,58571,103.243.221.51,80,9,5173,7,4209,2,964,5879.862558,0.501106,67195.36386,15389.95741,Benign
10.0.2.15,44124,119.254.87.201,80,11,1579,6,705,5,874,17248.31074,1.520886,3708.36473,4597.320246,Malicious
10.0.2.15,53841,119.254.87.201,80,11,1579,6,705,5,874,10673.94865,4.817683,1170.687237,1451.320064,Malicious
192.168.43.224,33850,54.161.96.219,443,100,15275,56,5838,44,9437,1278.863642,1176.00473,39.71412598,64.19702071,Benign
172.30.1.136,50287,52.84.103.186,443,7157,5578208,3240,219196,3917,5359012,487.363398,149.636119,11718.88186,286509.0079,Benign
172.30.15.215,49491,162.125.34.129,443,482,156194,200,114613,282,41581,10.952865,5478.165453,167.3742803,60.72251794,Benign
10.0.2.15,33789,119.254.87.201,80,11,1513,6,705,5,808,5956.665215,1.825502,3089.561118,3540.943806,Malicious
10.0.2.15,57742,119.254.87.201,80,11,1561,6,705,5,856,10223.35142,1.025417,5500.201381,6678.258699,Malicious
10.0.2.15,52634,119.254.87.201,80,12,1656,7,779,5,877,20221.65867,4.889651,1274.528591,1434.867233,Malicious
172.30.1.136,50446,172.217.161.3,443,45,5949,21,3374,24,2575,855.998501,282.592602,95.51559315,72.89645891,Benign
172.30.6.255,58253,157.240.16.39,443,28,5548,14,3345,14,2203,5242.384905,60.776357,440.3027974,289.9811846,Benign
172.30.6.255,56016,18.210.163.206,443,30,8860,14,1951,16,6909,228.151667,60.933425,256.1484112,907.0883509,Benign
172.30.1.136,50579,172.217.161.4,443,16,936,9,534,7,402,1586.412792,25.705691,166.1888801,125.1084828,Benign
10.0.2.15,57565,119.254.87.201,80,11,1582,6,705,5,877,14993.6763,1.676466,3364.219734,4184.99391,Malicious
172.30.1.136,51765,52.114.75.78,443,27,11295,16,6136,11,5159,2952.517673,9.704524,5058.259426,4252.861861,Benign
10.0.2.15,35019,119.254.87.201,80,11,1579,6,705,5,874,7100.078514,1.0895,5176.686553,6417.622763,Malicious
172.30.15.2510,51844,14.139.45.128,80,10,1398,5,671,5,727,5475.954372,0.148841,36065.33146,39075.2548,Benign
172.30.6.255,56439,54.64.58.164,80,16,2447,9,1489,7,958,700.445336,61.581806,193.4337554,124.4523423,Benign
172.30.15.2027,51339,52.52.93.212,443,22,8442,12,1918,10,6524,4090.515193,7.078652,2167.644348,7373.155228,Benign
172.30.15.770,50061,157.240.16.39,443,234,177157,108,9335,126,167822,2625.926473,10.312685,7241.56706,130186.8524,Benign
172.30.1.136,51884,13.75.122.216,443,22,8805,14,2542,8,6263,4420.515557,2.58014,7881.742851,19419.10129,Benign
192.168.137.97,39662,192.168.125.6,80,46,29169,25,2336,21,26833,8266.447902,17.21563039,1085.525164,12469.13387,Benign
172.30.1.136,50286,52.84.103.186,443,20,1858,10,1144,10,714,487.363181,8.307601,1101.641737,687.5631124,Benign
172.30.6.255,57444,103.243.221.17,80,36,19036,17,9370,19,9666,2860.893616,30.135026,2487.470892,2566.050549,Benign
172.30.6.255,56983,176.34.147.227,443,13,1533,7,1009,6,524,1438.294242,16.231423,497.3069829,258.2644787,Benign
192.168.43.233,51442,192.0.73.2,80,18,6873,9,999,9,5874,3802.209162,89.081219,89.71588052,527.5186008,Benign
192.168.137.97,33602,172.217.161.5,443,9,606,5,338,4,268,7120.573859,36.63993532,73.79925692,58.51538714,Benign
192.168.43.233,50849,172.217.166.195,443,16,968,9,491,7,477,34.108912,197.340064,19.90472649,19.33717828,Benign
10.0.2.15,46475,119.254.87.201,80,11,1582,6,705,5,877,13884.79829,1.823881,3092.307009,3846.742194,Malicious
172.30.15.1694,51005,184.29.25.7,443,127,104472,53,25039,74,79433,3609.559565,7.56856,26466.32913,83961.01768,Benign
192.168.43.224,41892,23.251.156.28,443,677,538943,296,27486,381,511457,714.9809931,172.9106824,1271.685456,23663.40786,Benign
192.168.137.97,46550,151.101.193.170,443,19,7875,11,1368,8,6507,382.7903869,17.02400188,642.8570718,3057.800414,Benign
172.30.6.255,56663,172.30.10.168,445,3,198,3,198,0,0,1110.366209,9.002432,175.9524537,0,Benign
172.30.6.255,57653,172.217.166.206,443,42,6495,22,4050,20,2445,3521.412768,106.048884,305.519481,184.4432422,Benign
172.30.6.255,56228,103.229.206.182,80,23,2650,13,1537,10,1113,470.513652,347.474149,35.38680513,25.62492786,Benign
192.168.43.233,51395,104.16.93.188,80,13,1445,7,623,6,822,3579.427635,46.926777,106.2080185,140.1332122,Benign
192.168.137.97,40804,18.211.26.179,443,28,3594,16,2569,12,1025,38.17475645,27.02866952,760.3777901,303.3815628,Benign
172.30.6.255,57570,103.243.221.51,80,15,6198,9,5076,6,1122,3256.286951,25.780335,1575.154085,348.172357,Benign
192.168.43.233,51438,192.0.73.2,443,90,33284,50,5922,40,27362,3801.394978,199.981627,236.901763,1094.580554,Benign
172.30.6.255,58147,216.58.196.194,80,136,41227,71,23095,65,18132,4950.83858,163.155536,1132.416371,889.0657562,Benign
192.168.43.224,49988,172.217.166.195,443,56,12626,28,6196,28,6430,383.3239501,241.0192414,205.6599287,213.4269434,Benign
192.168.43.233,51213,52.84.108.135,443,15,1699,9,1120,6,579,1437.710783,72.964505,122.7994352,63.48292228,Benign
172.30.15.771,50062,157.240.16.20,443,174,126800,76,5801,98,120999,2626.52832,9.710047,4779.379544,99689.73374,Benign
172.30.6.255,58141,157.240.16.17,443,1749,1515804,702,44420,1047,1471384,4935.641728,23.297398,15253.20553,505252.6467,Benign
172.30.1.136,50478,157.240.16.39,443,24,6015,13,1355,11,4660,913.174338,40.96183,264.6366141,910.1155881,Benign
10.0.2.15,53707,119.254.87.201,80,11,1568,6,705,5,863,7430.3857,1.524986,3698.394608,4527.254676,Malicious
10.0.2.15,51335,119.254.87.201,80,11,1579,6,705,5,874,19198.03209,1.650398,3417.35751,4236.553849,Malicious
172.30.15.671,49958,35.190.14.224,80,15,3898,8,3158,7,740,2397.40358,8.819095,2864.693033,671.2706916,Benign
172.30.6.255,58540,35.190.43.164,80,10,1703,6,1249,4,454,5801.827855,7.27238,1373.965607,499.4238475,Benign
10.0.2.15,48267,119.254.87.201,80,11,1513,6,705,5,808,25898.48072,1.34812,4183.603833,4794.825386,Malicious
172.30.6.255,55716,104.36.113.23,80,20,10243,11,4007,9,6236,57.330883,1.529374,20960.20986,32619.88238,Benign
192.168.43.233,51471,54.81.94.76,80,22,4421,12,3342,10,1079,3816.109944,233.003033,114.7452875,37.04672806,Benign
192.168.137.97,42504,157.240.16.39,443,584,372416,289,88416,295,284000,22.66023702,124.2538597,5692.603847,18285.14627,Benign
10.0.2.15,58234,119.254.87.201,80,11,1579,6,705,5,874,18963.44444,1.462717,3855.838142,4780.145442,Malicious
10.0.2.15,58461,119.254.87.201,80,11,1513,6,705,5,808,6977.73333,1.82592,3088.853838,3540.133193,Malicious
172.30.6.255,57747,103.243.221.87,80,32,18970,15,9262,17,9708,3844.927745,9.885956,7495.076854,7855.992885,Benign
192.168.215.49,46396,223.31.160.67,443,18,3209,9,1755,9,1454,293.0489145,17.23929063,814.4186616,674.7377402,Benign
172.30.15.2341,51675,192.168.121.37,443,175,141320,75,7013,100,134307,5310.995057,6.967551,8052.183615,154208.5591,Benign
192.168.43.233,51461,49.44.178.243,80,7,402,4,228,3,174,3813.535737,15.60118,116.9142334,89.22402023,Benign
172.30.6.255,58043,143.204.192.51,80,238,195893,100,10759,138,185134,4816.434523,56.231097,1530.68328,26339.0202,Benign
10.0.2.15,42670,119.254.87.201,80,11,1582,6,705,5,877,3794.542833,1.375112,4101.484097,5102.129863,Malicious
172.30.15.2015,51327,34.205.118.138,443,23,6214,12,1867,11,4347,4089.31425,8.302405,1798.996797,4188.665814,Benign
172.30.1.136,50291,172.217.161.4,443,12,696,6,348,6,348,490.641333,17.587276,158.2962592,158.2962592,Benign
10.0.2.15,37378,119.254.87.201,80,12,1656,7,779,5,877,18419.76062,11.795299,528.3460809,594.8132387,Malicious
10.0.2.15,53195,119.254.87.201,80,12,1587,7,779,5,808,3766.383393,4.325859,1440.638726,1494.269693,Malicious
192.168.43.224,51864,54.197.248.134,443,122,76916,63,10973,59,65943,2406.384942,107.607025,815.7831702,4902.505203,Benign
192.168.137.97,41184,23.57.218.60,443,28,6249,16,4573,12,1676,81.58797242,97.1690065,376.4986524,137.9863856,Benign
10.0.2.15,58880,119.254.87.201,80,11,1579,6,705,5,874,21846.46974,2.543793,2217.161538,2748.651325,Malicious
192.168.137.97,56170,172.217.161.14,443,20,6925,11,1521,9,5404,342.0766541,13.63424747,892.458497,3170.838736,Benign
172.30.15.317,49580,172.217.166.197,443,34,9145,17,3784,17,5361,749.783307,10.287133,2942.705222,4169.091622,Benign
172.30.6.255,56485,52.114.128.10,443,42,25831,27,18560,15,7271,810.905078,1.996322,74376.7789,29137.58402,Benign
192.168.215.49,46418,223.31.160.67,443,96,75822,36,3539,60,72283,335.727455,124.8020256,226.8552923,4633.450436,Benign
10.0.2.15,55787,119.254.87.201,80,11,1593,6,705,5,888,23102.36506,0.886397,6362.837419,8014.467558,Malicious
10.0.2.15,60758,119.254.87.201,80,11,1582,6,705,5,877,25234.66761,0.820963,6869.980742,8546.06115,Malicious
172.30.15.1847,51159,35.161.208.104,443,6,340,4,228,2,112,3877.477557,9.958052,183.1683546,89.97743735,Benign
172.30.1.136,50255,104.17.162.9,443,1,66,1,66,0,0,460.705075,0,0,0,Benign
192.168.43.233,51096,157.240.16.39,443,68,16533,34,12861,34,3672,917.090806,157.344666,653.9020522,186.6984166,Benign
172.30.15.1390,50698,156.154.136.36,443,23,7783,10,2086,13,5697,3495.999072,1.974563,8451.490279,23081.56286,Benign
172.30.6.255,56847,172.217.194.189,443,5,330,1,66,4,264,1352.42226,14.469427,36.49073319,145.9629327,Benign
172.30.15.2047,51359,151.101.2.2,443,27,13659,13,1396,14,12263,4091.023556,0.315315,35418.5497,311130.1397,Benign
172.30.15.2123,51435,54.71.19.12,443,7,402,4,228,3,174,4178.24466,3.924197,464.8084691,354.7222527,Benign
172.30.1.136,50120,52.229.170.171,443,34,11513,15,1680,19,9833,99.406215,6.693594,2007.889932,11752.13196,Benign
172.30.6.255,58392,216.58.196.162,80,20,4207,11,2371,9,1836,5526.256722,13.122298,1445.478528,1119.316144,Benign
172.30.6.255,57937,103.243.221.17,80,16,5483,9,4255,7,1228,4526.859089,27.954598,1217.688768,351.4269817,Benign
10.0.2.15,33102,119.254.87.201,80,11,1582,6,705,5,877,17098.19128,1.617865,3486.075785,4336.579381,Malicious
172.30.15.1943,51255,18.215.97.76,443,29,7560,15,2746,14,4814,4027.389696,10.077568,2179.891021,3821.556947,Benign
10.0.2.15,55780,119.254.87.201,80,11,1582,6,705,5,877,2140.433402,1.827368,3086.406241,3839.401806,Malicious
192.168.43.233,51193,104.24.19.71,443,26,8829,14,1417,12,7412,1139.297473,21.358159,530.757356,2776.269247,Benign
172.30.6.255,55942,74.217.250.101,80,6,348,4,228,2,120,152.515649,10.551061,172.8736096,90.98611031,Benign
172.30.1.136,50353,74.125.24.188,5228,38,8663,19,2502,19,6161,632.603402,194.329299,103.000423,253.6313374,Benign
10.0.2.15,53699,119.254.87.201,80,11,1582,6,705,5,877,10431.34009,0.956663,5895.492979,7333.826018,Malicious
172.30.15.2287,51612,13.107.5.88,443,40,10461,20,2878,20,7583,4796.198933,126.795109,181.5842912,478.4411676,Benign
172.30.6.255,58411,210.176.156.21,80,3,198,3,198,0,0,5551.09802,9.000428,175.9916306,0,Benign
172.30.6.255,55766,195.201.82.80,80,59,59744,15,2858,44,56886,62.234169,1.680954,13601.79993,270731.9772,Benign
172.30.6.255,55636,117.18.232.131,80,73,52419,32,9299,41,43120,35.502951,23.078138,3223.483628,14947.47973,Benign
172.30.15.2219,51534,104.121.244.70,443,153,115281,68,13266,85,102015,4442.268101,15.553715,6823.321631,52471.06559,Benign
10.0.2.15,33016,119.254.87.201,80,11,1582,6,705,5,877,24186.40392,2.494001,2261.426519,2813.150436,Malicious
192.168.43.233,51354,104.94.6.160,443,25,9191,12,1147,13,8044,3085.470719,51.508929,178.1438709,1249.33679,Benign
192.168.215.49,56664,130.211.41.44,443,107,29655,48,11892,59,17763,511.6249548,242.3580695,392.5431499,586.3390491,Benign
192.168.43.224,50446,23.251.156.28,443,2913,2467915,1205,106315,1708,2361600,179.0025433,298.04699,2853.643984,63388.66231,Benign
172.30.6.255,58530,172.217.166.226,80,10,1609,6,939,4,670,5790.835933,8.240366,911.609994,650.4565453,Benign
192.168.43.233,51657,157.240.16.39,443,7,402,4,228,3,174,857.488038,38.891654,46.89952245,35.79174082,Benign
10.0.2.15,37113,119.254.87.201,80,11,1582,6,705,5,877,18477.2776,1.748408,3225.791692,4012.793353,Malicious
172.30.6.255,57450,172.30.10.168,7680,2,132,2,132,0,0,2881.010281,3.001441,351.8310038,0,Benign
172.30.1.136,50503,157.240.16.20,443,138,86211,69,5323,69,80888,965.615586,61.851637,688.4862239,10462.19682,Benign
172.30.1.136,50188,172.217.161.3,443,27,7460,14,1861,13,5599,353.356201,16.048058,927.7134965,2791.116533,Benign
192.168.43.233,51296,216.239.32.21,80,37,9644,18,2267,19,7377,2528.12192,300.393966,60.37404892,196.4620022,Benign
172.30.15.607,49894,104.31.90.207,80,271,207998,126,20666,145,187332,2387.122094,19.151641,8632.576185,78252.09338,Benign
172.30.6.255,56289,209.205.217.82,80,11,1469,6,750,5,719,569.159972,36.908472,162.5643023,155.8449778,Benign
172.30.15.1895,51207,52.218.208.200,443,7,409,4,228,3,181,3977.839214,9.722768,187.6008972,148.9287824,Benign
172.30.6.255,57740,103.243.221.87,80,7,406,5,294,2,112,3799.84305,45.2265,52.00490863,19.81139376,Benign
192.168.137.97,34532,172.217.161.19,443,9,622,5,350,4,272,346.8328339,16.86764249,165.9983013,129.0043942,Benign
172.30.1.136,51773,204.79.197.200,443,6,348,3,174,3,174,2973.56068,40.440092,34.42128668,34.42128668,Benign
192.168.42.240,50954,172.217.166.206,443,18,5554,9,1120,9,4434,209.300611,14.613018,613.151917,2427.424643,Benign
10.0.2.15,45763,119.254.87.201,80,11,1582,6,705,5,877,22774.69353,6.898436,817.5766217,1017.042124,Malicious
192.168.43.224,38160,18.205.91.83,443,44,11712,24,3048,20,8664,42.58732275,63.46722908,384.1982761,1092.091163,Benign
10.0.2.15,50274,119.254.87.201,80,11,1582,6,705,5,877,8419.40082,1.287586,4380.289938,5448.956419,Malicious
192.168.137.97,60974,206.189.157.46,443,102,73628,41,5779,61,67849,420.8382376,147.5042569,313.4282424,3679.839561,Benign
172.30.6.255,55640,117.18.232.131,80,237,152120,97,13176,140,138944,36.634069,21.947078,4802.826144,50646.92439,Benign
192.168.43.224,50950,172.217.166.205,443,4,280,3,206,1,74,10.84235696,4.528332752,363.9308528,130.7324423,Benign
172.30.15.766,50057,209.197.3.15,443,19,6715,9,1141,10,5574,2618.654245,7.709367,1184.0142,5784.132472,Benign
192.168.43.233,50697,151.101.152.188,443,18,9739,6,1370,12,8369,1837.371894,0.857543,12780.70021,78074.21902,Benign
172.30.1.136,51498,52.84.110.227,443,2313,908971,1050,387273,1263,521698,4.251507,663.584852,4668.858836,6289.450381,Benign
172.30.6.255,58457,157.240.16.17,443,424,373074,158,10624,266,362450,5644.265208,4.806506,17682.69924,603265.657,Benign
172.30.6.255,55676,195.201.82.80,80,50,42097,18,1916,32,40181,41.403296,17.352717,883.3198859,18524.36134,Benign
172.30.1.136,50824,52.18.200.60,443,32,4901,17,3088,15,1813,1965.918906,31.58665,782.1025655,459.1813314,Benign
172.30.6.255,57126,172.217.166.206,443,125,20914,57,11749,68,9165,1861.42382,178.753417,525.819319,410.1739773,Benign
192.168.215.49,52216,52.84.110.101,443,791,740623,272,19688,519,720935,551.7727049,184.054674,855.7457227,31335.68888,Benign
172.30.1.136,50256,104.17.161.9,443,1,66,1,66,0,0,460.95694,0,0,0,Benign
172.30.15.909,50215,104.244.42.72,443,29,7040,16,5239,13,1801,3439.686961,7.574364,5533.40188,1902.205915,Benign
172.30.6.255,57227,161.69.36.37,80,7,398,4,228,3,170,2167.293815,0.825984,2208.275221,1646.520998,Benign
10.0.2.15,57324,119.254.87.201,80,11,1582,6,705,5,877,16585.41816,1.223175,4610.951009,5735.892248,Malicious
172.30.1.136,50788,151.101.129.181,443,19,2830,12,2262,7,568,1925.406661,37.930744,477.0800172,119.7972811,Benign
172.30.1.136,51783,172.217.160.243,443,38,7250,16,2303,22,4947,2974.532906,44.192738,416.9010755,895.53175,Benign
172.30.1.136,51913,172.217.160.228,443,39,19398,25,9140,14,10258,5745.551275,74.047775,987.4705891,1108.257473,Benign
192.168.43.233,51183,131.253.14.229,443,28,12449,16,1825,12,10624,634.557418,33.329633,438.0486278,2550.04308,Benign
172.30.15.525,49809,23.9.250.106,443,233,164824,92,9421,141,155403,2241.781015,14.313309,5265.588831,86857.90267,Benign
172.30.15.1522,50830,180.179.41.214,443,22,12360,10,2185,12,10175,3526.164259,0.386523,45223.6995,210595.4885,Benign
172.30.15.597,49882,23.56.25.241,443,19,7963,11,1273,8,6690,2321.317608,4.741915,2147.655536,11286.57937,Benign
192.168.43.224,51998,34.207.29.244,443,32,13238,18,6525,14,6713,1011.900683,62.22254743,838.9241868,863.095489,Benign
10.0.2.15,56417,119.254.87.201,80,12,1656,7,779,5,877,20404.96836,4.94825,1259.435154,1417.875006,Malicious
172.30.6.255,56005,34.234.151.4,443,86,72559,32,18750,54,53809,227.520166,122.914731,1220.358201,3502.200237,Benign
172.30.15.1967,51279,52.26.114.97,443,149,115347,66,5559,83,109788,4076.450569,5.499582,8086.432751,159703.7739,Benign
192.168.43.233,51302,104.16.88.20,443,18,6000,9,1080,9,4920,2531.722137,59.806982,144.4647382,658.1171409,Benign
192.168.137.97,38016,104.113.235.6,443,28,7200,14,2005,14,5195,16.64921408,71.76481427,223.5078592,579.1138795,Benign
10.0.2.15,38274,119.254.87.201,80,11,1582,6,705,5,877,19047.82458,2.242552,2514.991849,3128.578512,Malicious
192.168.137.97,55028,172.82.254.215,443,48,12402,24,6016,24,6386,0.032089662,403.9627392,119.1397011,126.4671096,Benign
192.168.43.233,51703,172.217.166.206,443,48,7385,23,3307,25,4078,1850.967288,242.063645,109.2935703,134.7744722,Benign
10.0.2.15,46211,119.254.87.201,80,11,1579,6,705,5,874,26015.72407,1.228492,4590.994488,5691.530755,Malicious
172.30.15.824,50123,172.217.166.196,443,19,3207,10,1478,9,1729,3102.164363,1.187759,9954.88142,11645.46006,Benign
192.168.43.224,39048,103.37.200.184,443,349,263232,169,13549,180,249683,2477.576043,36.63080944,2959.039171,54529.61675,Benign
172.30.6.255,57966,157.240.16.39,443,18,1879,10,1125,8,754,4632.090579,61.049271,147.4219078,98.80543864,Benign
10.0.2.15,50922,119.254.87.201,80,11,1579,6,705,5,874,10849.22431,2.025971,2783.850312,3451.184642,Malicious
172.30.15.468,49743,52.229.175.79,443,30,10192,17,2342,13,7850,1695.417803,121.943777,153.6445767,514.9914292,Benign
172.30.6.255,56981,103.243.221.51,80,36,23396,20,20894,16,2502,1437.086685,15.970155,10466.52334,1253.337867,Benign
172.30.6.255,55614,157.240.16.35,443,27,7245,14,1942,13,5303,2.59219,56.010537,277.3763801,757.4289102,Benign
192.168.43.233,51104,34.224.183.150,443,40,8451,18,3203,22,5248,918.816504,92.222388,277.8501029,455.2473744,Benign
10.0.2.15,47256,119.254.87.201,80,11,1579,6,705,5,874,9110.098609,1.95765,2881.005287,3571.629249,Malicious
172.30.6.255,58038,205.185.216.42,443,8969,7320878,4078,329128,4891,6991750,4814.901635,32.95709,79892.49051,1697176.541,Benign
10.0.2.15,36876,119.254.87.201,80,11,1579,6,705,5,874,23552.82467,2.11923,2661.343979,3299.311542,Malicious
192.168.43.233,51672,54.255.158.169,443,9,534,5,294,4,240,870.390417,26.350642,89.25778734,72.86349987,Benign
172.30.15.485,49761,162.247.242.19,443,33,15344,17,11298,16,4046,1789.163644,6.733534,13422.96631,4806.985455,Benign
172.30.6.255,57718,157.240.16.39,443,19,1933,10,1125,9,808,3717.092029,61.029862,147.4687916,105.9153632,Benign
172.30.15.2260,51577,104.121.244.70,443,48,35853,19,3623,29,32230,4486.768759,0.80776,35881.94513,319203.7239,Benign
192.168.43.233,50987,13.228.177.65,443,5,286,3,174,2,112,509.781871,11.021964,126.2932813,81.29222705,Benign
192.168.215.49,57018,108.179.217.142,443,772,654548,328,24187,444,630361,1305.670171,2.954578586,65490.21946,1706804.491,Benign
192.168.43.233,50988,49.44.170.2,443,14,1531,7,958,7,573,511.673476,11.049566,693.6019026,414.8579229,Benign
10.0.2.15,56412,119.254.87.201,80,11,1582,6,705,5,877,18873.27899,1.520057,3710.387176,4615.616388,Malicious
172.30.1.136,51863,74.125.24.188,5228,2,132,2,132,0,0,4164.781368,3.000612,351.9282066,0,Benign
172.30.15.995,50301,188.125.88.204,443,124,98267,47,3894,77,94373,3443.088902,4.172619,7465.814636,180937.6797,Benign
172.30.6.255,55776,172.217.166.202,80,231,203850,82,6018,149,197832,63.419045,249.536733,192.9335189,6342.376856,Benign
172.30.15.859,50165,68.232.44.114,80,20,12084,9,1007,11,11077,3434.378877,2.674093,3012.610257,33138.71283,Benign
192.168.43.233,51083,162.251.148.163,443,50,27860,26,6480,24,21380,916.294239,134.348217,385.8629549,1273.109564,Benign
192.168.43.233,51213,52.114.128.10,443,5,294,3,174,2,120,1245.197173,0.846638,1644.150156,1133.896659,Benign
172.30.6.255,56045,54.239.17.112,80,6,344,4,228,2,116,254.482627,27.572141,66.15373104,33.65716141,Benign
172.30.6.255,58296,157.240.16.39,443,6,348,4,228,2,120,5324.898488,9.103099,200.3713241,105.4585916,Benign
172.30.15.1137,50445,208.100.17.185,80,8,1684,5,1053,3,631,3458.30701,4.760635,1769.51184,1060.362746,Benign
172.30.6.255,57968,103.243.221.17,80,21,10665,10,4570,11,6095,4646.840029,50.216025,728.0544408,971.0047739,Benign
10.0.2.15,55237,119.254.87.201,80,11,1579,6,705,5,874,7335.568875,1.441501,3912.588337,4850.499583,Malicious
192.168.43.224,35036,34.232.42.95,443,148,111092,69,21830,79,89262,3015.327785,25.78708431,6772.382558,27692.00238,Benign
10.0.2.15,54064,119.254.87.201,80,13,1727,8,853,5,874,13582.098,10.368394,658.1540015,674.3570894,Malicious
192.168.43.224,41516,172.217.166.193,443,17,5891,9,1212,8,4679,29.0403386,11.53600084,840.4992457,3244.798656,Benign
172.30.6.255,56564,35.190.43.164,80,68,19885,36,14933,32,4952,881.904889,268.225411,445.3865857,147.6966699,Benign
192.168.43.233,51342,34.208.98.48,443,15,1590,7,958,8,632,3383.02318,35.630992,215.0936466,141.8989401,Benign
192.168.137.97,35466,104.198.143.177,80,17,1405,10,771,7,634,10827.81625,10.60912787,581.3861493,478.0788828,Benign
10.0.2.15,57597,119.254.87.201,80,11,1534,6,705,5,829,17701.88926,1.447783,3895.611428,4580.796984,Malicious
192.168.43.224,53966,14.139.116.17,443,98,60531,48,7126,50,53405,1566.139784,69.14505707,824.4696355,6178.894314,Benign
172.30.6.255,56941,103.15.158.188,80,4,240,2,120,2,120,1387.978458,10.287984,93.31274232,93.31274232,Benign
172.30.1.136,50455,157.240.16.20,443,3,198,3,198,0,0,857.487726,9.002102,175.9589038,0,Benign
172.30.6.255,56199,192.132.33.27,443,7,402,4,228,3,174,466.866877,24.251377,75.21222403,57.39880255,Benign
172.30.6.255,55662,35.190.43.164,80,25,7155,12,5311,13,1844,37.639483,20.972245,2025.91568,703.4058586,Benign
172.30.6.255,56342,103.243.221.46,80,35,21220,16,9610,19,11610,605.847583,26.229465,2931.054827,3541.055832,Benign
172.30.6.255,58413,52.213.19.114,443,6,348,4,228,2,120,5551.952526,7.244609,251.7734221,132.5123274,Benign
10.0.2.15,39948,119.254.87.201,80,11,1582,6,705,5,877,24997.42923,2.021807,2789.583773,3470.163077,Malicious
10.0.2.15,55927,119.254.87.201,80,11,1560,6,705,5,855,16435.18772,3.429261,1644.669216,1994.598836,Malicious
192.168.137.97,36334,52.84.103.186,443,30,3098,21,2103,9,995,3757.631166,108.9825589,154.3733252,73.03920997,Benign
172.30.15.1380,50688,23.58.23.32,443,19,6490,11,5588,8,902,3494.850952,2.175076,20552.84505,3317.585225,Benign
172.30.6.255,57278,103.243.220.231,80,6,340,4,228,2,112,2298.870315,23.206895,78.59733066,38.60921506,Benign
172.30.6.255,56022,52.114.74.44,443,270,240690,177,228719,93,11971,230.884779,8.417355,217378.4995,11377.44577,Benign
10.0.2.15,35201,119.254.87.201,80,11,1579,6,705,5,874,21636.22766,2.253101,2503.216678,3103.278548,Malicious
10.0.2.15,40929,219.234.85.243,80,8,944,4,688,4,256,186.159177,0.601564,9149.483679,3404.459043,Malicious
10.0.2.15,43961,119.254.87.201,80,11,1579,6,705,5,874,2683.471085,1.561264,3612.457598,4478.422611,Malicious
192.168.137.97,40178,157.240.16.20,443,11,730,6,404,5,326,22.91130518,16.94866265,190.6935117,153.8764476,Benign
172.30.6.255,57388,103.243.221.17,80,40,27130,16,8868,24,18262,2664.880443,17.233161,4116.714281,8477.608954,Benign
172.30.15.1482,50790,23.58.57.98,443,19,4252,10,3017,9,1235,3520.905212,6.132994,3935.435124,1610.958693,Benign
192.168.43.233,51175,204.79.197.200,443,5,302,3,186,2,116,557.881181,131.437932,11.32093283,7.060366714,Benign
172.30.1.136,50570,122.15.34.32,80,14,1278,7,629,7,649,1563.170034,98.640215,51.01367632,52.6357328,Benign
192.168.137.97,45906,103.102.166.240,443,69,28293,37,3829,32,24464,1165.525058,181.584232,168.6930615,1077.802835,Benign
172.30.6.255,56754,54.194.27.245,443,6,396,1,66,5,330,1244.397425,15.225623,34.67838393,173.3919197,Benign
10.0.2.15,54121,119.254.87.201,80,11,1569,6,705,5,864,18777.65667,2.161269,2609.577984,3198.121104,Malicious
172.30.15.2347,51681,192.168.121.37,443,11,1879,7,1483,4,396,5313.06116,4.944069,2399.642885,640.7677563,Benign
10.0.2.15,59308,119.254.87.201,80,11,1582,6,705,5,877,4457.228561,1.884553,2992.752127,3722.898746,Malicious
172.30.6.255,55861,103.15.158.128,443,18,8994,9,3070,9,5924,104.860861,10.246041,2397.023397,4625.396287,Benign
10.0.2.15,45797,119.254.87.201,80,11,1582,6,705,5,877,1842.334897,1.621115,3479.086925,4327.885437,Malicious
172.30.6.255,55682,195.201.82.80,80,15,6637,8,870,7,5767,41.819123,16.936758,410.9405118,2724.016013,Benign
10.0.2.15,48652,119.254.87.201,80,11,1513,6,705,5,808,4937.722945,1.832244,3078.192642,3527.914404,Malicious
172.30.1.136,50128,172.217.161.5,443,1227,919084,493,69470,734,849614,105.980934,259.445052,2142.110615,26197.8864,Benign
172.30.15.2518,51852,151.139.104.1,443,30,14885,13,1802,17,13083,5487.728489,10.263729,1404.557739,10197.46332,Benign
10.0.2.15,57864,119.254.87.201,80,11,1582,6,705,5,877,17041.05276,2.215186,2546.061595,3167.228395,Malicious
192.168.43.233,51385,210.176.156.35,443,32,8083,16,3074,16,5009,3478.262149,317.350372,77.49163754,126.270531,Benign
172.30.15.787,50079,34.200.202.18,443,78,54260,36,7970,42,46290,2674.716916,14.381801,4433.380771,25749.20902,Benign
10.0.2.15,50854,119.254.87.201,80,12,1653,7,779,5,874,13977.45529,3.813154,1634.342594,1833.652667,Malicious
192.168.137.97,39106,172.217.161.4,443,723,370444,324,40609,399,329835,17.58952282,258.1023703,1258.694369,10223.38538,Benign
172.30.15.1299,50607,173.241.248.220,80,6,535,4,228,2,307,3471.411242,6.211699,293.6394697,395.3829701,Benign
172.30.6.255,55797,104.36.113.23,443,21,6749,10,1219,11,5530,89.111996,13.834431,704.9079214,3197.818544,Benign
172.30.6.255,57645,103.243.221.46,80,40,29211,16,5623,24,23588,3516.843752,1.640252,27425.0542,115045.7369,Benign
172.30.6.255,58546,103.243.221.51,80,14,8192,10,6672,4,1520,5813.893963,9.619284,5548.85374,1264.127351,Benign
192.168.137.97,59352,157.240.16.20,443,22,5594,12,1381,10,4213,466.7439428,101.5987535,108.7414916,331.7363533,Benign
172.30.15.471,49746,162.125.82.3,443,6,348,4,228,2,120,1722.127507,0.284936,6401.437516,3369.17764,Benign
172.30.15.1848,51160,52.6.46.142,443,22,4193,12,2728,10,1465,3880.707644,6.655895,3278.897879,1760.845085,Benign
172.30.15.1640,50950,184.29.25.7,443,1065,987363,386,97643,679,889720,3575.558289,31.486308,24809.00587,226058.8952,Benign
172.30.15.1350,50658,52.84.102.103,443,42,11978,21,4660,21,7318,3492.305803,4.711128,7913.179179,12426.7479,Benign
10.0.2.15,49831,119.254.87.201,80,11,1560,6,705,5,855,17276.23668,1.451659,3885.209956,4711.850373,Malicious
172.30.1.136,50309,104.17.161.9,443,20,7600,10,1662,10,5938,552.593201,14.058563,945.758112,3379.008224,Benign
10.0.2.15,57201,119.254.87.201,80,11,1579,6,705,5,874,10734.03744,249.665887,22.59019071,28.00542791,Malicious
172.30.15.1041,50347,52.45.111.226,443,18,5717,10,1767,8,3950,3447.574929,9.370055,1508.635755,3372.445519,Benign
172.30.15.570,49854,50.31.185.52,443,6,348,4,228,2,120,2254.855419,1.423145,1281.668417,674.562325,Benign
192.168.43.224,44720,157.240.16.52,443,63,27444,32,3702,31,23742,350.5003715,67.99423573,435.5663342,2793.413265,Benign
172.30.15.2196,51508,52.84.108.186,443,30,10778,15,1889,15,8889,4286.878429,10.612378,1423.997524,6700.854417,Benign
172.30.6.255,55656,159.180.93.4,443,6,348,4,228,2,120,37.477215,13.932498,130.9169397,68.90365245,Benign
172.30.6.255,57272,103.243.220.231,80,35,22046,16,8323,19,13723,2285.858711,36.557652,1821.342355,3003.037504,Benign
192.168.43.233,51238,172.217.160.228,443,55,7785,26,4952,29,2833,1633.022341,247.200468,160.2585963,91.68267432,Benign
192.168.215.49,42790,35.237.145.81,443,74,4884,37,2442,37,2442,26.84637473,1659.173704,11.77453569,11.77453569,Benign
10.0.2.15,54307,119.254.87.201,80,11,1579,6,705,5,874,25928.50831,1.222155,4614.799269,5721.04193,Malicious
172.30.15.555,49839,23.56.26.209,443,6,348,4,228,2,120,2252.849403,3.310024,551.0534063,290.0281086,Benign
10.0.2.15,47252,119.254.87.201,80,11,1579,6,705,5,874,25750.67172,4.049739,1392.682343,1726.531018,Malicious
192.168.43.233,51277,13.107.42.254,443,47,16029,26,3685,21,12344,2702.353469,17.827573,1653.618246,5539.284568,Benign
172.30.15.2152,51464,104.16.120.145,443,90,24333,47,7066,43,17267,4182.986272,14.446115,3913.024367,9562.155638,Benign
172.30.15.2167,51479,31.24.224.56,443,592,487172,242,17790,350,469382,4244.21561,14.146638,10060.34084,265438.0497,Benign
10.0.2.15,39471,119.254.87.201,80,11,1569,6,705,5,864,23468.2575,2.074415,2718.838805,3332.023727,Malicious
172.30.6.255,58080,103.243.221.46,80,85,60213,52,50337,33,9876,4857.229988,15.479212,26015.27778,5104.135792,Benign
192.168.43.224,44582,192.168.121.2,443,7,518,7,518,0,0,2461.522551,64.80172444,63.9489155,0,Benign
172.30.6.255,57116,52.229.173.178,443,28,10050,14,2146,14,7904,1836.159907,128.284121,133.8279427,492.9058991,Benign
192.168.43.233,51296,23.9.140.60,80,29,10348,16,8722,13,1626,2820.175032,68.294755,1021.689001,190.4685067,Benign
10.0.2.15,59223,119.254.87.201,80,11,1513,6,705,5,808,11962.81625,1.446742,3898.414507,4467.970101,Malicious
172.30.6.255,58348,157.240.16.39,443,5,330,1,66,4,264,5425.092136,15.062413,35.05414438,140.2165775,Benign
172.30.15.936,50242,35.203.66.107,443,53,12467,27,4050,26,8417,3440.999409,6.284769,5155.320744,10714.15672,Benign
172.30.15.250,49518,13.107.4.50,80,1131,1112416,364,20532,767,1091884,61.162849,30.149742,5448.006819,289722.9436,Benign
172.30.1.136,51897,13.107.4.52,80,12,1651,6,502,6,1149,4734.213997,0.591995,6783.84108,15527.15817,Benign
172.30.1.136,50430,172.217.161.3,443,2,132,2,132,0,0,835.244047,3.000086,351.9899096,0,Benign
192.168.215.49,60100,192.82.210.131,443,15,3026,8,2060,7,966,1292.773179,3.967052502,4154.21777,1948.045809,Benign
10.0.2.15,53473,119.254.87.201,80,11,1582,6,705,5,877,12805.9976,1.221778,4616.223242,5742.450756,Malicious
192.168.43.224,53970,14.139.116.17,443,35,18617,17,2260,18,16357,1573.216683,62.06173445,291.3228281,2108.481195,Benign
172.30.15.258,49521,172.217.161.10,443,42,10725,20,4671,22,6054,76.536132,2.951059,12662.57299,16411.73558,Benign
172.30.6.255,57912,52.229.172.155,443,29,10198,16,2336,13,7862,4440.588283,62.17437,300.5740147,1011.606551,Benign
10.0.2.15,60454,119.254.87.201,80,11,1513,6,705,5,808,25748.27573,2.016716,2796.625802,3205.210848,Malicious
172.30.15.2233,51550,104.121.244.70,443,77,54218,36,11160,41,43058,4457.928717,10.286181,8679.606163,33488.03604,Benign
172.30.15.241,49510,23.198.126.238,443,18,6436,8,1318,10,5118,53.221413,0.746357,14127.28761,54858.46585,Benign
192.168.42.240,50965,216.58.221.46,443,15,918,9,546,6,372,236.282167,43.851364,99.60921626,67.86561987,Benign
192.168.43.233,51293,23.9.140.60,80,13,4010,8,3416,5,594,2807.137148,5.150687,5305.699997,922.5953742,Benign
172.30.15.1158,50466,173.241.248.220,80,26,17879,11,1736,15,16143,3460.501886,7.052246,1969.301695,18312.46386,Benign
172.30.6.255,56221,54.209.69.152,80,16,2858,9,1649,7,1209,469.966402,61.545231,214.3464211,157.1527126,Benign
172.30.6.255,56569,103.243.221.109,80,59,51363,22,13663,37,37700,887.913701,61.583017,1774.904922,4897.454115,Benign
172.30.1.136,51761,74.125.68.188,5228,20,2415,11,1475,9,940,2948.272241,77.813377,151.6448772,96.64148107,Benign
172.30.15.1595,50904,13.107.21.200,443,34,10919,16,2601,18,8318,3572.915189,4.097104,5078.709254,16241.7161,Benign
172.30.15.785,50077,34.200.202.18,443,140,97259,66,10619,74,86640,2674.689606,11.781983,7210.331232,58828.80666,Benign
192.168.43.224,51340,209.167.231.17,443,4,268,2,140,2,128,107.982324,11.08506168,101.0368758,92.37657217,Benign
192.168.215.49,42246,111.119.15.1,443,1272,964395,523,39041,749,925354,509.7224849,187.2892808,1667.623468,39526.19162,Benign
10.0.2.15,57235,119.254.87.201,80,11,1582,6,705,5,877,1692.191477,1.687013,3343.187041,4158.829837,Malicious
192.168.137.97,49208,52.84.109.5,443,12,828,8,536,4,292,3808.577731,30.63437286,139.9734873,76.25421322,Benign
172.30.6.255,57319,103.243.221.51,80,31,23004,11,5835,20,17169,2467.877936,43.15016,1081.803636,3183.116818,Benign
10.0.2.15,35797,119.254.87.201,80,11,1579,6,705,5,874,7097.886181,0.827888,6812.515703,8445.586843,Malicious
192.168.42.240,50899,172.217.161.10,443,68,29700,29,2430,39,27270,21.606896,258.515885,75.19847378,843.8939835,Benign
172.30.6.255,57392,103.243.221.75,80,6,340,4,228,2,112,2666.594944,15.519157,117.5321572,57.73509476,Benign
10.0.2.15,43286,119.254.87.201,80,11,1579,6,705,5,874,26171.21582,1.349303,4179.935863,5181.934673,Malicious
172.30.15.2221,51536,104.121.244.70,443,107,85171,42,6769,65,78402,4443.552403,14.268483,3795.217754,43958.14187,Benign
10.0.2.15,50902,119.254.87.201,80,11,1513,6,705,5,808,4307.102117,1.225605,4601.808903,5274.12992,Malicious
172.30.6.255,57332,52.213.19.114,443,18,6378,9,1141,9,5237,2468.838337,42.754885,213.4960719,979.9114183,Benign
172.30.15.1672,50983,157.240.16.39,443,23,3171,13,1902,10,1269,3595.491562,1.889479,8053.013556,5372.909675,Benign
192.168.43.233,50855,172.217.166.206,443,28,2391,14,1126,14,1265,3.384936,242.540256,37.14022632,41.72503224,Benign
10.0.2.15,53763,119.254.87.201,80,11,1579,6,705,5,874,6014.345904,0.886118,6364.8408,7890.596963,Malicious
172.30.6.255,57083,115.114.126.194,443,17,6860,10,1174,7,5686,1695.800187,39.601197,237.1645483,1148.652148,Benign
10.0.2.15,42258,119.254.87.201,80,11,1582,6,705,5,877,9377.620482,1.055969,5341.065884,6644.13444,Malicious
192.168.43.233,51190,192.229.237.96,443,23,6188,11,1249,12,4939,1102.279523,36.476272,273.9315026,1083.224733,Benign
10.0.2.15,33139,119.254.87.201,80,12,1587,7,779,5,808,24093.4377,6.208659,1003.759427,1041.126594,Malicious
172.30.6.255,57449,157.240.16.39,443,19,1933,10,1125,9,808,2863.086095,61.033251,147.4606031,105.909482,Benign
10.0.2.15,38758,119.254.87.201,80,5,340,4,276,1,64,14965.92244,12.755861,173.0969003,40.13841167,Malicious
172.30.15.1297,50605,210.176.156.62,80,14,5294,7,3712,7,1582,3471.143126,0.890822,33335.50361,14207.1031,Benign
192.168.43.224,42698,107.21.25.13,443,7,474,5,346,2,128,41.85435682,15.09287287,183.3978212,67.8465928,Benign
172.30.1.136,50494,172.217.161.14,443,24,1392,14,804,10,588,959.165884,43.810704,146.8134363,107.3710206,Benign
172.30.1.136,51818,52.84.110.171,443,585,192178,278,139552,307,52626,3017.419718,286.310462,3899.319613,1470.459714,Benign
192.168.43.233,51336,104.16.50.161,443,56,13957,28,2597,28,11360,3371.282827,403.6383,51.47182515,225.152073,Benign
172.30.6.255,56494,103.243.221.17,80,6,340,4,228,2,112,818.086574,10.970988,166.2566762,81.66994623,Benign
172.30.15.2102,51414,151.101.66.2,443,20,3192,10,2002,10,1190,4146.22526,1.170611,13681.74398,8132.505162,Benign
192.168.43.233,51087,185.167.164.39,443,7,398,4,228,3,170,916.42217,12.179282,149.7625229,111.665039,Benign
10.0.2.15,44627,119.254.87.201,80,11,1513,6,705,5,808,21576.1558,1.489526,3786.439445,4339.635562,Malicious
192.168.43.224,37934,103.37.200.180,80,9,618,5,338,4,280,2541.954785,29.29946126,92.28838632,76.45191766,Benign
10.0.2.15,40561,119.254.87.201,80,11,1579,6,705,5,874,23918.6462,2.21701,2543.966874,3153.797231,Malicious
192.168.43.224,55390,34.200.202.18,443,14,1660,8,1080,6,580,3112.233547,21.08985374,409.6756719,220.011009,Benign
192.168.43.224,47486,157.240.16.16,443,36,7870,18,2561,18,5309,1206.819355,68.4572701,299.2815806,620.4162091,Benign
172.30.6.255,58484,103.243.221.87,80,46,33168,19,9068,27,24100,5682.843744,6.404409,11327.19662,30104.26099,Benign
172.30.1.136,50506,104.113.230.86,443,22,2805,9,1595,13,1210,966.118276,33.258824,383.6575821,291.0505795,Benign
172.30.15.2516,51850,52.221.28.239,443,167,130672,73,6181,94,124491,5483.897002,4.260578,11605.93703,233754.1995,Benign
172.30.15.1502,50810,184.29.24.49,443,124,103844,46,5691,78,98153,3521.02797,6.009346,7576.198808,130667.1308,Benign
192.168.43.224,60928,151.101.1.69,443,350,209649,169,16019,181,193630,1202.704077,611.5230587,209.5620078,2533.085185,Benign
192.168.43.233,50700,52.229.171.86,443,29,9433,14,1375,15,8058,1838.343996,1.65096,6662.790134,39046.37302,Benign
172.30.6.255,57259,13.250.67.150,443,6,340,4,228,2,112,2252.301771,18.650887,97.79695732,48.04061062,Benign
172.30.15.1556,50865,54.169.137.62,80,6,348,4,228,2,120,3555.240344,1.862311,979.428248,515.4885516,Benign
10.0.2.15,47507,119.254.87.201,80,11,1582,6,705,5,877,10824.27463,1.145177,4925.00286,6126.563841,Malicious
192.168.137.97,60230,172.217.161.4,443,55,6277,27,3524,28,2753,4210.016988,242.9798792,116.0260681,90.6412501,Benign
10.0.2.15,33970,119.254.87.201,80,11,1593,6,705,5,888,7940.946931,2.306514,2445.248544,3079.972634,Malicious
172.30.1.136,51542,172.217.161.4,443,3,198,3,198,0,0,702.129991,8.999552,176.0087613,0,Benign
172.30.15.377,49645,195.154.150.142,80,6,348,4,228,2,120,1452.541254,8.012888,227.6332828,119.8069909,Benign
172.30.6.255,56172,35.190.43.164,80,93,27697,48,20485,45,7212,434.877407,421.234374,389.0470724,136.968879,Benign
192.168.215.49,36436,157.240.16.52,443,91,66470,36,3414,55,63056,31.10590965,65.14053173,419.2781249,7743.995737,Benign
172.30.15.837,50140,34.232.42.95,443,23,7424,14,4360,9,3064,3217.431917,9.606707,3630.796692,2551.550703,Benign
192.168.43.224,45472,54.173.101.22,443,22,6157,12,1984,10,4173,44.56337468,12.5559252,1264.104377,2658.824377,Benign
172.30.6.255,56501,52.232.69.150,443,25,16960,11,1648,14,15312,822.530817,51.052582,258.2435498,2399.408516,Benign
172.30.6.255,58387,172.217.166.197,443,51,23621,26,5250,25,18371,5504.84146,4.238295,9909.64527,34676.20824,Benign
10.0.2.15,45744,119.254.87.201,80,11,1582,6,705,5,877,22231.316,0.952421,5921.75099,7366.490239,Malicious
192.168.43.233,51189,192.229.237.96,443,23,6188,11,1249,12,4939,1102.278821,36.476973,273.9262383,1083.203916,Benign
172.30.1.136,51517,52.84.108.242,443,57,15575,30,6554,27,9021,9.846398,190.07406,275.8503712,379.6835823,Benign
192.168.43.224,54310,52.206.154.207,443,7,478,4,272,3,206,21.20715536,11.41260974,190.6662937,144.4016783,Benign
10.0.2.15,39002,119.254.87.201,80,11,1579,6,705,5,874,19080.43211,1.025747,5498.431875,6816.495686,Malicious
192.168.137.97,37524,172.217.160.227,443,2,120,1,66,1,54,29.88533595,1.109230759,476.0055522,389.4590882,Benign
192.168.43.233,51183,63.215.202.75,443,51,13252,25,3346,26,9906,1052.118287,385.439317,69.44802676,205.6043494,Benign
172.30.6.255,55897,50.112.42.246,443,6,348,4,228,2,120,115.533478,11.653635,156.5176874,82.37773021,Benign
10.0.2.15,58480,119.254.87.201,80,11,1579,6,705,5,874,2470.821179,2.02126,2790.3387,3459.228402,Malicious
10.0.2.15,49256,119.254.87.201,80,11,1582,6,705,5,877,25868.42568,1.220399,4621.439382,5748.939486,Malicious
172.30.15.1381,50689,50.116.239.135,443,19,6116,10,2164,9,3952,3495.374335,1.718436,10074.27684,18398.12481,Benign
172.30.6.255,56408,157.240.16.39,443,28,5555,15,3407,13,2148,667.085645,61.074538,446.2743541,281.3611132,Benign
192.168.43.224,34092,52.84.108.208,443,39,20519,20,3212,19,17307,2890.749935,2.788391676,9215.348124,49654.43026,Benign
172.30.6.255,57185,103.243.221.75,80,25,17137,10,4551,15,12586,2043.862274,29.168083,1248.213672,3451.992371,Benign
10.0.2.15,50373,119.254.87.201,80,12,1656,7,779,5,877,14548.21834,5.423238,1149.128989,1293.692071,Malicious
192.168.215.49,55856,156.154.202.36,443,19,3981,9,2365,10,1616,512.144652,1.93134654,9796.274054,6693.775422,Benign
10.0.2.15,35016,119.254.87.201,80,11,1582,6,705,5,877,17131.18384,1.227071,4596.311053,5717.680558,Malicious
192.168.43.224,53998,23.213.82.189,443,37,7773,20,2521,17,5252,113.7642241,304.0149881,66.33883455,138.2037124,Benign
192.168.137.97,41116,104.17.161.9,443,7,410,4,236,3,174,9545.481744,18.75294968,100.6774951,74.22832269,Benign
10.0.2.15,60317,119.254.87.201,80,11,1513,6,705,5,808,15716.62513,2.089245,2699.539786,3093.940634,Malicious
172.30.15.1628,50938,184.29.25.7,443,1027,941842,380,86169,647,855673,3574.56463,32.47271,21228.65631,210804.2107,Benign
192.168.137.97,51826,38.81.32.37,443,21,7541,11,1569,10,5972,127.8996063,11.8492708,1059.305691,4031.978068,Benign
172.30.1.136,50587,104.113.230.86,443,23,2343,9,1090,14,1253,1595.388157,15.587877,559.4090844,643.0638374,Benign
10.0.2.15,42334,119.254.87.201,80,11,1569,6,705,5,864,8479.431479,2.015355,2798.514406,3429.668718,Malicious
192.168.137.97,54824,52.84.108.88,443,26737,24866708,9856,692106,16881,24174602,1839.486624,383.3628866,14442.83783,504474.5403,Benign
10.0.2.15,44809,119.254.87.201,80,11,1579,6,705,5,874,3195.760708,0.824433,6841.065314,8480.980262,Malicious
192.168.43.233,51517,13.107.51.254,443,37,9499,19,1881,18,7618,3916.028544,128.861569,116.7764766,472.9416262,Benign
10.0.2.15,49442,119.254.87.201,80,11,1593,6,705,5,888,1329.502927,0.914149,6169.672559,7771.162032,Malicious
172.30.6.255,57440,103.243.221.109,80,17,6252,9,4498,8,1754,2829.864535,31.166472,1154.574056,450.227411,Benign
172.30.6.255,58237,103.243.221.75,80,41,24405,25,20311,16,4094,5221.875464,38.284483,4244.226048,855.4901995,Benign
10.0.2.15,57636,119.254.87.201,80,11,1582,6,705,5,877,22296.95778,1.717085,3284.636462,4085.994578,Malicious
172.30.6.255,57067,103.243.221.17,80,24,15230,11,5834,13,9396,1679.879912,16.111758,2896.766448,4665.412676,Benign
192.168.43.233,51670,107.22.42.44,443,7,402,4,228,3,174,870.376888,24.803179,73.53896047,56.12183825,Benign
10.0.2.15,34856,119.254.87.201,80,11,1579,6,705,5,874,9347.547529,1.883204,2994.895933,3712.821341,Malicious
172.30.6.255,58305,157.240.16.17,443,1934,1708690,749,47375,1185,1661315,5337.288812,41.732068,9081.745002,318472.5952,Benign
172.30.15.280,49543,172.217.166.206,443,22,8700,11,1922,11,6778,309.81323,4.900628,3137.557064,11064.70436,Benign
172.30.1.136,51784,172.217.160.243,443,20,5018,8,1066,12,3952,2974.547673,2.74418,3107.667864,11521.11013,Benign
10.0.2.15,52092,119.254.87.201,80,11,1582,6,705,5,877,17698.88909,1.089895,5174.810418,6437.317356,Malicious
172.30.1.136,50134,119.81.119.5,80,7,402,4,228,3,174,112.824707,19.399698,94.0220822,71.75369431,Benign
192.168.137.97,34358,172.217.161.3,443,9,638,8,572,1,66,214.0393839,65.10684079,70.2844731,8.109746896,Benign
10.0.2.15,36042,119.254.87.201,80,11,1582,6,705,5,877,18512.89175,1.643059,3432.621714,4270.084032,Malicious
192.168.43.233,51107,52.84.102.201,443,10,588,5,294,5,294,918.920401,21.394865,109.9329208,109.9329208,Benign
10.0.2.15,43642,119.254.87.201,80,11,1582,6,705,5,877,23105.15694,0.818604,6889.778208,8570.688636,Malicious
172.30.15.928,50234,208.100.17.185,80,6,531,4,228,2,303,3440.884009,6.379643,285.9094153,379.9585651,Benign
10.0.2.15,37270,119.254.87.201,80,11,1579,6,705,5,874,21005.40548,1.419626,3972.877363,4925.240873,Malicious
10.0.2.15,41907,119.254.87.201,80,11,1582,6,705,5,877,5776.527968,1.617599,3486.64904,4337.292493,Malicious
172.30.1.136,50307,104.17.162.9,443,19,7093,10,1209,9,5884,552.263568,14.388478,672.2045236,3271.506549,Benign
172.30.1.136,50230,104.237.191.1,443,3,198,3,198,0,0,428.892261,9.000676,175.9867814,0,Benign
10.0.2.15,34740,119.254.87.201,80,11,1579,6,705,5,874,11031.8524,1.888076,2987.167889,3703.240759,Malicious
10.0.2.15,43170,219.234.85.243,80,11,1631,6,796,5,835,180.218635,2.697942,2360.317605,2475.961307,Malicious
172.30.15.2239,51556,192.168.1.44,7680,2,132,2,132,0,0,4463.398528,3.001114,351.8693392,0,Benign
172.30.6.255,56904,210.176.156.55,80,6,348,4,228,2,120,1385.59894,18.878384,96.61843937,50.8518102,Benign
10.0.2.15,50756,119.254.87.201,80,11,1579,6,705,5,874,192.568809,1.635184,3449.153123,4275.971389,Malicious
172.30.6.255,56100,52.198.158.144,80,13,1648,7,943,6,705,305.8258,63.160832,119.4411119,89.29584715,Benign
10.0.2.15,59586,119.254.87.201,80,11,1579,6,705,5,874,11359.77367,0.826403,6824.757413,8460.76309,Malicious
192.168.43.233,51674,23.21.249.197,443,13,741,7,393,6,348,891.256165,156.994839,20.02613602,17.73306701,Benign
10.0.2.15,47687,119.254.87.201,80,11,1513,6,705,5,808,12681.13639,11.226366,502.3887516,575.7873919,Malicious
10.0.2.15,40665,119.254.87.201,80,3,222,3,222,0,0,18933.32166,9.03183,196.6378907,0,Malicious
10.0.2.15,46527,119.254.87.201,80,11,1585,6,705,5,880,23318.00711,0.893354,6313.286782,7880.414707,Malicious
192.168.137.97,51754,172.217.161.3,443,158,86165,84,10036,74,76129,3765.667731,82.37224935,974.6971903,7393.655082,Benign
172.30.6.255,57564,210.176.156.62,80,14,5521,7,3905,7,1616,3253.848602,6.702701,4660.807636,1928.774684,Benign
172.30.1.136,51820,23.21.249.197,443,15,873,8,459,7,414,3031.782691,162.764974,22.56013631,20.34835824,Benign
172.30.6.255,58144,157.240.16.39,443,19,1933,10,1125,9,808,4937.092338,61.030693,147.4667836,105.913921,Benign
172.30.6.255,58350,157.240.16.39,443,18,1879,10,1125,8,754,5425.393742,60.755479,148.134788,99.28322679,Benign
172.30.6.255,57053,157.240.16.39,443,19,1933,10,1125,9,808,1643.096106,61.026465,147.4770003,105.9212589,Benign
192.168.137.97,56532,23.57.201.101,443,31,7401,16,2132,15,5269,80.62408016,79.74939479,213.8699616,528.5557352,Benign
10.0.2.15,38811,119.254.87.201,80,11,1579,6,705,5,874,12926.05878,2.023346,2787.461957,3455.662057,Malicious
10.0.2.15,40527,119.254.87.201,80,11,1579,6,705,5,874,1990.230974,1.890343,2983.585519,3698.799636,Malicious
172.30.15.1733,51044,54.201.247.66,443,6,348,4,228,2,120,3623.836322,3.545336,514.4787405,270.7782845,Benign
172.30.15.2367,51701,14.139.45.128,80,21,13249,8,834,13,12415,5333.087619,0.339501,19652.37216,292547.0028,Benign
172.30.15.1092,50398,205.185.216.42,80,6,348,4,228,2,120,3453.102262,4.153502,439.1474953,231.1302607,Benign
192.168.43.224,38672,23.213.72.244,443,23,6267,13,1553,10,4714,2280.202084,16.25639936,764.2528781,2319.824898,Benign
192.168.43.233,51321,104.19.195.151,443,8,456,4,228,4,228,3365.292609,15.445838,118.0900641,118.0900641,Benign
172.30.6.255,55922,52.212.169.136,80,13,1872,7,891,6,981,121.806182,61.194898,116.4802987,128.2459855,Benign
172.30.15.1632,50942,152.195.60.249,443,6,348,4,228,2,120,3574.820568,2.18807,833.6113561,438.742819,Benign
172.30.1.136,50382,157.240.16.20,443,27,6424,8,1606,19,4818,690.137919,125.206916,102.6141399,307.8424198,Benign
172.30.15.435,49709,59.63.81.183,443,10,612,6,360,4,252,1623.638215,7.230155,398.3317093,278.8321965,Benign
192.168.137.97,56112,172.217.161.14,443,11,766,6,428,5,338,281.2467561,23.44665131,146.033647,115.3256371,Benign
10.0.2.15,35834,119.254.87.201,80,11,1582,6,705,5,877,6767.498092,3.565333,1581.899924,1967.838628,Malicious
192.168.215.49,51364,18.211.245.141,443,19,2143,11,1315,8,828,235.2875327,102.5344927,102.5996201,64.60265052,Benign
10.0.2.15,34850,119.254.87.201,80,11,1593,6,705,5,888,1033.50769,1.888588,2986.358062,3761.540368,Malicious
192.168.43.224,48406,34.227.208.227,443,8,605,4,264,4,341,40.64343455,10.52789443,200.6099143,259.1211393,Benign
10.0.2.15,32933,119.254.87.201,80,11,1513,6,705,5,808,12500.8141,1.683296,3350.569359,3840.085166,Malicious
192.168.43.233,50873,204.79.197.213,443,38,15859,19,5032,19,10827,10.928786,71.735422,561.1732513,1207.436962,Benign
10.0.2.15,53867,119.254.87.201,80,11,1582,6,705,5,877,13942.54639,1.689147,3338.963394,4153.57574,Malicious
172.30.6.255,58577,103.243.221.46,80,21,16881,16,14994,5,1887,5880.101744,2.177603,55084.42081,6932.393095,Benign
192.168.137.97,42386,172.217.194.188,443,14,972,7,506,7,466,12293.94343,62.62293082,64.64085834,59.53090907,Benign
192.168.43.233,50113,131.253.61.80,443,1,54,0,0,1,54,50.214084,0,0,0,Benign
172.30.15.1812,51124,184.29.24.149,443,12,1433,6,914,6,519,3743.356134,3.762185,1943.55142,1103.61399,Benign
172.30.15.1786,51098,52.37.171.77,443,58,19545,31,13145,27,6400,3642.806308,4.628411,22720.54059,11062.11181,Benign
172.30.15.717,50004,52.19.169.14,443,21,8022,10,1732,11,6290,2407.973121,8.33895,1661.600082,6034.33286,Benign
10.0.2.15,59987,119.254.87.201,80,11,1587,6,705,5,882,23612.88577,0.931378,6055.543506,7575.871451,Malicious
192.168.137.97,56426,52.216.165.221,443,33,9618,18,1683,15,7935,1042.055414,12.60279205,1068.334695,5036.979086,Benign
172.30.15.2061,51373,54.236.156.42,443,16,4806,9,1153,7,3653,4104.266929,3.030493,3043.729189,9643.315461,Benign
10.0.2.15,40704,119.254.87.201,80,13,1730,8,853,5,877,1419.556913,10.247521,665.9171521,684.6533908,Malicious
172.30.6.255,58378,103.243.221.109,80,30,18190,18,15131,12,3059,5485.106297,4.114033,29423.19617,5948.420929,Benign
172.30.15.1955,51267,34.205.118.138,443,25,6841,13,2351,12,4490,4029.621788,7.839736,2399.060377,4581.786938,Benign
172.30.6.255,55751,52.32.41.162,80,6,396,1,66,5,330,58.377911,15.748587,33.52681736,167.6340868,Benign
172.30.6.255,58495,216.58.196.162,80,6,348,4,228,2,120,5711.168179,7.924517,230.1717568,121.1430299,Benign
10.0.2.15,47751,119.254.87.201,80,11,1579,6,705,5,874,25297.84514,1.250809,4509.081722,5589.982164,Malicious
172.30.15.459,49733,162.247.242.20,443,23,6281,11,2376,12,3905,1641.5506,9.154193,2076.425524,3412.643802,Benign
172.30.6.255,58304,157.240.16.17,443,15,4922,8,1025,7,3897,5326.657849,7.294678,1124.107192,4273.800708,Benign
10.0.2.15,58812,119.254.87.201,80,11,1579,6,705,5,874,15959.73047,2.149572,2623.778129,3252.740546,Malicious
172.30.6.255,57103,115.114.126.194,443,17,6860,10,1174,7,5686,1795.654068,15.757611,596.0294362,2886.732005,Benign
192.168.43.233,51105,144.2.1.5,443,6,348,3,174,3,174,918.869456,20.288485,68.6103472,68.6103472,Benign
10.0.2.15,41232,119.254.87.201,80,11,1579,6,705,5,874,8506.720042,2.151375,2621.579223,3250.014526,Malicious
10.0.2.15,42397,119.254.87.201,80,11,1513,6,705,5,808,17671.86668,1.448752,3893.005842,4461.771235,Malicious
192.168.43.224,47532,104.24.19.65,443,18,6456,10,1141,8,5315,728.6606846,12.44999187,733.1731693,3415.263273,Benign
172.30.6.255,56347,185.84.60.60,80,11,1297,6,788,5,509,607.669614,34.392041,183.298223,118.3994867,Benign
172.30.1.136,50520,104.237.191.1,443,1,66,1,66,0,0,1025.766775,0,0,0,Benign
172.30.15.735,50022,104.31.90.207,80,12,2628,7,1890,5,738,2491.366934,4.970135,3042.170887,1187.895299,Benign
192.168.43.224,34082,52.84.108.208,443,22,7893,13,2070,9,5823,2884.942664,24.08083037,687.6839273,1934.484787,Benign
192.168.43.233,50734,172.217.166.202,443,17,4582,9,1120,8,3462,1858.564271,10.532554,850.6958521,2629.561643,Benign
172.30.6.255,57276,103.243.221.87,80,40,29001,27,25061,13,3940,2298.849838,23.512601,8526.832059,1340.557772,Benign
172.30.15.2048,51360,64.74.232.52,443,6,348,4,228,2,120,4091.140818,6.45324,282.648716,148.7624821,Benign
172.30.1.136,50747,157.240.16.16,443,15,3468,11,3216,4,252,1894.110208,66.013021,389.7412906,30.53942949,Benign
192.168.137.97,37700,23.57.214.252,443,12,832,7,478,5,354,3532.804676,26.96899195,141.7924707,105.0094867,Benign
172.30.6.255,58547,103.231.98.53,80,19,6478,10,5744,9,734,5813.894373,5.249916,8752.901951,1118.494086,Benign
172.30.6.255,57668,103.243.221.46,80,30,17154,14,4486,16,12668,3571.83776,12.710502,2823.491944,7973.249208,Benign
172.30.1.136,50497,157.240.16.39,443,27,6359,9,1596,18,4763,964.301583,146.434926,87.19231367,260.2111466,Benign
172.30.15.2164,51476,162.125.82.3,443,6,348,4,228,2,120,4235.097933,0.272391,6696.256484,3524.345518,Benign
192.168.43.224,50874,23.251.156.28,443,11,730,6,404,5,326,1808.771237,152.022344,21.26003267,17.1553729,Benign
172.30.1.136,51852,74.125.200.188,5228,23,3033,12,1973,11,1060,3855.525176,9.136375,1727.599841,928.1580496,Benign
192.168.43.233,51229,204.79.197.213,443,39,15685,20,4870,19,10815,1629.156632,3.354438,11614.46418,25792.69612,Benign
172.30.6.255,57614,52.229.174.233,443,30,10338,17,2291,13,8047,3408.568983,102.032823,179.6284711,630.934224,Benign
172.30.6.255,56580,204.79.197.200,443,236,190513,93,6855,143,183658,896.45214,61.210934,895.9183665,24003.29327,Benign
192.168.43.224,36336,52.20.136.189,443,17,1874,10,1220,7,654,2852.677062,30.39515536,321.1038037,172.1326947,Benign
172.30.15.2371,51705,14.139.45.128,80,10,1382,5,656,5,726,5334.54515,0.144865,36226.83188,40092.49991,Benign
172.30.6.255,58500,157.240.16.39,443,19,1933,10,1125,9,808,5730.090379,61.048455,147.4238783,105.8831055,Benign
172.30.6.255,57218,103.243.221.17,80,47,30018,27,25709,20,4309,2138.868824,19.196797,10713.87065,1795.716233,Benign
10.0.2.15,35756,119.254.87.201,80,11,1582,6,705,5,877,15954.72101,2.225953,2533.74622,3151.908419,Malicious
172.30.6.255,57972,131.253.61.102,443,69,28655,26,7469,43,21186,4686.868944,65.89229,906.813225,2572.197749,Benign
10.0.2.15,48493,119.254.87.201,80,11,1560,6,705,5,855,398.511614,2.555123,2207.330136,2676.974846,Malicious
10.0.2.15,45591,119.254.87.201,80,11,1582,6,705,5,877,12655.88586,1.845195,3056.587515,3802.308157,Malicious
172.30.1.136,51767,52.230.84.217,443,50,12468,27,6260,23,6208,2954.341397,569.290118,87.96920659,87.23847197,Benign
172.30.15.943,50249,161.170.232.82,80,7,398,4,228,3,170,3441.188719,6.075529,300.2207709,223.8488204,Benign
172.30.6.255,57495,103.243.221.109,80,17,5580,9,4299,8,1281,3057.851141,15.178379,2265.854608,675.1709125,Benign
192.168.43.224,41950,23.251.156.28,443,269,208754,111,12522,158,196232,1053.980085,114.1041465,877.9347908,13758.09774,Benign
192.168.43.224,53746,52.84.110.220,443,625,505170,268,20850,357,484320,2921.251393,183.4963003,909.0101529,21115.19411,Benign
172.30.15.583,49868,14.139.45.149,80,29,18806,12,1055,17,17751,2298.604306,0.293567,28749.82542,483732.8446,Benign
172.30.6.255,57455,54.194.27.245,443,45,13283,26,11001,19,2282,2891.655972,157.52918,558.6774463,115.8896403,Benign
172.30.6.255,57660,103.243.221.46,80,27,17449,11,4606,16,12843,3556.838164,15.214351,2421.92388,6753.097782,Benign
172.30.6.255,57991,103.243.221.75,80,69,50401,44,43389,25,7012,4696.86788,25.237678,13753.72172,2222.708444,Benign
192.168.43.233,51700,157.240.16.39,443,72,11939,37,7474,35,4465,1794.976728,161.601845,369.9957757,221.0370804,Benign
172.30.6.255,55824,204.11.109.67,80,23,3159,12,1650,11,1509,91.006572,303.092043,43.55112681,39.82948507,Benign
172.30.6.255,56490,103.243.221.17,80,19,9620,9,4225,10,5395,817.860988,11.196519,3018.795395,3854.769505,Benign
10.0.2.15,53715,119.254.87.201,80,11,1579,6,705,5,874,15714.43355,2.02383,2786.795334,3454.835633,Malicious
172.30.15.1889,51201,52.26.114.97,443,141,109635,63,4922,78,104713,3971.232658,5.490779,7171.295731,152565.6013,Benign
192.168.43.224,60588,144.2.1.5,443,42,10212,20,4789,22,5423,110.6278461,118.6276971,322.9599911,365.7156048,Benign
172.30.6.255,58347,52.213.19.114,443,7,402,5,282,2,120,5420.864334,8.842499,255.1314962,108.5665941,Benign
172.30.6.255,57269,103.243.220.231,80,8,448,5,282,3,166,2271.090783,17.98052,125.4691188,73.85770823,Benign
172.30.1.136,50384,157.240.16.39,443,90,33758,45,16178,45,17580,695.496038,103.906254,1245.584313,1353.527767,Benign
192.168.43.224,33446,18.211.245.141,443,33,6801,17,2164,16,4637,390.1233425,61.77377779,280.2483613,600.5137022,Benign
192.168.137.97,42074,54.76.174.157,443,6,412,4,272,2,140,3707.275971,14.60398972,149.0003787,76.69137141,Benign
172.30.6.255,56341,103.243.221.17,80,48,36629,31,32471,17,4158,605.841525,26.490716,9806.001469,1255.685199,Benign
10.0.2.15,42877,119.254.87.201,80,11,1582,6,705,5,877,10884.24177,3.384377,1666.48101,2073.0551,Malicious
172.30.6.255,56972,115.114.126.213,443,16,6868,9,1153,7,5715,1435.996882,18.258003,505.2031156,2504.107377,Benign
192.168.43.224,50894,23.251.156.28,443,12,1528,7,1038,5,490,2344.670789,17.43508583,476.2809934,224.833995,Benign
172.30.15.670,49957,172.217.166.193,443,18,7833,9,1273,9,6560,2397.282215,8.821008,1154.516581,5949.433443,Benign
10.0.2.15,50933,119.254.87.201,80,11,1582,6,705,5,877,11509.90384,1.639654,3439.750094,4278.951535,Malicious
10.0.2.15,45295,119.254.87.201,80,11,1582,6,705,5,877,22924.93307,1.084298,5201.522091,6470.54592,Malicious
172.30.1.136,50322,104.244.46.103,443,29,11235,16,2486,13,8749,568.128904,40.661735,489.1084948,1721.3235,Benign
172.30.15.1295,50603,210.176.156.62,80,14,4104,9,3822,5,282,3471.140254,120.893749,252.9163026,18.66101447,Benign
172.30.15.2241,51558,184.29.25.145,443,80,59956,31,8263,49,51693,4467.820517,9.838751,6718.738994,42032.16445,Benign
172.30.6.255,55759,195.201.82.80,80,355,379499,89,17610,266,361889,61.576043,40.473756,3480.77406,71530.59874,Benign
192.168.43.233,51209,52.216.228.96,80,11,618,6,336,5,282,1154.594914,61.93974,43.39701781,36.42249709,Benign
172.30.6.255,56888,184.29.26.182,80,130,93127,63,5394,67,87733,1385.017944,112.841781,382.4115467,6219.894739,Benign
192.168.137.97,44978,104.17.162.9,443,18,5993,10,1153,8,4840,6.394910449,10.2540112,899.550412,3776.083256,Benign
10.0.2.15,56715,119.254.87.201,80,11,1582,6,705,5,877,24516.79329,1.095751,5147.154782,6402.914531,Malicious
10.0.2.15,45114,119.254.87.201,80,11,1579,6,705,5,874,761.355988,1.553104,3631.437431,4501.95222,Malicious
192.168.137.97,45608,104.197.3.80,80,10,911,5,425,5,486,762.8321268,0.781145726,4352.580942,4977.304324,Benign
192.168.43.233,51159,172.217.160.238,443,19,5812,9,1285,10,4527,480.460762,21.013264,489.2148121,1723.482844,Benign
172.30.6.255,55860,152.163.13.4,443,30,7826,15,2652,15,5174,104.860253,303.219507,69.96911317,136.5083678,Benign
10.0.2.15,37688,119.254.87.201,80,11,1544,6,705,5,839,24879.82989,2.152471,2620.244361,3118.276623,Malicious
192.168.43.224,47274,54.236.156.42,443,48,11000,24,3504,24,7496,18.29605937,79.52163126,352.5078593,754.1092788,Benign
192.168.43.233,51047,162.212.45.11,80,11,1065,6,642,5,423,887.868983,3.366863,1525.455595,1005.089901,Benign
172.30.15.229,49498,52.114.76.37,443,17,7345,9,2705,8,4640,48.741438,1.518804,14248.05307,24440.28328,Benign
10.0.2.15,50523,119.254.87.201,80,11,1582,6,705,5,877,10158.56395,1.29949,4340.164218,5399.041162,Malicious
10.0.2.15,34445,119.254.87.201,80,11,1513,6,705,5,808,20855.28957,1.311079,4301.800273,4930.290242,Malicious
192.168.43.224,37994,104.16.123.127,443,286,124825,149,57606,137,67219,149.4125979,462.1995483,997.0758337,1163.462842,Benign
192.168.137.97,44924,103.102.166.224,443,25,6536,14,1550,11,4986,32.137236,18.30541165,677.3953102,2179.027753,Benign
172.30.15.1588,50897,162.247.242.19,443,29,9567,14,5404,15,4163,3571.72932,5.517315,7835.695442,6036.269454,Benign
10.0.2.15,41754,119.254.87.201,80,13,1727,8,853,5,874,20669.51098,10.466626,651.9770555,668.0280732,Malicious
172.30.6.255,57158,103.243.221.75,80,70,47895,42,39926,28,7969,1941.893777,20.134542,15863.68342,3166.299983,Benign
10.0.2.15,56189,119.254.87.201,80,11,1582,6,705,5,877,16377.31697,2.8178,2001.561502,2489.885726,Malicious
192.168.215.49,52346,158.85.224.179,443,30,8122,15,3170,15,4952,1677.761287,1.329620295,19073.1144,29794.97241,Benign
172.30.6.255,56355,54.72.26.137,80,12,1638,7,806,5,832,607.828443,69.256779,93.10279937,96.10611548,Benign
192.168.137.97,50612,192.168.121.7,443,27,9648,13,2644,14,7004,2904.35973,7.392936006,2861.109576,7579.126879,Benign
172.30.1.136,50684,151.139.105.14,443,17,1038,9,546,8,492,1806.045903,20.610793,211.9277992,190.967907,Benign
172.30.6.255,57266,103.243.220.231,80,26,13848,12,5383,14,8465,2270.842126,15.623068,2756.436828,4334.615967,Benign
192.168.137.97,34226,172.217.161.3,443,69,18598,33,10890,36,7708,69.55661035,107.6573438,809.2341585,572.7802474,Benign
192.168.43.233,51003,104.244.42.200,443,8,456,4,228,4,228,527.398834,21.957495,83.06958512,83.06958512,Benign
172.30.6.255,56661,157.240.16.39,443,26,5399,15,3398,11,2001,1094.088796,61.445629,442.4073843,260.5230064,Benign
10.0.2.15,33471,119.254.87.201,80,11,1579,6,705,5,874,4817.606669,1.313789,4292.926794,5322.011373,Malicious
172.30.15.1986,51298,52.52.93.212,443,6,348,4,228,2,120,4077.035844,5.532061,329.7143687,173.5338782,Benign
10.0.2.15,46379,119.254.87.201,80,11,1579,6,705,5,874,25270.11862,1.354747,4163.138948,5161.111263,Malicious
10.0.2.15,54225,119.254.87.201,80,11,1579,6,705,5,874,3224.023033,1.409741,4000.734887,4959.776299,Malicious
172.30.6.255,56137,172.217.166.206,443,17,1779,10,1150,7,629,366.407989,64.043857,143.6515605,78.57115789,Benign
10.0.2.15,41360,119.254.87.201,80,11,1513,6,705,5,808,22681.8737,1.181087,4775.26211,5472.924518,Malicious
172.30.15.1928,51240,34.201.201.2,443,16,4819,9,1153,7,3666,3991.666642,5.532969,1667.097719,5300.589973,Benign
172.30.6.255,56729,157.240.16.39,443,5,330,1,66,4,264,1216.097131,15.083252,35.00571362,140.0228545,Benign
10.0.2.15,54792,119.254.87.201,80,11,1579,6,705,5,874,5263.752735,1.955955,2883.501921,3574.724367,Malicious
192.168.43.224,53574,151.101.1.69,443,248,144669,116,10541,132,134128,1898.23317,620.9028964,135.8151178,1728.167168,Benign
192.168.43.224,32876,172.217.166.195,443,188,160263,69,5729,119,154534,12.90242388,2.46968308,18557.8467,500579.2079,Benign
192.168.43.233,51159,103.243.221.75,443,19,4307,10,2149,9,2158,951.151605,57.524052,298.8662899,300.1179402,Benign
172.30.15.240,49509,23.198.126.238,443,17,6384,8,1319,9,5065,53.221387,0.667228,15814.68404,60728.86629,Benign
192.168.137.97,53448,52.206.154.207,443,11,742,6,416,5,326,6795.052,104.1043306,31.96793044,25.05179165,Benign
172.30.1.136,50237,172.217.161.14,443,49,10981,24,8250,25,2731,433.120893,197.883406,333.5297352,110.4084493,Benign
172.30.15.1430,50738,103.231.98.48,443,7,402,4,228,3,174,3500.772252,6.298087,289.6117504,221.0194937,Benign
10.0.2.15,33127,119.254.87.201,80,11,1513,6,705,5,808,25925.57231,1.298121,4344.741361,4979.504992,Malicious
10.0.2.15,60252,119.254.87.201,80,11,1582,6,705,5,877,7065.421911,0.827317,6817.217584,8480.425278,Malicious
192.168.137.97,58230,173.194.166.151,443,24,6855,14,1550,10,5305,1197.910183,34.15239507,363.0784891,1242.665409,Benign
172.30.6.255,57325,35.190.43.164,80,118,34507,60,25237,58,9270,2467.901258,581.163902,347.3994157,127.6059985,Benign
10.0.2.15,40279,119.254.87.201,80,11,1513,6,705,5,808,17879.09715,6.303105,894.7970881,1025.526308,Malicious
172.30.1.136,50631,52.214.173.82,443,12,696,6,348,6,348,1714.765196,30.976428,89.87479124,89.87479124,Benign
172.30.15.1446,50754,103.231.98.244,443,16,6374,7,1033,9,5341,3501.903119,1.135366,7278.710125,37633.67936,Benign
172.30.6.255,57590,172.217.166.206,443,17,1783,10,1154,7,629,3340.411305,88.067999,104.8280886,57.137667,Benign
192.168.137.97,41110,157.240.16.20,443,11,730,6,404,5,326,2906.747717,18.06305763,178.9287321,144.3830858,Benign
192.168.42.240,50967,172.217.166.234,443,22,1236,12,684,10,552,280.058003,44.934324,121.7777305,98.276765,Benign
192.168.43.233,51283,52.175.18.194,443,36,12279,19,4816,17,7463,2768.616815,10.889742,3538.008522,5482.590864,Benign
192.168.137.97,52484,172.217.163.142,443,65,17031,33,8993,32,8038,18.93415355,157.5230493,456.720463,408.2196243,Benign
172.30.15.1091,50397,50.7.74.138,80,6,348,4,228,2,120,3453.06534,4.41922,412.7425202,217.2329054,Benign
172.30.15.2438,51772,14.139.45.128,80,17,8741,7,777,10,7964,5418.725054,0.327193,18997.96145,194722.9922,Benign
192.168.137.97,52308,172.217.161.3,443,11,766,7,486,4,280,10888.3824,33.3501994,116.5810121,67.16601521,Benign
172.30.15.1394,50702,52.33.0.53,443,6,348,4,228,2,120,3497.933785,9.323127,195.6425135,102.9697439,Benign
172.30.15.498,49777,23.9.250.106,443,19,3971,10,2372,9,1599,1866.532526,9.237416,2054.254133,1384.80285,Benign
172.30.6.255,56955,184.29.26.182,443,32,7685,17,3241,15,4444,1390.043145,305.776168,84.79405105,116.268054,Benign
172.30.15.879,50185,205.185.216.42,80,6,348,4,228,2,120,3436.938528,10.273882,177.5375656,93.44082402,Benign
172.30.15.1669,50980,103.254.155.35,443,6,348,4,228,2,120,3591.394056,6.059894,300.9953639,158.4186126,Benign
172.30.6.255,55651,151.139.104.15,80,33,25316,10,1282,23,24034,36.877335,8.935019,1147.84311,21518.92458,Benign
192.168.137.97,51748,172.217.161.3,443,16,2049,11,1563,5,486,3759.744871,106.8689829,117.0030786,36.38099563,Benign
192.168.137.97,60874,52.84.110.140,443,38,8041,19,2532,19,5509,10.41803329,180.5975233,112.1610066,244.0343544,Benign
192.168.137.97,39718,35.171.73.174,443,11,730,6,404,5,326,5674.738321,151.1687236,21.38008394,17.25224595,Benign
192.168.43.224,34322,172.217.166.206,443,10,700,7,494,3,206,1401.125046,24.71074032,159.9304573,66.69164819,Benign
10.0.2.15,36903,119.254.87.201,80,11,1582,6,705,5,877,14545.46238,7.511143,750.884386,934.0788745,Malicious
172.30.15.1859,51171,35.161.208.104,443,15,2805,8,1989,7,816,3908.742515,8.768903,1814.59414,744.448878,Benign
192.168.137.97,49084,52.84.109.5,443,258,148327,135,20422,123,127905,3705.730748,88.23312984,1851.640085,11597.00446,Benign
192.168.43.233,50693,151.101.152.188,443,14,8982,5,799,9,8183,1837.370612,0.629139,10159.91697,104053.3173,Benign
192.168.43.224,33944,52.84.108.93,443,27,7835,15,1775,12,6060,2850.768582,31.78620995,446.7346067,1525.189699,Benign
172.30.6.255,55710,54.194.27.245,443,6,348,4,228,2,120,54.189313,4.56213,399.8132451,210.4280238,Benign
172.30.6.255,58310,103.243.221.51,80,14,5437,9,4317,5,1120,5353.882145,5.28158,6538.952359,1696.462044,Benign
10.0.2.15,46861,119.254.87.201,80,11,1582,6,705,5,877,14938.68495,1.282564,4397.441375,5470.292321,Malicious
192.168.43.224,44520,35.176.197.116,443,35,12097,19,4487,16,7610,1904.688866,153.3663967,234.0538787,396.957882,Benign
172.30.15.1734,51045,162.247.242.19,443,7,398,4,228,3,170,3623.978352,3.311217,550.854867,410.7251201,Benign
172.30.15.1646,50956,184.29.25.7,443,15,2114,8,1529,7,585,3577.210981,10.288368,1188.915482,454.8826403,Benign
172.30.6.255,56254,151.101.128.166,80,21,2987,12,1658,9,1329,529.951931,300.722411,44.10712177,35.35486419,Benign
172.30.6.255,58159,176.34.147.227,443,28,9147,15,3538,13,5609,4958.529827,132.302036,213.9347274,339.1633368,Benign
192.168.43.224,58588,174.129.238.218,443,140,68714,79,34236,61,34478,1804.065754,335.4274446,816.5342592,822.3059992,Benign
172.30.1.136,51538,172.217.161.3,443,2,132,2,132,0,0,695.514811,8.999935,117.3341807,0,Benign
172.30.1.136,51840,172.217.160.227,443,9,535,5,295,4,240,3398.328751,56.307855,41.91244721,34.09826213,Benign
192.168.43.224,37908,103.37.200.180,80,7,486,5,346,2,140,2493.238394,17.30316428,159.9707403,64.72804523,Benign
10.0.2.15,40835,119.254.87.201,80,11,1593,6,705,5,888,9587.852092,2.02015,2791.871891,3516.570552,Malicious
192.168.137.97,57798,104.197.3.80,80,12,1055,6,503,6,552,12023.81266,1.492876804,2695.466893,2958.047166,Benign
10.0.2.15,44740,119.254.87.201,80,11,1582,6,705,5,877,25087.51882,1.356368,4158.163566,5172.637514,Malicious
172.30.15.281,49544,172.217.194.189,443,15,5206,8,1219,7,3987,328.022858,6.696263,1456.334675,4763.253773,Benign
172.30.15.1094,50400,217.182.138.56,80,6,396,1,66,5,330,3453.472772,15.185949,34.76898283,173.8449141,Benign
192.168.43.224,41760,157.240.16.36,443,91,22750,52,10264,39,12486,59.7495387,94.44054422,869.457082,1057.681326,Benign
192.168.43.224,41528,172.217.166.193,443,19,6033,10,1278,9,4755,29.29133538,11.2848586,905.9927432,3370.888493,Benign
172.30.6.255,57624,103.231.98.53,80,14,5617,8,5045,6,572,3431.943056,0.381522,105786.8223,11994.06587,Benign
192.168.43.233,51645,172.217.166.206,443,127,28767,60,14487,67,14280,851.606863,308.336284,375.8753219,370.5045625,Benign
10.0.2.15,52895,119.254.87.201,80,11,1513,6,705,5,808,3852.356111,1.29405,4358.409644,4995.170202,Malicious
172.30.6.255,57767,161.69.36.37,80,7,398,4,228,3,170,3967.304272,0.679883,2682.814543,2000.344177,Benign
10.0.2.15,53437,119.254.87.201,80,11,1579,6,705,5,874,19290.69966,2.283004,2470.429312,3062.631515,Malicious
192.168.43.224,45538,104.237.191.1,443,36,11266,18,2981,18,8285,2144.147899,4.72640082,5045.699869,14023.35573,Benign
10.0.2.15,53420,119.254.87.201,80,11,1579,6,705,5,874,21606.19632,1.753755,3215.956619,3986.873879,Malicious
172.30.15.655,49942,172.217.166.193,80,47,29257,24,2924,23,26333,2396.043236,10.131333,2308.876828,20793.31515,Benign
172.30.6.255,55928,157.240.16.39,443,35,8390,18,5795,17,2595,126.856123,65.22198,710.8033212,318.2976046,Benign
192.168.137.97,37982,144.76.137.80,443,748,691595,273,19204,475,672391,38.12183059,5.33970823,28771.60949,1007382.383,Benign
172.30.15.304,49567,131.247.120.10,443,24,8973,10,1599,14,7374,670.256498,4.892639,2614.539924,12057.29669,Benign
192.168.43.233,51457,49.44.178.216,80,13,3742,8,3168,5,574,3812.419312,6.073337,4172.994188,756.0917499,Benign
10.0.2.15,53022,119.254.87.201,80,11,1579,6,705,5,874,22171.2821,1.485948,3795.556776,4705.413648,Malicious
172.30.15.2327,51660,52.55.184.84,443,17,4594,9,2437,8,2157,5081.413743,6.640825,2935.779817,2598.472328,Benign
172.30.6.255,58543,210.176.156.21,80,14,5524,8,3970,6,1554,5813.854197,3.459158,9181.425075,3593.938178,Benign
192.168.215.49,46406,223.31.160.67,443,59,32784,27,4148,32,28636,310.2623037,24.74474637,1341.052339,9258.045992,Benign
192.168.43.233,51483,31.13.79.26,443,52,20622,25,3529,27,17093,3818.166374,69.713669,404.9707956,1961.509155,Benign
172.30.15.1651,50962,103.254.155.35,443,30,12639,15,4547,15,8092,3579.124107,8.375457,4343.165991,7729.249879,Benign
172.30.1.136,50632,157.240.16.17,443,367,262954,164,13035,203,249919,1724.734897,182.763539,570.5733243,10939.55617,Benign
172.30.15.1966,51278,52.207.90.113,443,16,4806,8,1099,8,3707,4076.366044,1.088169,8079.627337,27253.11969,Benign
10.0.2.15,59572,119.254.87.201,80,11,1579,6,705,5,874,5296.111063,1.845452,3056.161851,3788.773699,Malicious
172.30.1.136,50365,52.84.108.177,80,15,858,9,510,6,348,652.723684,37.496197,108.8110349,74.24752969,Benign
10.0.2.15,58498,119.254.87.201,80,11,1579,6,705,5,874,22444.21201,1.423292,3962.644348,4912.554838,Malicious
10.0.2.15,33160,119.254.87.201,80,11,1582,6,705,5,877,853.334765,2.357553,2392.311011,2975.96703,Malicious
172.30.6.255,55692,172.217.166.195,443,15,5573,7,1165,8,4408,46.098146,0.225295,41367.9842,156523.669,Benign
172.30.15.2517,51851,151.139.104.1,443,6,348,4,228,2,120,5487.595511,10.393579,175.4929654,92.36471864,Benign
192.168.137.97,47128,157.240.16.20,443,1215,1093681,449,31511,766,1062170,133.4866744,81.98778348,3074.701978,103641.7822,Benign
172.30.6.255,56528,23.198.119.247,443,21,9397,11,1312,10,8085,831.969349,41.616349,252.2085731,1554.196885,Benign
10.0.2.15,39583,119.254.87.201,80,11,1559,6,705,5,854,24847.25759,0.817058,6902.814733,8361.707492,Malicious
192.168.215.49,39486,151.101.2.2,443,126,49429,61,7328,65,42101,1251.079534,645.9971611,90.74962482,521.3769043,Benign
172.30.15.1213,50521,217.156.250.128,80,6,348,4,228,2,120,3466.790184,10.831528,168.3972935,88.63015449,Benign
192.168.215.28,62352,157.240.16.11,443,4,408,0,0,4,408,301.1560335,360.9359236,0,9.043156379,Benign
172.30.1.136,50392,172.217.161.14,443,3,198,3,198,0,0,753.967332,8.999378,176.0121644,0,Benign
192.168.42.240,50960,216.58.221.67,443,45,11984,21,4596,24,7388,226.822324,241.147137,152.4712276,245.0951761,Benign
172.30.6.255,56306,103.243.221.46,80,30,14549,16,9376,14,5173,588.856728,17.182387,4365.400453,2408.512857,Benign
172.30.15.200,49418,172.217.194.188,443,82,4986,41,2285,41,2701,0.159567,1724.011565,10.60317713,12.53355861,Benign
172.30.6.255,56926,54.149.58.94,80,6,348,4,228,2,120,1386.864978,17.798165,102.482475,53.93814475,Benign
192.168.215.49,59172,223.31.160.61,443,440,371626,179,17381,261,354245,279.7381494,13.12951756,10590.48814,215846.4686,Benign
172.30.6.255,57566,210.176.156.62,80,95,58460,49,42583,46,15877,3254.84782,248.42341,1371.303936,511.2883685,Benign
192.168.137.97,56534,23.57.201.101,443,8,552,5,338,3,214,80.87449331,15.77481363,171.4124848,108.5274312,Benign
10.0.2.15,34418,119.254.87.201,80,12,1653,7,779,5,874,20525.13198,7.751248,803.9995624,902.0482895,Malicious
172.30.15.2012,51324,104.113.220.53,443,26,9417,13,1864,13,7553,4088.240413,9.319929,1600.012189,6483.311193,Benign
10.0.2.15,54999,119.254.87.201,80,11,1579,6,705,5,874,5208.061091,1.222289,4614.293346,5720.41473,Malicious
172.30.15.1058,50364,172.217.160.226,80,14,3810,8,1766,6,2044,3448.985342,8.163441,1730.642752,2003.076889,Benign
172.30.6.255,57225,103.243.220.231,80,29,14751,14,8233,15,6518,2157.852848,41.482101,1587.769144,1257.024084,Benign
172.30.1.136,50680,52.16.255.206,443,10,588,6,348,4,240,1805.188254,22.43996,124.0643923,85.56164984,Benign
192.168.137.97,36296,52.84.103.186,443,8,552,5,338,3,214,3709.00458,12.44615649,217.2558253,137.5525048,Benign
192.168.43.224,55176,52.35.44.197,443,26,7965,14,2068,12,5897,94.23887944,15.02237276,1101.290739,3140.382731,Benign
172.30.6.255,57848,103.243.221.109,80,7,406,5,294,2,112,4223.861677,14.195914,165.6814771,63.11675317,Benign
10.0.2.15,37588,119.254.87.201,80,11,1582,6,705,5,877,11269.63156,1.909474,2953.693007,3674.310307,Malicious
192.168.137.97,60482,104.113.242.64,443,14,980,8,536,6,444,22.48944713,17.23756879,248.7589783,206.0615417,Benign
172.30.6.255,55672,172.217.166.202,80,242,261149,57,3925,185,257224,40.638106,17.971651,1747.196181,114502.1122,Benign
192.168.137.97,56446,172.217.161.5,443,45,8410,22,2899,23,5511,1048.098788,240.5165621,96.42579202,183.3054639,Benign
192.168.43.224,58154,162.213.83.13,443,6,412,4,272,2,140,93.67309619,13.21130454,164.7074286,84.77588239,Benign
192.168.43.233,51297,23.9.140.60,80,20,6750,11,5940,9,810,2825.580979,22.307414,2130.233473,290.4863827,Benign
172.30.15.1538,50846,85.159.213.174,443,40,14974,20,2593,20,12381,3531.396277,5.724533,3623.701706,17302.37209,Benign
172.30.15.2218,51533,104.121.244.70,443,447,385248,185,18802,262,366446,4442.214829,15.605891,9638.411546,187850.0881,Benign
192.168.43.224,50890,104.16.118.145,443,24,7058,13,1344,11,5714,152.1315564,1.080878344,9947.465466,42291.53101,Benign
172.30.1.136,50577,172.217.161.14,443,21,1206,11,630,10,576,1586.107953,28.556085,176.4947821,161.3666579,Benign
192.168.43.233,51281,23.9.140.60,80,16,4046,9,3344,7,702,2761.943758,6.665163,4013.705291,842.5900462,Benign
172.30.15.2086,51398,52.86.72.168,443,7,394,4,228,3,166,4123.58725,4.011732,454.6664633,331.0290917,Benign
192.168.137.97,50960,104.237.191.1,443,50,6403,26,4535,24,1868,9500.181481,77.84444531,466.0576597,191.9725928,Benign
192.168.43.233,51685,54.255.158.169,443,26,2894,13,1852,13,1042,894.911482,125.823063,117.7526572,66.25176499,Benign
192.168.137.97,54064,140.98.193.112,443,58,36649,30,7941,28,28708,15.79060061,13.12395692,4840.613268,17499.60026,Benign
192.168.43.224,35044,34.232.42.95,443,175,124206,87,12255,88,111951,3027.629007,16.54334918,5926.248604,54137.04264,Benign
172.30.15.524,49807,162.247.242.19,443,22,6145,10,2355,12,3790,2210.195565,6.169296,3053.833047,4914.661251,Benign
172.30.6.255,57302,103.243.221.51,80,17,5532,9,4243,8,1289,2403.097535,20.935289,1621.377188,492.5654477,Benign
10.0.2.15,33868,119.254.87.201,80,11,1582,6,705,5,877,1061.609765,1.84916,3050.033529,3794.155184,Malicious
172.30.15.813,50108,172.30.24.126,7680,3,198,3,198,0,0,2896.144392,8.21049,192.9239302,0,Benign
172.30.6.255,55934,217.12.15.54,443,21,8156,11,1844,10,6312,152.295529,21.222444,695.1131547,2379.367805,Benign
10.0.2.15,53001,119.254.87.201,80,11,1579,6,705,5,874,12560.85588,2.341837,2408.36574,2985.690294,Malicious
172.30.6.255,56707,157.240.16.16,443,47,12800,23,3531,24,9269,1169.39426,117.025416,241.3834615,633.6401316,Benign
172.30.15.2139,51451,184.29.26.86,443,16,5516,10,1219,6,4297,4178.604278,8.744409,1115.226884,3931.197637,Benign
192.168.215.49,56090,104.197.3.80,80,10,911,5,425,5,486,1762.82303,0.774650323,4389.077109,5019.038764,Benign
172.30.6.255,57477,103.243.221.109,80,71,48311,42,40281,29,8030,3005.835945,36.193487,8903.480342,1774.904971,Benign
172.30.6.255,58016,103.243.221.51,80,29,15435,16,8388,13,7047,4761.88279,12.164663,5516.305713,4634.407053,Benign
172.30.6.255,56737,103.243.221.75,80,6,340,4,228,2,112,1223.133434,20.046343,90.98916446,44.69643166,Benign
192.168.215.249,42184,157.240.16.53,5222,15,1504,0,0,15,1504,859.594788,651.2070383,0,18.47645878,Benign
10.0.2.15,33152,119.254.87.201,80,11,1582,6,705,5,877,3612.152833,1.881892,2996.983886,3728.162934,Malicious
172.30.6.255,57868,172.217.166.206,443,49,8903,26,5671,23,3232,4241.406378,108.806266,416.9612805,237.6333731,Benign
172.30.6.255,57245,103.243.221.87,80,77,57516,47,49439,30,8077,2225.84152,26.386432,14989.2187,2448.83431,Benign
172.30.6.255,58567,103.243.221.46,80,3,186,2,120,1,66,5879.852231,1.22899,781.1292199,429.621071,Benign
10.0.2.15,45310,119.254.87.201,80,11,1582,6,705,5,877,791.357287,1.153491,4889.50499,6082.405498,Malicious
192.168.43.224,36098,107.21.25.13,443,16,4978,9,1245,7,3733,55.81181885,12.41132879,802.4926398,2406.188775,Benign
192.168.43.224,59524,49.44.150.71,443,53,14264,29,8365,24,5899,53.6337291,463.9916394,144.2267367,101.7087292,Benign
192.168.43.224,50760,104.197.3.80,80,10,911,5,425,5,486,1114.562074,1.805701568,1882.924654,2153.179722,Benign
192.168.215.28,62299,192.12.31.88,5228,8,528,0,0,8,528,1408.917032,57.30657029,0,73.70882568,Benign
10.0.2.15,36221,119.254.87.201,80,11,1582,6,705,5,877,6617.334779,1.34965,4178.861186,5198.384766,Malicious
192.168.43.233,51256,163.53.78.128,443,365,291501,145,45421,220,246080,1939.848715,75.398394,4819.306894,26109.83995,Benign
172.30.6.255,57801,35.190.43.164,80,162,50147,83,37245,79,12902,4041.966937,731.930234,407.0879794,141.0189048,Benign
172.30.6.255,58524,157.240.16.17,443,351,287067,150,10836,201,276231,5781.034607,8.064663,10749.11624,274016.1616,Benign
192.168.137.97,56310,172.217.161.14,443,9,618,5,338,4,280,357.2749518,17.11927916,157.9505758,130.8466308,Benign
10.0.2.15,38906,119.254.87.201,80,11,1579,6,705,5,874,26198.83282,0.892959,6316.079462,7830.146737,Malicious
172.30.6.255,57146,103.243.221.75,80,47,30072,27,24970,20,5102,1876.839434,45.204633,4419.016077,902.9163006,Benign
10.0.2.15,38989,119.254.87.201,80,11,1582,6,705,5,877,10073.18711,1.052376,5359.301238,6666.818704,Malicious
172.30.15.354,49622,23.56.26.202,80,12,2412,7,620,5,1792,1293.984411,60.52824,81.94522094,236.8481225,Benign
172.30.6.255,56340,52.109.120.4,443,24,9399,15,2554,9,6845,604.034926,132.047343,154.7323826,414.699749,Benign
192.168.137.97,44928,103.102.166.224,443,12,848,7,486,5,362,32.40073555,20.42670175,190.3390987,141.7752134,Benign
172.30.6.255,57701,103.243.221.87,80,20,10618,10,4552,10,6066,3678.865498,34.18207,1065.353854,1419.691669,Benign
172.30.15.1589,50898,162.247.242.19,443,7,398,4,228,3,170,3571.981065,5.271445,346.0151818,257.9937759,Benign
172.30.6.255,55693,172.217.166.195,443,39,9968,17,3789,22,6179,46.166711,12.464499,2431.866696,3965.823255,Benign
172.30.6.255,57369,103.243.221.17,80,7,403,5,283,2,120,2599.067564,49.980842,45.29735614,19.20735949,Benign
10.0.2.15,41100,119.254.87.201,80,11,1582,6,705,5,877,9893.092789,2.237493,2520.678277,3135.652268,Malicious
10.0.2.15,58328,119.254.87.201,80,11,1513,6,705,5,808,21302.79206,1.961997,2874.622132,3294.602387,Malicious
192.168.43.233,51290,74.207.230.33,443,38,18699,17,2118,21,16581,2491.955029,99.83471,169.7205311,1328.676169,Benign
172.30.1.136,50602,157.240.16.35,443,25,1434,14,804,11,630,1604.743492,61.834683,104.0192929,81.50765485,Benign
192.168.43.233,51313,117.18.232.102,443,541,363284,212,14406,329,348878,2596.691963,199.903963,576.5168347,13961.82426,Benign
10.0.2.15,36404,119.254.87.201,80,11,1582,6,705,5,877,12410.72681,1.61742,3487.034907,4337.772502,Malicious
172.30.6.255,56345,103.243.221.17,80,7,402,5,282,2,120,606.888525,25.727165,87.68941312,37.31464388,Benign
172.30.6.255,56756,23.198.126.238,443,17,6649,8,1327,9,5322,1244.684017,0.769575,13794.6269,55324.04249,Benign
172.30.15.2415,51749,14.139.45.128,80,257,221694,104,6531,153,215163,5347.245003,4.841387,10791.94867,355539.4353,Benign
10.0.2.15,49047,119.254.87.201,80,11,1582,6,705,5,877,25027.48833,7.863616,717.2272909,892.2104029,Malicious
192.168.43.233,50948,54.77.120.226,443,101,22596,51,7769,50,14827,461.641035,207.990573,298.8212355,570.2950777,Benign
172.30.15.798,50090,52.84.108.164,443,40,24948,18,3318,22,21630,2679.553044,6.672914,3977.872336,25931.6994,Benign
172.30.6.255,56757,23.198.126.238,443,17,6647,8,1327,9,5320,1244.683714,0.774903,13699.7792,54923.00327,Benign
172.30.6.255,55771,195.201.82.80,80,131,126200,39,6201,92,119999,62.533189,36.362459,1364.264171,26400.63479,Benign
172.30.6.255,56682,157.240.16.39,443,15,1686,9,1071,6,615,1155.47707,60.690802,141.174605,81.06664993,Benign
172.30.6.255,57598,103.243.221.17,80,20,10313,10,4270,10,6043,3359.838844,16.197746,2108.935404,2984.612797,Benign
192.168.43.233,51259,172.82.241.224,443,8,456,4,228,4,228,1946.207676,25.385707,71.85145562,71.85145562,Benign
172.30.1.136,50136,104.17.162.9,443,7,402,4,228,3,174,113.301284,18.882932,96.59516859,73.7173655,Benign
10.0.2.15,51839,119.254.87.201,80,11,1582,6,705,5,877,23162.42196,2.317918,2433.218086,3026.854272,Malicious
172.30.6.255,56084,103.243.221.46,80,15,4481,9,3358,6,1123,305.089621,19.772249,1358.671945,454.374209,Benign
172.30.6.255,57865,103.243.221.109,80,42,27030,20,5824,22,21206,4237.842146,1.082513,43040.59166,156716.8246,Benign
172.30.6.255,57819,103.243.221.46,80,17,5494,9,4204,8,1290,4064.859627,38.197081,880.4861293,270.1777133,Benign
172.30.1.136,51497,172.217.161.3,443,2,109,1,55,1,54,4.268964,0.212543,2070.16933,2032.529888,Benign
172.30.6.255,56256,192.99.18.118,443,6,348,4,228,2,120,530.107627,36.327714,50.20960031,26.42610542,Benign
172.30.6.255,57961,103.243.221.17,80,30,15509,15,8361,15,7148,4629.865476,17.165407,3896.674282,3331.351246,Benign
10.0.2.15,37148,119.254.87.201,80,11,1582,6,705,5,877,8121.094551,1.439,3919.388464,4875.608061,Malicious
172.30.6.255,56109,157.240.16.39,443,148,101894,55,13570,93,88324,306.842488,72.178245,1504.054303,9789.542542,Benign
172.30.6.255,57952,172.217.166.206,443,17,1779,10,1150,7,629,4580.422438,99.778713,92.20403554,50.43159857,Benign
10.0.2.15,38558,119.254.87.201,80,11,1582,6,705,5,877,20759.66125,2.032227,2775.280517,3452.370232,Malicious
10.0.2.15,35510,119.254.87.201,80,11,1582,6,705,5,877,13642.18593,2.027769,2781.381903,3459.960183,Malicious
172.30.6.255,57232,161.69.226.29,443,29,8254,15,4573,14,3681,2183.040473,275.556721,132.7639546,106.8672899,Benign
10.0.2.15,49964,119.254.87.201,80,11,1579,6,705,5,874,8000.969635,0.929142,6070.116301,7525.222194,Malicious
10.0.2.15,56463,119.254.87.201,80,13,1727,8,853,5,874,1423.906993,9.910551,688.5590922,705.5107229,Malicious
172.30.6.255,56072,52.54.208.77,80,6,348,4,228,2,120,286.645189,17.606776,103.596479,54.52446263,Benign
10.0.2.15,44693,119.254.87.201,80,11,1582,6,705,5,877,19978.95848,1.889146,2985.475977,3713.847421,Malicious
172.30.15.507,49789,52.229.168.53,443,30,10177,17,2326,13,7851,2017.979068,102.37407,181.764777,613.5147308,Benign
10.0.2.15,37215,119.254.87.201,80,11,1582,6,705,5,877,21455.9935,3.859063,1461.494669,1818.057907,Malicious
10.0.2.15,58688,119.254.87.201,80,11,1579,6,705,5,874,15956.9957,2.223217,2536.864373,3144.992144,Malicious
172.30.15.1661,50972,184.29.25.7,443,15,1648,8,1063,7,585,3587.496159,9.885067,860.2875428,473.4414041,Benign
172.30.6.255,58502,157.240.16.17,443,677,739824,151,9526,526,730298,5741.206552,7.845642,9713.417971,744666.1471,Benign
172.30.6.255,58076,205.185.216.42,443,82,85808,18,2070,64,83738,4847.865911,0.691124,23960.96793,969296.3925,Benign
192.168.43.233,50883,104.237.191.1,443,7,427,4,241,3,186,66.499881,48.093389,40.08866998,30.93980339,Benign
10.0.2.15,42348,119.254.87.201,80,11,1582,6,705,5,877,23402.61001,4.279917,1317.782564,1639.284126,Malicious
192.168.43.224,55720,18.208.55.232,443,33,8187,17,2678,16,5509,1914.875236,62.04064467,345.3220081,710.3730181,Benign
172.30.6.255,58559,157.240.16.17,443,161,137039,57,4415,104,132624,5831.202656,7.88818,4477.585451,134504.0301,Benign
10.0.2.15,34240,119.254.87.201,80,12,1653,7,779,5,874,9950.911457,4.963279,1255.621536,1408.746113,Malicious
10.0.2.15,60633,119.254.87.201,80,11,1579,6,705,5,874,2655.09769,1.546915,3645.966327,4519.963928,Malicious
192.168.137.97,56108,172.217.161.14,443,22,8435,12,1599,10,6836,281.1471158,23.38775729,546.9528284,2338.317408,Benign
172.30.15.1919,51231,205.185.216.10,443,25,8417,11,1744,14,6673,3985.624088,1.772847,7869.827458,30112.01756,Benign
192.168.137.97,45774,54.251.174.92,443,18,6689,10,1323,8,5366,349.6686728,13.50515549,783.700714,3178.637968,Benign
172.30.6.255,56049,161.170.232.82,80,7,398,4,228,3,170,254.463556,27.658936,65.94613762,49.17036577,Benign
192.168.43.224,38920,54.77.4.53,443,6,412,4,272,2,140,1430.37265,34.87337783,62.39716757,32.11618919,Benign
172.30.6.255,58266,35.190.43.164,80,10,1573,6,1119,4,454,5287.834124,36.158338,247.5777509,100.4470947,Benign
172.30.15.1798,51110,103.254.155.35,443,20,7895,11,2743,9,5152,3653.74902,3.545286,6189.627579,11625.5783,Benign
10.0.2.15,59209,119.254.87.201,80,11,1559,6,705,5,854,19468.35879,2.116132,2665.240165,3228.532058,Malicious
172.30.1.136,50263,172.217.161.5,443,57,9537,29,5992,28,3545,474.257815,159.743078,300.0818602,177.5350792,Benign
172.30.6.255,58315,35.190.43.164,80,10,1573,6,1119,4,454,5353.890755,5.130317,1744.921415,707.9484562,Benign
172.30.15.443,49717,52.84.110.254,443,51,28969,24,5819,27,23150,1632.074528,8.49892,5477.401835,21791.00403,Benign
172.30.6.255,56611,103.243.221.87,80,7,406,5,294,2,112,960.088245,36.963755,63.62989907,24.23996155,Benign
192.168.43.233,51088,162.251.148.163,443,7,402,4,228,3,174,916.432265,12.061242,151.2282068,115.411,Benign
192.168.137.97,57524,192.229.237.96,443,174,104577,86,6730,88,97847,544.9429122,180.7510101,297.8683216,4330.686725,Benign
192.168.43.233,51319,117.18.237.70,443,16,5635,7,1033,9,4602,2957.250409,0.365249,22625.66085,100796.9905,Benign
10.0.2.15,33677,119.254.87.201,80,11,1579,6,705,5,874,1632.154834,1.690229,3336.825957,4136.717569,Malicious
192.168.43.224,46166,157.240.16.16,443,235,25545,118,12037,117,13508,44.21017213,1494.695677,64.42515456,72.29832913,Benign
10.0.2.15,53146,119.254.87.201,80,11,1582,6,705,5,877,25390.21085,11.098523,508.1757275,632.1561887,Malicious
192.168.43.224,38488,140.98.193.112,443,31,15226,16,6960,15,8266,3261.497077,13.91056451,4002.713187,4753.797012,Benign
172.30.1.136,50467,157.240.16.20,443,48,7259,22,2427,26,4832,878.319867,76.507762,253.7781722,505.2559242,Benign
192.168.43.224,51806,54.173.101.22,443,20,5474,11,1515,9,3959,34.04886711,11.06863844,1094.985627,2861.417886,Benign
172.30.15.1442,50750,103.231.98.244,443,8,973,5,799,3,174,3501.501965,0.320041,19972.44103,4349.442728,Benign
10.0.2.15,58501,119.254.87.201,80,11,1593,6,705,5,888,18903.27127,4.712532,1196.808849,1507.46987,Malicious
10.0.2.15,55728,119.254.87.201,80,11,1582,6,705,5,877,18209.49934,2.222423,2537.770712,3156.914773,Malicious
172.30.6.255,56767,23.198.126.238,443,17,6648,8,1326,9,5322,1244.684833,0.776486,13661.54702,54831.63895,Benign
192.168.43.224,33106,54.243.243.77,443,6,412,4,272,2,140,681.1263276,34.19345989,63.63790055,32.75480176,Benign
10.0.2.15,39419,119.254.87.201,80,11,1579,6,705,5,874,969.071097,0.89181,6324.217042,7840.235028,Malicious
172.30.6.255,56222,173.198.245.125,80,6,348,4,228,2,120,469.967223,21.108318,86.41143269,45.47970141,Benign
192.168.215.49,46402,223.31.160.67,443,13,1606,7,1038,6,568,293.0954291,17.19340097,482.9759984,264.2874442,Benign
172.30.15.2205,51517,77.88.21.119,443,11,1342,6,904,5,438,4312.129589,6.387553,1132.201956,548.5668769,Benign
172.30.6.255,56704,172.30.10.168,445,3,198,3,198,0,0,1162.760123,8.955081,176.8828222,0,Benign
172.30.15.1811,51123,161.202.1.35,443,11,1343,6,905,5,438,3743.325984,3.799453,1905.537455,922.2380169,Benign
172.30.15.836,50138,34.232.42.95,443,197,144425,104,137777,93,6648,3214.348247,2.711147,406549.7002,19616.7895,Benign
192.168.43.224,57264,139.59.82.147,443,22,7359,12,1410,10,5949,2571.001828,12.73060821,886.0535033,3738.391696,Benign
172.30.15.1826,51138,52.6.46.142,443,6,348,4,228,2,120,3861.044722,6.280841,290.4069694,152.8457734,Benign
172.30.15.220,49494,52.114.6.46,443,18,8426,10,3786,8,4640,22.14755,0.729226,41534.44885,50903.2865,Benign
172.30.6.255,57294,157.240.16.39,443,19,1933,10,1125,9,808,2375.087973,61.022759,147.4859568,105.9276917,Benign
172.30.6.255,58130,157.240.16.20,443,305,227851,120,9383,185,218468,4906.254852,2.683205,27975.49945,651364.3199,Benign
192.168.43.233,51145,52.29.202.17,443,43,9622,21,2571,22,7051,925.54161,88.92373,231.2993393,634.341362,Benign
192.168.215.49,39072,209.58.138.46,443,6,412,4,272,2,140,605.186112,15.08421471,144.2567639,74.24980494,Benign
172.30.6.255,57188,52.229.174.172,443,27,10001,13,2098,14,7903,2050.958216,126.248143,132.9445297,500.7915245,Benign
172.30.1.136,50614,157.240.16.17,443,10,660,3,198,7,462,1618.365131,34.835549,45.47079192,106.0985145,Benign
10.0.2.15,41080,119.254.87.201,80,3,222,3,222,0,0,21450.47338,9.042089,196.4147887,0,Malicious
172.30.1.136,51892,184.29.24.103,443,34,6478,17,2137,17,4341,4603.000091,102.711853,166.4462231,338.1109286,Benign
192.168.137.97,56176,172.217.161.14,443,19,6017,10,1443,9,4574,342.0768887,13.63413159,846.6985907,2683.852636,Benign
172.30.15.1743,51054,103.254.155.35,443,15,7010,8,1965,7,5045,3632.943174,0.493831,31832.7525,81728.36456,Benign
192.168.137.97,56486,18.208.55.232,443,7,539,3,198,4,341,25.789328,15.2400071,103.9369595,179.0025413,Benign
172.30.15.1809,51121,35.201.87.190,443,27,5173,15,3699,12,1474,3737.360929,9.763164,3030.984628,1207.805175,Benign
172.30.6.255,57362,157.240.16.39,443,19,1933,10,1125,9,808,2558.085077,61.064926,147.3841138,105.8545457,Benign
172.30.6.255,56268,103.243.223.145,443,41,20877,23,7915,18,12962,530.307663,76.123161,831.8099139,1362.213532,Benign
172.30.15.2050,51362,35.172.175.129,443,27,10939,14,2434,13,8505,4093.292808,4.300755,4527.577135,15820.47803,Benign
172.30.6.255,55291,157.240.16.16,443,312,83614,175,33566,137,50048,8.32668,1233.503719,217.6953307,324.5908333,Benign
172.30.15.1795,51107,104.244.42.133,443,11,1376,7,958,4,418,3643.53607,3.455654,2217.814631,967.6894735,Benign
172.30.15.2097,51409,52.7.89.176,443,24,4744,13,3090,11,1654,4144.842329,2.856303,8654.544003,4632.561742,Benign
172.30.1.136,51839,172.217.160.227,443,37,4824,18,2885,19,1939,3398.216494,84.089011,274.4710602,184.4711909,Benign
172.30.6.255,55993,103.243.221.46,80,24,13719,15,11615,9,2104,183.912863,30.120777,3084.913779,558.8169256,Benign
172.30.6.255,56086,50.116.239.135,80,10,1596,6,898,4,698,305.506264,7.508448,956.7889396,743.6956346,Benign
172.30.6.255,56471,52.220.16.13,443,8,469,5,283,3,186,771.472017,46.482706,48.70628659,32.01190568,Benign
172.30.6.255,55830,103.243.221.75,80,6,340,4,228,2,112,91.316421,10.751056,169.6577527,83.34065044,Benign
10.0.2.15,57481,119.254.87.201,80,11,1513,6,705,5,808,6647.359447,1.962181,2874.35257,3294.293442,Malicious
172.30.15.2500,51834,14.139.45.128,80,10,1394,5,669,5,725,5475.722134,0.184528,29003.72843,31431.54426,Benign
10.0.2.15,33050,119.254.87.201,80,12,1653,7,779,5,874,13401.84191,4.879652,1277.140255,1432.889067,Malicious
192.168.43.224,42958,52.84.110.129,443,34,3352,16,1518,18,1834,22.21141643,213.5047289,56.87930221,68.71978936,Benign
172.30.15.2002,51314,13.107.21.200,443,21,10081,10,1174,11,8907,4079.55227,2.695913,3483.791947,26431.12,Benign
10.0.2.15,47207,119.254.87.201,80,11,1582,6,705,5,877,19440.8978,1.351281,4173.817289,5192.110301,Malicious
10.0.2.15,48826,119.254.87.201,80,11,1579,6,705,5,874,12025.26888,1.35154,4173.017447,5173.357799,Malicious
192.168.215.49,60078,192.82.210.131,443,18,6648,10,2259,8,4389,1252.550623,1.52292271,11866.65606,23055.66774,Benign
192.168.43.233,51276,34.225.100.237,443,10,564,5,282,5,282,1990.189913,16.887739,133.5880428,133.5880428,Benign
172.30.15.2390,51724,14.139.45.128,80,41,32811,16,1260,25,31551,5337.606326,2.848537,3538.658617,88609.69684,Benign
10.0.2.15,35488,119.254.87.201,80,11,1582,6,705,5,877,20284.74934,2.042205,2761.720787,3435.502312,Malicious
192.168.43.224,35772,172.217.167.54,443,22,6191,12,2124,10,4067,40.82764716,22.52237257,754.449823,1444.608018,Benign
172.30.15.2381,51715,14.139.45.128,80,11,1432,5,654,6,778,5334.681715,2.339891,2236.001592,2659.952964,Benign
172.30.1.136,50335,172.217.161.3,443,31,3252,14,2126,17,1126,596.09653,19.460973,873.9542468,462.8751091,Benign
172.30.15.722,50009,35.190.14.224,80,13,3033,8,2552,5,481,2409.476531,7.033854,2902.533945,547.0685061,Benign
172.30.6.255,56258,23.56.26.27,80,9,948,5,294,4,654,529.952428,37.404518,62.88010448,139.8761508,Benign
172.30.1.136,50171,52.114.158.52,443,19,7076,10,2383,9,4693,236.093814,1.945063,9801.224947,19302.20255,Benign
10.0.2.15,56054,119.254.87.201,80,11,1561,6,705,5,856,13136.34479,2.078143,2713.961455,3295.249653,Malicious
172.30.15.660,49947,35.190.14.224,80,10,3884,7,2630,3,1254,2396.761284,9.4481,2226.902764,1061.800785,Benign
192.168.43.233,51363,139.59.72.43,443,36,7832,18,4768,18,3064,3137.592687,134.421894,283.7632983,182.351247,Benign
172.30.15.1560,50869,52.84.108.98,443,17,6861,9,1153,8,5708,3557.049129,0.154755,59603.89002,295072.8571,Benign
172.30.15.1220,50528,173.241.248.220,80,9,1939,6,1461,3,478,3467.152203,10.470643,1116.263824,365.211573,Benign
192.168.43.233,51356,23.33.237.68,443,24,12035,14,3558,10,8477,3096.265317,61.388347,463.6710612,1104.704774,Benign
192.168.43.224,55246,52.35.44.197,443,24,6200,13,3122,11,3078,110.4757148,64.17620481,389.1785136,383.6936147,Benign
192.168.43.224,35948,151.101.153.177,443,8,552,5,338,3,214,2407.279145,11.11458381,243.2839634,154.0318585,Benign
172.30.15.654,49941,13.229.196.49,80,10,1844,6,1324,4,520,2395.875586,10.398093,1018.648323,400.0733596,Benign
10.0.2.15,53664,119.254.87.201,80,11,1582,6,705,5,877,2803.622928,0.838149,6729.113797,8370.826667,Malicious
172.30.15.292,49555,180.149.59.12,443,19,6641,11,1417,8,5224,574.800705,5.142853,2204.223998,8126.228768,Benign
192.168.215.49,51858,172.217.161.3,443,31,6864,16,1839,15,5025,1399.232516,252.493648,58.26681231,159.211926,Benign
192.168.42.240,50943,172.217.166.206,443,20,1212,11,666,9,546,170.959385,40.710773,130.8744494,107.2934675,Benign
192.168.215.49,43198,13.231.12.16,443,21,8046,12,2038,9,6008,516.0925883,8.077364364,2018.480195,5950.455846,Benign
172.30.15.2252,51569,192.168.45.1,7680,3,198,3,198,0,0,4473.439529,9.000964,175.9811505,0,Benign
192.168.137.97,46132,18.208.55.232,443,9,659,5,318,4,341,7.040048546,13.88758952,183.1851378,196.4343773,Benign
172.30.6.255,58449,157.240.16.17,443,9,546,6,360,3,186,5624.484199,4.584337,628.2260663,324.5834676,Benign
10.0.2.15,55283,119.254.87.201,80,12,1633,7,779,5,854,20369.25349,5.639517,1105.059174,1211.451264,Malicious
172.30.6.255,55837,103.243.221.75,80,60,46540,22,8678,38,37862,101.881106,20.781472,3340.668072,14575.29091,Benign
10.0.2.15,38496,115.182.31.2,80,9,773,5,517,4,256,178.761432,0.683102,6054.732675,2998.088133,Malicious
172.30.1.136,50298,119.81.119.5,443,44,13668,23,7655,21,6013,508.166133,122.604017,499.4942376,392.3525605,Benign
172.30.15.451,49725,52.84.110.254,443,18,5390,10,2408,8,2982,1632.631084,7.94256,2425.414476,3003.565601,Benign
172.30.15.2386,51720,14.139.45.128,80,10,1376,5,653,5,723,5335.567339,0.317486,16454.26885,18218.12615,Benign
172.30.1.136,50189,172.217.161.3,443,28,7524,15,1927,13,5597,353.356569,16.047209,960.6654964,2790.267142,Benign
10.0.2.15,36193,119.254.87.201,80,11,1582,6,705,5,877,26231.28776,8.048953,700.7122541,871.6661658,Malicious
172.30.6.255,57716,103.243.221.87,80,6,340,4,228,2,112,3714.705763,24.347043,74.91669522,36.80118362,Benign
192.168.43.233,51014,163.53.78.128,443,51,21685,28,11834,23,9851,691.122287,50.779583,1864.371356,1551.962331,Benign
10.0.2.15,58280,119.254.87.201,80,11,1582,6,705,5,877,9197.454981,1.955356,2884.385247,3588.093421,Malicious
172.30.6.255,55923,103.243.221.51,443,21,7609,11,3149,10,4460,121.864819,30.402942,828.6040213,1173.570637,Benign
192.168.43.233,50863,172.217.166.206,443,21,1325,11,611,10,714,36.880779,197.203508,24.78657733,28.96500198,Benign
172.30.15.1271,50579,184.29.24.49,443,14,1543,7,958,7,585,3469.544683,7.962216,962.5461053,587.7760664,Benign
172.30.6.255,57931,103.243.221.17,80,7,406,5,294,2,112,4500.1072,26.957976,87.24690607,33.2369166,Benign
172.30.1.136,51895,172.217.194.188,5228,21,2397,11,1403,10,994,4698.098389,47.317279,237.2072156,168.0570009,Benign
172.30.6.255,57996,52.229.207.60,443,29,9951,16,3112,13,6839,4725.453851,2.262278,11004.83672,24184.47247,Benign
172.30.6.255,58494,35.190.41.40,443,37,13792,20,3744,17,10048,5711.167845,7.924429,3779.704506,10143.82235,Benign
10.0.2.15,55756,119.254.87.201,80,11,1513,6,705,5,808,9287.533798,2.02971,2778.722083,3184.691409,Malicious
172.30.6.255,58336,103.243.221.51,80,19,7345,11,5347,8,1998,5419.839133,9.970597,4290.214518,1603.113635,Benign
10.0.2.15,51454,119.254.87.201,80,11,1582,6,705,5,877,23432.62729,2.053917,2745.972695,3415.912133,Malicious
172.30.15.574,49858,52.11.15.218,443,28,9576,15,2177,13,7399,2256.231992,10.135666,1718.288665,5839.971443,Benign
172.30.1.136,50142,104.17.39.113,80,7,402,4,228,3,174,115.632744,16.632487,109.6648986,83.69163313,Benign
10.0.2.15,36660,119.254.87.201,80,11,1560,6,705,5,855,19738.64041,2.24956,2507.156955,3040.594605,Malicious
10.0.2.15,54915,119.254.87.201,80,11,1582,6,705,5,877,17368.3934,2.883071,1956.247349,2433.516205,Malicious
10.0.2.15,52668,119.254.87.201,80,11,1569,6,705,5,864,5025.828276,1.286904,4382.61129,5371.030007,Malicious
172.30.1.136,51810,52.84.108.135,443,19,2556,7,1530,12,1026,2983.843766,188.461208,64.94705266,43.55272943,Benign
192.168.43.224,58582,172.217.166.206,443,17,5877,9,1377,8,4500,2065.070648,16.02027367,687.6287028,2247.152624,Benign
192.168.42.240,51036,172.217.166.206,443,49,10278,24,5421,25,4857,608.371256,7.981348,5433.668598,4868.350559,Benign
192.168.43.233,51333,52.84.110.243,443,34,10307,17,1949,17,8358,3077.008238,195.035001,79.94462491,342.8307722,Benign
172.30.15.1817,51129,162.247.242.19,443,7,398,4,228,3,170,3743.638901,3.665021,497.6779124,371.0756364,Benign
172.30.6.255,57321,210.176.156.21,80,26,6226,14,4281,12,1945,2467.881173,302.104098,113.3648972,51.50542513,Benign
192.168.137.97,44558,74.125.24.188,443,9,606,5,338,4,268,11615.85778,56.09662261,48.20254543,38.21976975,Benign
172.30.6.255,57408,176.34.147.227,443,18,6378,9,1141,9,5237,2730.587126,40.222075,226.9400572,1041.617072,Benign
10.0.2.15,41987,119.254.87.201,80,11,1582,6,705,5,877,1393.994414,0.913233,6175.860925,7682.595789,Malicious
192.168.43.233,51219,157.240.16.20,443,13,1742,7,971,6,771,1278.145655,13.259033,585.8647459,465.1922957,Benign
172.30.15.1515,50823,157.240.16.16,443,26,7512,13,1863,13,5649,3525.437177,1.600439,9312.444898,28237.2524,Benign
192.168.137.97,37036,52.22.149.115,443,7,478,4,272,3,206,374.1119464,8.342908363,260.8203165,197.5330338,Benign
192.168.215.49,49118,104.237.191.1,443,7,478,4,272,3,206,1505.378035,12.76912529,170.4110462,129.061307,Benign
172.30.15.965,50271,151.101.130.49,80,10,1585,5,911,5,674,3442.374005,0.563407,12935.58653,9570.346126,Benign
192.168.215.49,45548,23.57.214.252,443,14,1667,8,1080,6,587,514.7228895,10.86883277,794.9335669,432.0611146,Benign
192.168.137.97,50938,104.237.191.1,443,9,606,5,338,4,268,9128.532719,57.12017763,47.33878836,37.53489728,Benign
10.0.2.15,57929,119.254.87.201,80,11,1582,6,705,5,877,340.921042,1.757274,3209.516558,3992.547548,Malicious
192.168.43.224,51532,54.197.248.134,443,29,10716,17,4404,12,6312,615.4227713,63.44388235,555.3254104,795.9159833,Benign
172.30.6.255,56869,184.29.25.41,80,33,12808,17,2243,16,10565,1379.012816,316.809863,56.63965077,266.7846234,Benign
172.30.6.255,56400,144.76.83.254,80,11,1878,6,992,5,886,651.41404,25.635444,309.5713887,276.4921879,Benign
10.0.2.15,38302,119.254.87.201,80,11,1582,6,705,5,877,13196.38252,1.914807,2945.466567,3664.07685,Malicious
10.0.2.15,38062,119.254.87.201,80,11,1579,6,705,5,874,7308.143884,1.820987,3097.221452,3839.675956,Malicious
192.168.43.224,51812,54.173.101.22,443,21,5688,12,1581,9,4107,34.04913416,11.06877289,1142.674091,2968.350721,Benign
172.30.15.1423,50731,103.231.98.244,443,8,973,5,799,3,174,3500.301032,1.030299,6204.024269,1351.064109,Benign
10.0.2.15,50752,119.254.87.201,80,11,1582,6,705,5,877,23438.18079,2.088444,2700.575165,3359.438893,Malicious
172.30.1.136,50460,157.240.16.39,443,2,132,2,132,0,0,857.994475,3.00082,351.903813,0,Benign
192.168.137.97,44036,23.57.201.101,443,8,559,4,264,4,295,44.16013839,24.79867513,85.16584008,95.16637434,Benign
10.0.2.15,50989,119.254.87.201,80,11,1513,6,705,5,808,6079.003432,2.279583,2474.136717,2835.606337,Malicious
192.168.43.233,51500,172.217.161.5,443,35,6892,19,4163,16,2729,3892.523053,156.755535,212.4582076,139.2741889,Benign
192.168.43.233,51116,13.126.200.177,443,7,402,4,228,3,174,919.971804,19.61628,92.98399085,70.9614667,Benign
172.30.1.136,50511,52.84.103.186,443,308,215379,130,11134,178,204245,990.319633,141.026084,631.5994706,11586.22542,Benign
192.168.137.97,36440,157.240.16.35,443,40,9250,21,3296,19,5954,133.1661073,67.02516952,393.4044507,710.658404,Benign
172.30.6.255,56047,103.243.220.234,443,33,17003,17,7753,16,9250,254.616457,30.228825,2051.816437,2447.994588,Benign
172.30.6.255,58515,54.194.27.245,443,18,6378,9,1141,9,5237,5748.868451,10.323432,884.2020754,4058.340288,Benign
172.30.6.255,57461,103.243.221.109,80,72,48153,44,40185,28,7968,2926.841048,24.189593,13290.01278,2635.182824,Benign
172.30.6.255,57917,216.239.32.62,443,7,402,4,228,3,174,4448.034712,17.852477,102.170696,77.97237325,Benign
172.30.6.255,57099,157.240.16.39,443,19,1933,10,1125,9,808,1765.095721,61.027304,147.4749728,105.9198027,Benign
192.168.43.233,51665,54.255.158.169,443,13,1533,8,1024,5,509,870.210125,23.328463,351.1590112,174.5507194,Benign
192.168.43.233,50909,213.239.228.180,443,7,402,4,228,3,174,335.316784,37.253592,48.9617216,37.36552438,Benign
10.0.2.15,56117,119.254.87.201,80,11,1579,6,705,5,874,26255.98918,1.017891,5540.868325,6869.104845,Malicious
10.0.2.15,46144,119.254.87.201,80,11,1582,6,705,5,877,1482.039056,1.621653,3477.932702,4326.449617,Malicious
192.168.137.97,48886,35.164.102.20,443,6,412,4,272,2,140,128.6756021,11.3282285,192.0865209,98.86806221,Benign
192.168.43.224,46480,54.85.84.151,443,68,8018,36,4687,32,3331,381.5834493,621.4862212,60.33279374,42.87786131,Benign
172.30.6.255,56706,172.217.166.206,443,18,1887,11,1246,7,641,1168.402712,74.010969,134.6827387,69.2870269,Benign
192.168.43.233,51011,163.53.78.128,443,9,535,5,295,4,240,566.071839,77.065518,30.62329381,24.91386615,Benign
10.0.2.15,40983,119.254.87.201,80,11,1582,6,705,5,877,22892.13295,1.484616,3798.962156,4725.80115,Malicious
192.168.43.224,33138,172.217.166.195,443,20,6735,11,1356,9,5379,110.6702924,15.82433497,685.526439,2719.355985,Benign
172.30.6.255,56865,103.243.221.51,80,75,56086,47,48118,28,7968,1375.861664,28.689681,13417.50715,2221.844154,Benign
172.30.15.2043,51355,52.86.72.168,443,21,9025,10,3119,11,5906,4090.895258,6.698039,3725.269441,7054.004911,Benign
172.30.6.255,56177,172.217.166.195,443,41,8576,19,2430,22,6146,437.094998,241.212264,80.59291712,203.8370653,Benign
172.30.15.1084,50390,205.185.216.42,80,126,97581,54,4240,72,93341,3452.949105,4.306573,7876.332295,173392.6256,Benign
172.30.1.136,50424,172.217.161.4,443,3,198,3,198,0,0,833.355197,9.001364,175.9733303,0,Benign
192.168.43.224,48408,34.227.208.227,443,9,659,5,318,4,341,26.30744926,13.13126758,193.7360567,207.748413,Benign
10.0.2.15,54936,119.254.87.201,80,11,1587,6,705,5,882,8809.748963,1.915443,2944.48856,3683.743134,Malicious
192.168.137.97,47188,54.88.46.124,443,32,8038,17,3233,15,4805,6829.997324,136.5622719,189.3934513,281.4833076,Benign
172.30.6.255,56279,103.243.221.46,80,29,17879,12,7111,17,10768,566.851232,22.206486,2561.774069,3879.226997,Benign
172.30.6.255,56113,103.243.221.109,80,7,406,5,294,2,112,323.932672,16.520819,142.3658234,54.23459939,Benign
192.168.43.224,48796,34.227.208.227,443,18,5210,10,1329,8,3881,361.3281476,44.27062028,240.1592734,701.3229046,Benign
172.30.6.255,56101,54.193.113.6,80,6,348,4,228,2,120,305.961259,18.156748,100.4585182,52.87290433,Benign
10.0.2.15,50039,119.254.87.201,80,11,1582,6,705,5,877,16917.9536,1.427493,3950.982597,4914.910266,Malicious
192.168.137.97,46488,172.217.161.14,443,26,6503,14,1715,12,4788,209.8481398,75.45022246,181.8417435,507.6724594,Benign
172.30.15.247,49400,162.125.34.129,443,520,156474,218,114865,302,41609,54.178358,5410.393538,169.8434677,61.52454487,Benign
192.168.137.97,39004,104.113.219.181,443,9,618,5,338,4,280,1767.174261,50.90642494,53.11706731,44.00230428,Benign
192.168.137.97,34202,172.217.161.3,443,23,2359,14,1528,9,831,62.56031093,234.6396821,52.09689977,28.33280348,Benign
172.30.6.255,57506,54.194.27.245,443,6,348,4,228,2,120,3059.618772,13.3845,136.2770369,71.72475625,Benign
10.0.2.15,43433,119.254.87.201,80,11,1582,6,705,5,877,17488.60363,1.439506,3918.010762,4873.894239,Malicious
192.168.43.233,51388,52.7.220.66,443,24,6093,13,1985,11,4108,3479.006747,146.431639,108.4465086,224.4323715,Benign
172.30.6.255,55839,35.190.43.164,80,80,23252,41,17054,39,6198,101.89335,309.750721,440.457409,160.0771092,Benign
172.30.15.1677,50988,54.201.247.66,443,6,348,4,228,2,120,3596.869943,10.477494,174.0874297,91.62496299,Benign
172.30.6.255,55882,52.77.195.144,443,30,8162,14,2780,16,5382,109.973668,60.391062,368.2664166,712.953185,Benign
172.30.6.255,55825,204.2.197.204,80,9,1315,5,813,4,502,91.006404,0.677403,9601.374662,5928.524084,Benign
192.168.43.233,51698,52.84.110.12,443,20,7024,10,1196,10,5828,1492.443326,81.174877,117.8689806,574.3648986,Benign
172.30.6.255,58452,52.114.128.8,443,21,8639,13,3996,8,4643,5639.555583,1.44502,22122.87719,25704.83454,Benign
172.30.15.1453,50761,103.231.98.244,443,28,11616,14,1162,14,10454,3502.140225,1.740565,5340.794512,48048.76577,Benign
172.30.15.2540,51874,192.168.121.146,80,225,202359,85,5817,140,196542,5501.85696,1.838163,25316.57965,855384.4246,Benign
172.30.15.1292,50600,210.176.156.62,80,12,5188,7,3714,5,1474,3471.125978,0.667683,44500.15951,17661.07569,Benign
10.0.2.15,37401,119.254.87.201,80,11,1582,6,705,5,877,22081.17039,1.45351,3880.262262,4826.936175,Malicious
172.30.15.1788,51100,52.37.171.77,443,16,5071,9,1153,7,3918,3643.11195,3.875837,2379.873044,8087.027396,Benign
192.168.43.233,51094,104.27.133.43,443,72,23211,31,2637,41,20574,916.815142,401.129244,52.59152833,410.3216169,Benign
192.168.43.233,51093,93.158.134.119,443,7,402,4,228,3,174,916.793904,11.367189,160.4618345,122.4577158,Benign
172.30.6.255,58308,173.241.248.220,80,10,2494,6,1300,4,1194,5353.845043,5.288399,1966.56871,1806.217723,Benign
10.0.2.15,57364,119.254.87.201,80,11,1579,6,705,5,874,941.524199,2.531965,2227.518943,2761.491569,Malicious
172.30.1.136,51786,172.217.160.243,443,11,642,6,348,5,294,2974.593841,36.431872,76.41660577,64.5588566,Benign
172.30.15.2494,51828,14.139.45.128,80,10,1401,5,665,5,736,5475.083348,0.712717,7464.393301,8261.343563,Benign
172.30.6.255,56117,103.243.221.109,80,7,406,5,294,2,112,324.084031,16.369735,143.6797847,54.73515607,Benign
172.30.15.721,50008,198.58.102.214,80,11,1667,6,732,5,935,2409.438934,6.23486,939.2352034,1199.706168,Benign
172.30.15.242,49511,23.198.126.238,443,17,6380,8,1315,9,5065,53.222211,0.671384,15669.12527,60352.94258,Benign
192.168.43.224,48896,151.101.153.177,443,21,9142,12,1410,9,7732,3264.3678,28.92384638,389.9896249,2138.581404,Benign
172.30.15.425,49699,59.63.81.183,443,151,123942,58,4683,93,119259,1616.772141,4.103362,9130.074315,232509.8297,Benign
172.30.1.136,51924,52.84.110.171,443,66,10964,33,6276,33,4688,6258.786148,178.751036,280.8822881,209.8113714,Benign
172.30.6.255,56277,103.243.221.17,80,37,24782,22,20742,15,4040,566.837036,22.223066,7466.836484,1454.344779,Benign
172.30.1.136,50329,157.240.16.20,443,27,7229,15,3002,12,4227,569.035403,45.243709,530.8141293,747.418829,Benign
172.30.15.2178,51490,172.217.166.202,443,8,480,5,294,3,186,4255.633657,2.517309,934.3310654,591.1074087,Benign
172.30.6.255,55714,184.29.25.122,80,26,18665,10,3951,16,14714,57.164327,1.429377,22113.13041,82351.96173,Benign
192.168.215.49,50270,217.12.15.83,443,5,340,3,206,2,134,612.7315831,18.08348221,91.13289026,59.28061794,Benign
172.30.6.255,56507,103.243.221.17,80,62,51593,22,13693,40,37900,828.848538,16.225513,6751.342777,18686.62026,Benign
172.30.6.255,57456,54.194.27.245,443,12,1416,6,904,6,512,2891.958306,35.720234,202.4622795,114.6689017,Benign
10.0.2.15,40451,119.254.87.201,80,11,1593,6,705,5,888,25955.6313,0.827879,6812.589763,8580.964126,Malicious
172.30.1.136,50348,172.217.161.3,443,10,600,6,360,4,240,618.12603,12.824681,224.5669892,149.7113262,Benign
172.30.15.874,50180,52.84.101.238,443,231,196041,92,6214,139,189827,3435.477524,1.575387,31555.42099,963963.7752,Benign
10.0.2.15,59649,119.254.87.201,80,11,1582,6,705,5,877,1421.93241,4.319929,1305.577013,1624.100766,Malicious
172.30.15.2274,51593,146.185.29.13,443,108,83660,45,4589,63,79071,4537.856294,19.856059,1848.906674,31857.68133,Benign
192.168.43.224,57388,34.196.177.243,443,34,8612,18,3530,16,5082,3075.713942,18.10015465,1560.207664,2246.168654,Benign
10.0.2.15,45348,119.254.87.201,80,11,1582,6,705,5,877,1121.700855,1.286435,4384.209074,5453.831713,Malicious
172.30.15.2111,51423,54.71.19.12,443,21,6680,12,1315,9,5365,4177.993764,9.355327,1124.493029,4587.760535,Benign
172.30.15.2521,51855,23.61.93.124,443,761,701919,274,17441,487,684478,5488.073693,9.805943,14228.9222,558418.9098,Benign
192.168.137.97,46370,173.241.248.143,443,6,356,4,236,2,120,349.1877583,14.64921638,128.8806139,65.53251554,Benign
172.30.6.255,57915,216.239.32.62,443,7,402,4,228,3,174,4448.034517,17.819428,102.360188,78.11698557,Benign
172.30.1.136,50820,172.217.161.3,443,20,2389,10,1357,10,1032,1956.673044,24.502748,443.0523466,336.9417993,Benign
10.0.2.15,51678,119.254.87.201,80,11,1582,6,705,5,877,25117.54173,0.825135,6835.245142,8502.851049,Malicious
172.30.15.592,49877,23.56.25.241,443,19,7963,11,1273,8,6690,2321.315144,4.744604,2146.438354,11280.18271,Benign
10.0.2.15,37999,119.254.87.201,80,11,1579,6,705,5,874,15146.07493,1.960451,2876.889042,3566.526274,Malicious
192.168.215.49,50040,172.217.161.14,443,55,13452,27,6866,28,6586,391.1375914,240.3507027,228.5327207,219.2130059,Benign
192.168.43.224,33430,172.217.161.3,443,9,618,5,338,4,280,126.7454994,22.6653417,119.3010913,98.82930641,Benign
10.0.2.15,57919,119.254.87.201,80,11,1582,6,705,5,877,14247.87436,7.099395,794.4338919,988.2532244,Malicious
10.0.2.15,52763,119.254.87.201,80,11,1569,6,705,5,864,23167.83069,2.275306,2478.787469,3037.833153,Malicious
172.30.1.136,51915,52.230.7.59,443,54,17742,31,6744,23,10998,5778.497247,647.98736,83.26088336,135.7804263,Benign
192.168.43.224,43850,52.84.110.11,443,12,832,7,478,5,354,1210.570706,39.29623033,97.3121332,72.06798149,Benign
172.30.6.255,58501,157.240.16.17,443,385,339538,145,9681,240,329857,5731.018158,8.03437,9639.585929,328445.9142,Benign
172.30.6.255,58564,52.229.175.79,443,27,10001,15,2206,12,7795,5856.908287,0.674988,26145.65,92386.82762,Benign
10.0.2.15,51928,119.254.87.201,80,11,1582,6,705,5,877,17341.45988,1.320013,4272.685193,5315.099169,Malicious
172.30.15.1376,50684,151.101.130.2,443,8,480,5,294,3,186,3494.479502,2.554309,920.7969748,582.5450249,Benign
172.30.6.255,58384,52.213.19.114,443,27,9777,14,4048,13,5729,5486.31614,4.314163,7506.438677,10623.61343,Benign
172.30.6.255,56323,66.117.28.68,80,10,2060,6,964,4,1096,590.94301,41.095219,187.6617326,213.3581524,Benign
172.30.6.255,57344,104.16.2.35,443,126,69809,52,4168,74,65641,2476.438302,400.607356,83.23361891,1310.829649,Benign
172.30.15.2228,51545,184.29.25.145,443,25,11670,11,2316,14,9354,4457.300022,10.371738,1786.392984,7214.991354,Benign
172.30.15.1112,50420,172.217.160.226,80,10,2507,6,1095,4,1412,3458.271389,8.760979,999.8882545,1289.353621,Benign
172.30.6.255,58230,157.240.16.39,443,19,1933,11,1179,8,754,5181.394772,60.966028,154.7091111,98.94034757,Benign
172.30.6.255,56167,173.241.248.220,80,95,49955,47,22218,48,27737,434.861298,421.390513,421.803516,526.5804359,Benign
172.30.1.136,51519,52.84.108.242,443,17,1681,8,1015,9,666,10.223225,15.298876,530.7579459,348.2608788,Benign
192.168.43.224,35726,151.101.153.177,443,21,9142,12,1410,9,7732,1274.94371,11.04585059,1021.197952,5599.930898,Benign
172.30.1.136,50621,52.213.11.166,443,22,7602,13,1394,9,6208,1650.281594,62.47281,178.5096588,794.9698437,Benign
10.0.2.15,40200,119.254.87.201,80,11,1579,6,705,5,874,5628.559164,1.623982,3472.944897,4305.46644,Malicious
192.168.43.233,51019,216.58.221.34,443,23,6170,11,1922,12,4248,698.904937,17.767618,865.3945622,1912.69308,Benign
172.30.6.255,57646,103.243.221.46,80,3,198,3,198,0,0,3516.847249,9.004684,175.9084494,0,Benign
172.30.6.255,57393,157.240.16.39,443,19,1933,10,1125,9,808,2680.089244,61.049558,147.4212147,105.8811925,Benign
192.168.43.224,41778,34.232.42.95,443,14,1660,8,1080,6,580,35.1338368,14.78716552,584.2904773,313.7856267,Benign
172.30.15.207,49487,111.221.29.13,443,25,7140,15,1863,10,5277,8.236677,1.20137,12405.83667,35139.88197,Benign
192.168.137.97,39208,172.217.161.4,443,60,12400,29,3388,31,9012,37.37542444,103.0747625,262.9547654,699.4534668,Benign
172.30.1.136,50219,52.84.103.186,443,18,3666,12,3282,6,384,385.106606,45.548382,576.4419908,67.44476675,Benign
192.168.137.97,33856,172.217.161.5,443,89,45175,46,6432,43,38743,10723.19386,242.7244736,211.9934559,1276.937572,Benign
172.30.6.255,57768,161.69.36.37,80,7,398,4,228,3,170,3967.691703,0.605708,3011.352005,2245.306319,Benign
192.168.43.224,38274,104.17.79.191,80,13,1886,7,1239,6,647,1425.774468,67.36829293,147.1315298,76.83139612,Benign
172.30.6.255,55743,50.116.239.135,80,6,531,4,228,2,303,58.234688,0.47761,3819.015515,5075.270618,Benign
192.168.42.240,51022,104.108.212.173,443,36,21115,14,1205,22,19910,490.166144,2.790077,3455.101777,57088.03019,Benign
192.168.215.49,44168,172.217.161.5,443,18,5684,9,1353,9,4331,1528.499917,12.56691596,861.3091737,2757.080585,Benign
192.168.137.97,44348,172.217.161.10,443,11,754,7,486,4,268,8269.413599,62.72319177,61.98664147,34.18193398,Benign
192.168.137.97,56332,52.84.108.195,443,11,770,7,478,4,292,8276.611691,16.27856998,234.9100691,143.5015485,Benign
192.168.43.224,46276,45.33.67.183,443,6,412,4,272,2,140,2468.272886,11.05385435,196.8544122,101.3221239,Benign
172.30.6.255,56804,172.217.166.197,443,29,8024,16,5470,13,2554,1266.453487,86.041044,508.5944796,237.4680623,Benign
172.30.15.1977,51289,52.26.114.97,443,6,348,4,228,2,120,4076.702449,0.934855,1951.104717,1026.897219,Benign
192.168.43.233,50921,83.212.248.207,80,35,25372,14,1158,21,24214,398.385421,134.015754,69.12620139,1445.442004,Benign
10.0.2.15,60658,119.254.87.201,80,11,1582,6,705,5,877,13161.55878,1.224802,4604.825923,5728.272815,Malicious
10.0.2.15,39391,119.254.87.201,80,11,1579,6,705,5,874,2380.738161,3.960286,1424.13957,1765.529055,Malicious
192.168.215.49,36836,169.60.79.3,443,7,478,4,272,3,206,998.0850684,52.99273591,41.0622317,31.09860195,Benign
192.168.137.97,46654,52.84.110.17,443,9,618,6,404,3,214,345.860756,11.17107411,289.3186428,153.2529445,Benign
172.30.15.900,50206,103.243.220.231,80,30,13935,17,10004,13,3931,3438.496985,8.764687,9131.187457,3588.034576,Benign
10.0.2.15,40621,119.254.87.201,80,11,1534,6,705,5,829,4603.171054,1.888404,2986.649043,3511.960364,Malicious
10.0.2.15,46197,119.254.87.201,80,11,1579,6,705,5,874,3974.778919,1.035146,5448.506781,6754.602732,Malicious
172.30.6.255,56934,103.15.158.129,443,20,10441,10,4330,10,6111,1387.703616,10.283586,3368.474771,4753.983678,Benign
10.0.2.15,46417,119.254.87.201,80,11,1579,6,705,5,874,3191.662898,1.467194,3844.072427,4765.559292,Malicious
172.30.6.255,58252,157.240.16.39,443,19,1933,10,1125,9,808,5242.384895,60.776283,148.0840808,106.3572776,Benign
192.168.215.49,60622,103.231.98.244,443,24,9206,11,2562,13,6644,620.3347875,1.909724973,10732.43545,27832.27991,Benign
192.168.137.97,34514,172.217.161.19,443,47,8082,23,2754,24,5328,346.6314396,240.858594,91.47275849,176.9669053,Benign
192.168.215.49,35662,54.65.57.191,443,33,9105,17,2781,16,6324,620.128355,60.61346058,367.0471837,834.6660876,Benign
172.30.6.255,56438,103.243.220.231,80,6,340,4,228,2,112,699.753599,11.128047,163.9101632,80.51727316,Benign
172.30.6.255,55899,184.84.52.113,80,71,56733,21,4667,50,52066,116.94126,111.914252,333.612559,3721.849475,Benign
172.30.15.531,49815,52.5.46.238,443,6,348,4,228,2,120,2246.651153,9.614565,189.7121711,99.84851109,Benign
10.0.2.15,35041,119.254.87.201,80,11,1587,6,705,5,882,6677.383829,2.021421,2790.116458,3490.613781,Malicious
192.168.137.97,34394,172.217.161.3,443,26,9123,14,2176,12,6947,281.2535801,23.28115586,747.7291981,2387.1667,Benign
192.168.43.224,42274,18.211.245.141,443,35,4324,19,2414,16,1910,3086.151685,117.2083124,164.7664709,130.3661804,Benign
10.0.2.15,46061,119.254.87.201,80,11,1579,6,705,5,874,3071.603132,0.897137,6286.665247,7793.681456,Malicious
10.0.2.15,54565,119.254.87.201,80,11,1582,6,705,5,877,3314.08294,1.861991,3029.015715,3768.00962,Malicious
192.168.137.97,39108,172.217.161.4,443,11,766,6,428,5,338,17.66378932,12.22220436,280.145864,221.236687,Benign
192.168.215.49,42086,52.205.114.175,443,7,478,4,272,3,206,612.4577695,7.781900624,279.6232058,211.7734574,Benign
192.168.43.224,41448,52.10.2.252,443,6,412,4,272,2,140,727.6745336,16.2874411,133.5998692,68.76463856,Benign
192.168.137.97,59986,180.149.59.77,443,22,5607,12,1575,10,4032,1121.976165,79.46323773,158.5638889,405.9235556,Benign
192.168.215.49,32928,195.8.215.136,80,9,618,5,338,4,280,508.4050898,7.657039529,353.1390937,292.5412611,Benign
172.30.15.1126,50434,205.185.216.42,80,10,1175,6,752,4,423,3458.29675,9.031891,666.084212,374.6723693,Benign
192.168.43.224,38218,140.98.193.112,443,7,478,4,272,3,206,2279.995038,16.85505556,129.1007314,97.77481863,Benign
172.30.1.136,50172,119.81.21.130,443,130,56122,71,9568,59,46554,263.310394,187.944464,407.2692452,1981.606652,Benign
192.168.43.224,43402,173.192.91.155,443,8,464,5,290,3,174,115.9054576,59.07714213,39.27068772,23.56241263,Benign
10.0.2.15,33586,119.254.87.201,80,11,1582,6,705,5,877,2565.018881,0.956826,5894.488653,7332.576665,Malicious
10.0.2.15,52502,119.254.87.201,80,11,1582,6,705,5,877,18990.35389,1.244824,4530.760975,5636.138121,Malicious
172.30.6.255,56881,184.29.26.182,80,9,534,5,294,4,240,1385.017894,23.444361,100.322632,81.89602608,Benign
192.168.43.224,40680,52.84.108.164,443,12,1535,7,1041,5,494,3067.13483,18.95005587,439.4709999,208.5481978,Benign
172.30.6.255,55956,103.243.221.75,80,37,23284,16,8248,21,15036,162.856328,51.177797,1289.309112,2350.394254,Benign
192.168.137.97,50630,104.237.191.1,443,7,518,7,518,0,0,5307.970213,65.07398392,63.68136313,0,Benign
172.30.6.255,56292,52.5.131.6,80,13,1942,7,981,6,961,569.288433,62.814704,124.9388997,122.3917254,Benign
10.0.2.15,42595,119.254.87.201,80,11,1582,6,705,5,877,10548.90506,1.355368,4161.231488,5176.453922,Malicious
172.30.6.255,56349,209.15.36.31,80,10,1606,6,861,4,745,607.828062,24.379006,282.5381806,244.4726417,Benign
192.168.43.224,35162,104.198.143.177,80,10,911,5,425,5,486,1823.813532,1.694362859,2006.653995,2294.667863,Benign
10.0.2.15,46202,119.254.87.201,80,11,1579,6,705,5,874,12745.96642,2.216549,2544.495971,3154.453161,Malicious
10.0.2.15,39310,119.254.87.201,80,11,1579,6,705,5,874,4367.138533,2.086525,2703.058914,3351.026228,Malicious
172.30.6.255,58480,103.243.221.51,80,47,33567,29,29366,18,4201,5682.838963,6.410762,36645.87767,5242.434519,Benign
192.168.43.224,45684,209.197.3.15,80,7,410,4,236,3,174,804.4710958,29.91616845,63.1096861,46.5300228,Benign
192.168.43.233,51099,172.217.160.238,443,7,454,3,163,4,291,3.94434,8.622303,151.2356965,269.9974705,Benign
10.0.2.15,59546,119.254.87.201,80,11,1579,6,705,5,874,2530.926561,2.73525,2061.968741,2556.256284,Malicious
192.168.215.49,42258,111.119.15.1,443,19,5514,10,1311,9,4203,509.9652756,11.19843879,936.5591219,3002.561395,Benign
172.30.6.255,57055,103.243.221.17,80,17,5497,9,4215,8,1282,1663.842362,16.189071,2082.886659,633.5138069,Benign
10.0.2.15,50759,119.254.87.201,80,12,1656,7,779,5,877,18002.2855,9.528754,654.0204522,736.2977363,Malicious
172.30.6.255,57264,157.240.16.39,443,28,5556,15,3410,13,2146,2253.094648,61.025025,447.0297226,281.3272096,Benign
172.30.15.984,50290,54.94.182.41,80,9,1023,5,731,4,292,3442.718363,1.167325,5009.744501,2001.15649,Benign
192.168.43.233,51389,103.243.221.46,443,24,7809,12,2566,12,5243,3479.00699,57.621568,356.255491,727.9218781,Benign
192.168.42.240,50942,172.217.166.206,443,177,57640,80,33486,97,24154,170.709209,125.00991,2142.934108,1545.733454,Benign
10.0.2.15,56007,119.254.87.201,80,11,1513,6,705,5,808,18089.3833,1.292667,4363.072624,5000.51444,Malicious
172.30.6.255,56183,103.243.221.17,80,35,17551,18,9996,17,7555,464.872024,26.164053,3056.407201,2310.039656,Benign
172.30.15.778,50070,52.84.108.93,443,2035,1833640,783,49049,1252,1784591,2660.239472,16.078049,24405.4487,887963.9563,Benign
10.0.2.15,49995,119.254.87.201,80,11,1582,6,705,5,877,18297.18931,2.016516,2796.903174,3479.268203,Malicious
10.0.2.15,39600,119.254.87.201,80,11,1582,6,705,5,877,8626.807025,2.049111,2752.41312,3423.923838,Malicious
172.30.15.2359,51693,14.139.45.128,80,132,128330,41,2593,91,125737,5332.70672,0.636346,32598.61773,1580737.523,Benign
192.168.43.224,57956,174.129.238.218,443,141,95447,70,8130,71,87317,50.32366083,90.01821182,722.5204621,7759.94086,Benign
10.0.2.15,44532,119.254.87.201,80,11,1582,6,705,5,877,11600.04414,1.506413,3743.993181,4657.421305,Malicious
10.0.2.15,40817,119.254.87.201,80,11,1513,6,705,5,808,18122.44662,125.202975,45.04685292,51.62816618,Malicious
172.30.1.136,50260,104.17.38.113,443,1,66,1,66,0,0,461.652319,0,0,0,Benign
10.0.2.15,45996,119.254.87.201,80,11,1579,6,705,5,874,14483.28274,1.030185,5474.744827,6787.130467,Malicious
172.30.15.2145,51457,23.57.208.237,443,25,8010,12,1363,13,6647,4178.856445,8.772724,1242.943469,6061.515215,Benign
192.168.137.97,55240,52.172.156.220,443,22,7586,13,1529,9,6057,8274.503891,54.91675254,222.7371327,882.3537037,Benign
10.0.2.15,55537,119.254.87.201,80,11,1579,6,705,5,874,15087.05092,1.659004,3399.63014,4214.576939,Malicious
192.168.137.97,57374,157.240.16.20,443,115,89250,44,3968,71,85282,5244.982208,65.21721217,486.7426703,10461.2874,Benign
172.30.6.255,55896,50.112.42.246,443,21,7603,12,2113,9,5490,115.413764,36.853654,458.679077,1191.740716,Benign
10.0.2.15,44980,119.254.87.201,80,11,1582,6,705,5,877,13827.31845,1.881501,2997.606698,3728.937694,Malicious
192.168.137.97,48652,54.255.158.169,443,18,5399,10,1437,8,3962,347.6960612,15.47754296,742.7535512,2047.870264,Benign
172.30.6.255,57644,103.243.221.75,80,7,406,5,294,2,112,3516.838076,40.224252,58.47218738,22.275119,Benign
192.168.43.233,51241,172.217.194.188,5228,135,11216,71,6439,64,4777,1634.692346,2446.788164,21.0529055,15.61884292,Benign
192.168.137.97,57598,169.60.79.147,443,32,8374,18,3488,14,4886,7156.909123,2.092614786,13334.51345,18679.02313,Benign
172.30.15.2179,51491,77.88.21.119,443,14,3595,8,2330,6,1265,4261.685669,6.604143,2822.470682,1532.371422,Benign
172.30.1.136,50200,172.217.161.1,443,14,864,8,492,6,372,358.080541,18.16757,216.6497776,163.8083684,Benign
172.30.15.2515,51849,54.251.147.241,80,10,2015,6,765,4,1250,5483.489255,4.668152,1311.011295,2142.175319,Benign
172.30.15.2213,51528,13.107.21.200,443,25,13006,13,1372,12,11634,4438.861765,8.626845,1272.307547,10788.64869,Benign
172.30.15.956,50262,103.243.220.231,443,19,6992,10,2692,9,4300,3442.086306,5.17527,4161.328781,6646.996195,Benign
10.0.2.15,47458,119.254.87.201,80,11,1593,6,705,5,888,2232.890891,1.821072,3097.076887,3900.998972,Malicious
10.0.2.15,44749,119.254.87.201,80,12,1587,7,779,5,808,7548.381918,4.77446,1305.278503,1353.870385,Malicious
10.0.2.15,60974,119.254.87.201,80,12,1587,7,779,5,808,5656.432015,3.851841,1617.927635,1678.158574,Malicious
192.168.43.224,42132,157.240.16.20,443,50,20265,23,3147,27,17118,1210.074511,68.6152552,366.9154902,1995.824392,Benign
172.30.6.255,55644,122.15.34.40,80,138,138184,39,6582,99,131602,36.774919,21.801949,2415.196917,48289.99462,Benign
10.0.2.15,55354,119.254.87.201,80,11,1579,6,705,5,874,1151.702977,1.827199,3086.691707,3826.622059,Malicious
10.0.2.15,55878,119.254.87.201,80,11,1579,6,705,5,874,5718.677019,1.646178,3426.117953,4247.414314,Malicious
192.168.137.97,49770,157.240.16.16,443,358,70400,202,27086,156,43314,28.29209677,1923.011899,112.68157,180.1923328,Benign
172.30.6.255,56432,103.243.221.75,443,21,7958,11,4400,10,3558,680.783779,18.494679,1903.250119,1539.037255,Benign
192.168.137.97,41096,23.57.218.60,443,10,692,6,412,4,280,53.19848434,13.47413245,244.6168622,166.2444695,Benign
172.30.6.255,57346,104.16.2.35,443,17,5792,10,1186,7,4606,2476.43835,34.980051,271.2403135,1053.400408,Benign
10.0.2.15,53086,119.254.87.201,80,11,1579,6,705,5,874,16948.01413,0.894101,6308.012182,7820.145599,Malicious
10.0.2.15,53692,119.254.87.201,80,11,1579,6,705,5,874,6286.988185,0.859117,6564.879987,8138.588807,Malicious
172.30.6.255,57387,103.243.221.17,80,17,5936,9,4299,8,1637,2664.880087,17.23352,1995.645695,759.9143994,Benign
172.30.15.1056,50362,184.72.247.8,80,6,348,4,228,2,120,3448.911791,8.409277,216.9033081,114.1596358,Benign
10.0.2.15,42053,119.254.87.201,80,11,1569,6,705,5,864,14338.04325,1.363337,4136.908189,5069.913015,Malicious
172.30.6.255,56409,157.240.16.39,443,19,1933,10,1125,9,808,667.085645,61.074769,147.3603609,105.8374859,Benign
10.0.2.15,51630,119.254.87.201,80,11,1582,6,705,5,877,19053.43414,1.818046,3102.231737,3859.088274,Malicious
172.30.6.255,56751,35.190.43.164,80,9,1517,5,1063,4,454,1244.368561,0.518199,16410.68393,7008.890407,Benign
172.30.1.136,50425,52.84.103.186,443,3,198,3,198,0,0,833.404685,9.000973,175.9809745,0,Benign
10.0.2.15,53677,119.254.87.201,80,11,1513,6,705,5,808,23558.32683,5.047149,1117.462552,1280.723038,Malicious
192.168.43.233,51362,45.79.77.20,443,18,2472,9,1646,9,826,3137.563843,29.395863,447.95419,224.7935364,Benign
172.30.6.255,57735,54.194.27.245,443,18,6378,9,1141,9,5237,3780.78961,20.285384,449.9791574,2065.329402,Benign
172.30.15.1541,50849,172.217.166.206,443,35,12746,16,2785,19,9961,3532.248266,4.767269,4673.535309,16715.64999,Benign
192.168.43.233,51315,74.207.230.33,443,39,17078,18,2613,21,14465,2939.577884,86.591011,241.4107395,1336.397377,Benign
10.0.2.15,40815,119.254.87.201,80,11,1579,6,705,5,874,6109.0508,1.676455,3364.241808,4170.705447,Malicious
10.0.2.15,45021,119.254.87.201,80,11,1582,6,705,5,877,24549.44963,1.428169,3949.112465,4912.583875,Malicious
172.30.15.243,49512,23.198.126.238,443,18,6469,8,1351,10,5118,53.222228,0.900402,12003.52731,45473.02205,Benign
172.30.6.255,58195,103.243.221.87,80,32,22731,13,5455,19,17276,5089.889511,11.497108,3795.737154,12021.11,Benign
172.30.6.255,57446,54.194.27.245,443,18,6378,9,1141,9,5237,2861.509934,30.336355,300.8931033,1381.049239,Benign
172.30.15.1880,51192,52.84.108.203,443,18,6927,10,1219,8,5708,3967.450608,0.409439,23817.95579,111528.213,Benign
192.168.42.240,51001,172.217.163.67,443,40,7464,22,5904,18,1560,344.157227,47.601166,992.2446017,262.1784517,Benign
172.30.6.255,56466,103.243.221.75,80,50,39070,20,9829,30,29241,762.859797,9.953265,7900.121217,23502.63959,Benign
10.0.2.15,51679,219.234.85.220,80,7,428,4,236,3,192,36785.37692,0.772623,2443.623863,1988.032973,Malicious
172.30.15.2320,51650,52.55.184.84,443,12,1416,6,904,6,512,5041.268992,6.575781,1099.793317,622.8917903,Benign
192.168.137.97,44630,151.101.193.170,443,21,9399,12,1458,9,7941,21.56655937,10.33998808,1128.047722,6143.91424,Benign
192.168.43.224,60738,172.217.166.205,443,13,921,6,396,7,525,40.93142207,143.9817221,22.00279281,29.17036925,Benign
172.30.6.255,56769,23.198.126.238,443,17,6374,8,1309,9,5065,1245.554182,0.78188,13393.35959,51823.80928,Benign
10.0.2.15,58426,219.234.85.216,80,7,1104,4,680,3,424,36786.97186,0.954689,5698.19072,3552.989508,Malicious
172.30.15.1265,50573,157.240.16.63,80,8,456,5,282,3,174,3469.538033,7.969981,283.0621554,174.6553725,Benign
192.168.43.233,50701,125.56.235.100,443,20,8012,10,1235,10,6777,1839.7969,0.880402,11222.14625,61580.95961,Benign
192.168.215.32,10020,192.168.215.177,7680,3,198,3,198,0,0,1094.613568,9.00096194,175.9811907,0,Benign
172.30.15.2335,51668,162.125.82.3,443,6,348,4,228,2,120,5135.362979,0.320672,5688.055084,2993.713202,Benign
192.168.43.224,33394,172.217.160.246,443,17,5284,9,1377,8,3907,2903.542659,20.23697131,544.3502306,1544.499892,Benign
172.30.6.255,56636,103.243.221.17,80,6,340,4,228,2,112,1012.113208,12.958463,140.757434,69.14400265,Benign
192.168.43.233,50887,49.44.169.252,80,13,1509,7,780,6,729,116.033194,167.962777,37.15108854,34.72197891,Benign
192.168.137.97,52270,172.217.161.3,443,27,2895,16,1876,11,1019,9511.64389,52.18850518,287.5729042,156.2029794,Benign
192.168.43.233,51660,130.211.21.54,443,15,2106,9,1312,6,794,868.131993,25.405059,413.1460588,250.0289411,Benign
192.168.43.233,51074,172.217.166.206,443,9,534,5,294,4,240,909.39765,11.860617,198.3033429,161.8802799,Benign
192.168.43.233,50973,49.44.170.2,443,15,1648,8,1063,7,585,492.655618,12.776044,665.6207508,366.3105731,Benign
172.30.6.255,57734,69.173.144.141,80,6,348,4,228,2,120,3780.117106,19.90445,91.63779959,48.23042084,Benign
172.30.6.255,58101,157.240.16.39,443,19,1945,10,1137,9,808,4876.081288,61.067197,148.9506715,105.8506091,Benign
172.30.15.2286,51609,52.6.78.241,443,52,32886,30,28217,22,4669,4726.838545,1.990519,113405.5992,18764.95527,Benign
172.30.15.1920,51232,18.207.56.96,443,39,13419,21,3886,18,9533,3986.823517,9.574473,3246.967222,7965.347022,Benign
172.30.6.255,57692,172.217.166.206,443,46,7685,25,4587,21,3098,3663.409736,136.799083,268.2474122,181.1708051,Benign
10.0.2.15,52262,119.254.87.201,80,12,1653,7,779,5,874,6464.811148,4.229249,1473.547668,1653.248603,Malicious
192.168.43.224,52204,151.101.153.176,443,82,25254,40,3952,42,21302,31.72347339,601.8720608,52.52943617,283.1432311,Benign
192.168.137.97,48752,172.217.194.189,443,20,6191,11,1521,9,4670,42.33162579,54.37104306,223.7955962,687.1304632,Benign
10.0.2.15,34183,119.254.87.201,80,11,1582,6,705,5,877,6795.131014,1.351911,4171.872261,5189.690741,Malicious
10.0.2.15,55904,119.254.87.201,80,11,1579,6,705,5,874,8721.723834,2.084476,2705.715969,3354.320222,Malicious
10.0.2.15,41854,119.254.87.201,80,11,1569,6,705,5,864,10553.79316,1.412315,3993.443389,4894.092324,Malicious
172.30.1.136,50681,151.101.0.188,443,15,2998,10,2668,5,330,1805.301274,15.617678,1366.656426,169.0392131,Benign
172.30.6.255,56090,13.228.114.100,80,6,348,4,228,2,120,305.824907,18.097097,100.789646,53.0471821,Benign
172.30.15.1925,51237,34.201.201.2,443,19,5522,11,1790,8,3732,3991.665176,5.535711,2586.840245,5393.345137,Benign
10.0.2.15,59386,119.254.87.201,80,11,1579,6,705,5,874,18870.25765,2.354354,2395.561585,2969.816774,Malicious
172.30.15.297,49560,209.197.3.15,443,6,348,4,228,2,120,614.172943,6.11109,298.4737584,157.0914518,Benign
172.30.6.255,57166,103.243.221.87,80,40,24264,23,20107,17,4157,1982.853271,25.17201,6390.27237,1321.14996,Benign
10.0.2.15,33453,119.254.87.201,80,12,1653,7,779,5,874,18032.27967,6.561193,949.8272646,1065.659858,Malicious
10.0.2.15,46829,119.254.87.201,80,11,1582,6,705,5,877,5626.429576,1.614441,3493.469257,4345.77665,Malicious
172.30.1.136,50592,54.239.32.228,443,36,14850,18,3334,18,11516,1597.724748,202.76692,131.540194,454.3541915,Benign
10.0.2.15,59650,115.182.31.2,80,5,574,3,446,2,128,36785.55836,0.527368,6765.674064,1941.718117,Malicious
10.0.2.15,58415,115.182.31.2,80,10,1992,5,554,5,1438,176.921952,0.662958,6685.18971,17352.53214,Malicious
172.30.6.255,57947,103.243.221.17,80,26,14260,12,5393,14,8867,4565.868971,21.18253,2036.772756,3348.797334,Benign
172.30.6.255,56850,172.217.194.189,443,453,87858,231,48063,222,39795,1352.726338,3890.504999,98.83138567,81.82999381,Benign
172.30.6.255,58427,157.240.16.20,443,68,54578,23,2284,45,52294,5587.105344,1.94541,9392.364592,215045.6716,Benign
172.30.15.1816,51128,54.218.8.216,443,6,348,4,228,2,120,3743.602997,4.205366,433.7315706,228.279774,Benign
172.30.1.136,50650,157.240.16.20,443,22,5720,10,1778,12,3942,1746.401685,3.581331,3971.707725,8805.66471,Benign
172.30.1.136,50283,52.84.103.186,443,14,864,8,492,6,372,484.253502,25.599847,153.7509189,116.2506948,Benign
172.30.15.2040,51352,151.101.194.2,443,58,19338,29,4466,29,14872,4090.889058,6.70361,5329.665658,17748.04919,Benign
192.168.137.97,36082,172.217.160.234,443,47,12395,25,4288,22,8107,22.0288411,279.192267,122.8687326,232.2986975,Benign
172.30.15.1228,50536,103.229.205.253,443,8,468,5,282,3,186,3467.555785,10.175046,221.7188994,146.2401251,Benign
172.30.1.136,50285,52.84.103.186,443,14,1603,9,1090,5,513,487.362917,20.014759,435.6784911,205.0486843,Benign
192.168.215.49,54234,157.240.16.20,443,4874,4746878,1420,117058,3454,4629820,118.5955946,75.9547884,12329.22927,487639.5653,Benign
172.30.6.255,56730,157.240.16.39,443,28,5555,15,3410,13,2145,1216.399608,24.976733,1092.216504,687.0394138,Benign
192.168.43.233,50941,54.239.35.198,443,8,459,4,228,4,231,453.113256,13.209637,138.0810086,139.897864,Benign
10.0.2.15,36929,119.254.87.201,80,12,1656,7,779,5,877,15924.6637,3.863586,1613.009261,1815.929554,Malicious
10.0.2.15,58304,119.254.87.201,80,11,1582,6,705,5,877,7035.391107,0.842403,6695.132852,8328.555335,Malicious
172.30.6.255,57224,103.243.220.231,80,29,15658,15,8539,14,7119,2157.845679,41.48927,1646.497998,1372.692265,Benign
172.30.15.1180,50488,52.86.241.228,80,13,2148,7,1459,6,689,3464.492137,3.956642,2949.976268,1393.100513,Benign
192.168.215.49,48552,34.238.177.126,443,24,4086,12,2304,12,1782,620.0210185,5.931127791,3107.67204,2403.590093,Benign
10.0.2.15,44851,119.254.87.201,80,11,1513,6,705,5,808,20374.90068,1.637917,3443.397926,3946.47592,Malicious
172.30.15.1700,51011,184.29.25.7,443,94,72407,41,14806,53,57601,3609.722076,7.404218,15997.36799,62235.8769,Benign
10.0.2.15,52721,119.254.87.201,80,11,1582,6,705,5,877,18720.1173,1.355273,4161.523177,5176.816774,Malicious
10.0.2.15,39311,119.254.87.201,80,11,1587,6,705,5,882,19170.55719,1.661748,3394.016421,4246.131182,Malicious
192.168.43.224,54946,52.84.108.83,443,8,552,5,338,3,214,152.4854873,11.94687555,226.3353284,143.3010659,Benign
192.168.137.97,34430,172.217.161.3,443,17,2111,11,1547,6,564,325.4866486,30.44195126,406.544242,148.2165174,Benign
172.30.6.255,57610,103.243.221.87,80,7,394,4,228,3,166,3386.760862,15.303421,119.1890362,86.77798252,Benign
172.30.6.255,55900,157.240.16.39,443,20,2025,11,1217,9,808,118.090974,61.041304,159.4985585,105.8955097,Benign
172.30.6.255,57479,103.243.220.231,80,30,16073,15,8540,15,7533,3005.843044,36.186387,1888.002801,1665.377646,Benign
192.168.43.224,56074,117.18.237.66,443,31,8104,18,2751,13,5353,2462.541898,274.8414209,80.0752664,155.8134864,Benign
192.168.43.233,50708,157.240.16.16,443,45,7306,22,4883,23,2423,1843.322775,34.378192,1136.301758,563.8458241,Benign
172.30.15.2507,51841,14.139.45.128,80,10,1414,5,679,5,735,5475.873827,0.153781,35322.95927,38236.19303,Benign
192.168.43.224,59520,49.44.150.71,443,52,12957,29,7124,23,5833,53.63302618,463.9816946,122.8324321,100.5729332,Benign
10.0.2.15,40067,119.254.87.201,80,11,1582,6,705,5,877,20491.87902,1.619286,3483.016589,4332.773827,Malicious
172.30.6.255,56671,103.243.221.17,80,3,198,3,198,0,0,1132.868962,9.00443,175.9134115,0,Benign
172.30.6.255,56694,103.243.221.46,80,40,24283,23,20126,17,4157,1155.917847,13.675065,11773.838,2431.871439,Benign
172.30.1.136,50782,34.225.100.237,443,25,8660,12,1465,13,7195,1925.109201,68.609498,170.8218299,838.9508986,Benign
10.0.2.15,44886,119.254.87.201,80,11,1582,6,705,5,877,17758.95016,1.272257,4433.06659,5514.609077,Malicious
172.30.15.701,49988,35.187.209.245,443,9,546,6,360,3,186,2403.213012,13.082654,220.1388189,113.7383898,Benign
10.0.2.15,40617,119.254.87.201,80,12,1653,7,779,5,874,12320.62644,3.801864,1639.195931,1839.097874,Malicious
192.168.137.97,46610,172.217.161.14,443,7,466,4,272,3,194,1256.580311,55.51300101,39.19802498,27.95741487,Benign
172.30.15.2255,51572,104.121.244.70,443,43,25943,20,11247,23,14696,4486.376987,1.198818,75053.92812,98069.93222,Benign
172.30.15.400,49672,195.154.150.142,80,6,348,4,228,2,120,1486.34643,4.213479,432.896426,227.8402242,Benign
192.168.43.233,51667,54.255.158.169,443,15,1704,9,1129,6,575,870.211389,23.326842,387.1934315,197.1977175,Benign
192.168.43.233,51675,130.211.21.54,443,47,7680,23,3783,24,3897,894.525544,246.304789,122.8721541,126.5748836,Benign
10.0.2.15,54013,119.254.87.201,80,11,1593,6,705,5,888,312.747566,1.899139,2969.766826,3740.64247,Malicious
172.30.15.1714,51025,184.29.25.7,443,112,91418,44,18839,68,72579,3618.881389,8.199832,18379.88876,70810.23123,Benign
10.0.2.15,54231,119.254.87.201,80,11,1579,6,705,5,874,13254.13372,1.648,3422.330097,4242.718447,Malicious
10.0.2.15,40625,119.254.87.201,80,11,1561,6,705,5,856,5117.892956,1.874451,3008.881,3653.336364,Malicious
172.30.15.644,49931,50.17.52.222,443,179,127569,87,6605,92,120964,2395.341364,11.042153,4785.298664,87637.98147,Benign
192.168.43.233,50741,172.217.166.197,443,9,510,5,282,4,228,1871.634897,11.428216,197.4061393,159.6049637,Benign
172.30.15.895,50201,210.176.156.62,80,14,5184,8,3664,6,1520,3438.484708,8.685123,3374.966595,1400.095312,Benign
192.168.43.224,39682,54.243.243.77,443,124,60963,71,30455,53,30508,174.8463391,230.7529806,1055.847684,1057.685146,Benign
192.168.137.97,39742,192.168.125.6,80,11,1819,6,1008,5,811,8298.89271,3.682763132,2189.660239,1761.720688,Benign
172.30.6.255,55589,161.69.226.19,443,554,148853,339,110227,215,38626,2.61996,1039.879404,847.9983319,297.1575346,Benign
172.30.6.255,57203,103.243.221.75,80,22,10143,10,4270,12,5873,2087.8543,12.171772,2806.493582,3860.078878,Benign
172.30.15.992,50298,54.94.182.41,80,7,398,4,228,3,170,3442.926187,4.37951,416.4849492,310.5370235,Benign
10.0.2.15,39547,119.254.87.201,80,11,1558,6,705,5,853,11449.86742,1.427763,3950.235438,4779.504722,Malicious
172.30.15.2141,51453,151.101.130.2,443,26,13574,14,1450,12,12124,4178.624891,8.724946,1329.521123,11116.63041,Benign
192.168.43.224,40604,172.217.166.195,443,12,855,6,396,6,459,14.13548425,104.3673526,30.35431983,35.18341616,Benign
172.30.6.255,56000,103.243.221.75,80,23,15328,9,2893,14,12435,223.859783,14.182461,1631.87475,7014.297448,Benign
192.168.43.233,51280,13.107.42.254,443,9,566,5,318,4,248,2720.181776,125.724099,20.2347841,15.78058635,Benign
192.168.43.224,55250,52.35.44.197,443,13,898,7,478,6,420,110.7266651,64.28622732,59.48396974,52.26624956,Benign
192.168.43.224,42786,172.217.166.197,443,10,684,6,404,4,280,49.99491723,15.59631017,207.2285024,143.6237145,Benign
10.0.2.15,33812,119.254.87.201,80,11,1582,6,705,5,877,26469.17856,0.832432,6775.328195,8428.316067,Malicious
172.30.6.255,58364,172.217.167.42,443,40,6793,21,4156,19,2637,5472.745075,87.453563,380.1789071,241.2251631,Benign
192.168.43.233,51132,13.107.21.200,443,1,54,0,0,1,54,15.80257,0,0,0,Benign
192.168.43.224,35160,35.171.73.174,443,16,5004,9,1258,7,3746,1252.701813,27.10569747,371.2872547,1105.597819,Benign
172.30.6.255,57908,103.243.220.231,80,23,13912,10,5285,13,8627,4433.89374,13.168826,3210.6127,5240.862018,Benign
172.30.13.95,50866,172.30.6.255,139,3,198,3,198,0,0,3566.795306,8.984647,176.3007495,0,Benign
192.168.137.97,50936,104.237.191.1,443,48,8896,22,2799,26,6097,9128.518468,242.7811768,92.23120299,200.9051964,Benign
172.30.6.255,57114,157.240.16.39,443,27,5512,15,3419,12,2093,1826.097938,61.031971,448.1585561,274.3480134,Benign
172.30.15.1149,50457,87.248.118.22,443,20,7306,10,1195,10,6111,3458.537684,8.407446,1137.087291,5814.845555,Benign
192.168.137.97,39794,172.217.167.10,443,13,906,8,552,5,354,152.2190536,22.77318502,193.9122699,124.3567818,Benign
172.30.1.136,50549,157.240.16.20,443,15,4922,8,1025,7,3897,1461.545757,10.165601,806.641929,3066.813266,Benign
10.0.2.15,33681,119.254.87.201,80,12,1653,7,779,5,874,13584.56536,4.314032,1444.588265,1620.757565,Malicious
172.30.15.483,49758,172.217.166.196,443,22,5792,11,1374,11,4418,1732.172643,0.557555,19714.64699,63391.05559,Benign
10.0.2.15,44961,119.254.87.201,80,11,1579,6,705,5,874,21305.79003,2.483085,2271.368076,2815.852055,Malicious
172.30.6.255,57502,180.149.59.210,80,7,402,4,228,3,174,3058.10143,14.741155,123.7352161,94.42950705,Benign
192.168.215.49,46878,157.240.16.39,443,1287,824768,621,172385,666,652383,118.2550075,286.0125229,4821.746916,18247.67653,Benign
192.168.137.97,40528,103.102.166.224,443,13,931,5,342,8,589,19.32799312,133.8429489,20.44186879,35.20544069,Benign
10.0.2.15,52545,119.254.87.201,80,11,1579,6,705,5,874,3432.053577,1.622919,3475.219651,4308.286489,Malicious
172.30.1.136,51811,52.84.108.135,443,11,666,6,360,5,306,2983.898827,27.526885,104.6249875,88.9312394,Benign
192.168.43.224,49794,52.207.90.113,443,9,671,4,264,5,407,25.02740945,14.78484145,142.8490124,220.2255609,Benign
192.168.43.224,54890,52.206.154.207,443,29,4870,15,2689,14,2181,1916.312737,12.96218263,1659.597046,1346.069601,Benign
192.168.137.97,46218,13.228.212.129,443,6,412,4,272,2,140,346.5656443,17.19315252,126.5620134,65.14221278,Benign
172.30.6.255,57037,103.243.221.51,80,27,16885,11,4324,16,12561,1593.842879,16.524668,2093.355219,6081.090404,Benign
10.0.2.15,33155,119.254.87.201,80,10,981,6,725,4,256,18537.33622,135.765244,42.72080121,15.08486222,Malicious
192.168.43.224,60678,54.165.86.233,443,10,700,7,486,3,214,42.53995758,14.71908577,264.1468404,116.3115717,Benign
192.168.43.233,51111,34.224.183.150,443,7,402,4,228,3,174,918.992692,21.125166,86.34251679,65.89297334,Benign
192.168.137.97,59418,119.81.119.5,443,23,4254,13,3248,10,1006,3079.009434,1.781820086,14582.84156,4516.729867,Benign
172.30.6.255,55871,210.176.156.55,443,105,54573,58,32111,47,22462,105.471567,306.304363,838.6690855,586.6583102,Benign
172.30.15.1525,50833,52.221.3.46,443,20,7516,10,3070,10,4446,3526.666024,10.396004,2362.446186,3421.314574,Benign
10.0.2.15,57181,119.254.87.201,80,11,1582,6,705,5,877,18723.20315,2.3755,2374.237003,2953.483477,Malicious
172.30.6.255,56399,173.239.42.221,443,27,8279,14,1949,13,6330,650.888875,167.673601,92.99018991,302.0153423,Benign
192.168.137.97,55864,172.217.161.14,443,12,804,6,404,6,400,29.3962226,16.12646942,200.4158453,198.43153,Benign
10.0.2.15,39490,119.254.87.201,80,11,1579,6,705,5,874,11992.82499,1.414604,3986.981516,4942.726021,Malicious
192.168.43.233,51418,13.107.246.10,443,19,4992,8,1056,11,3936,3649.36785,122.829507,68.77826189,256.3553398,Benign
10.0.2.15,60266,119.254.87.201,80,11,1579,6,705,5,874,3552.096898,1.305355,4320.663727,5356.397302,Malicious
172.30.6.255,56890,52.221.7.77,80,14,4246,8,3134,6,1112,1384.566364,68.354772,366.7922409,130.1445348,Benign
172.30.15.1276,50584,54.169.236.196,80,6,535,4,228,2,307,3469.550092,7.958582,229.1865561,308.5976874,Benign
10.0.2.15,40428,119.254.87.201,80,11,1582,6,705,5,877,12593.47963,2.014821,2799.256113,3482.195193,Malicious
172.30.15.840,50143,34.232.42.95,443,18,4841,10,2636,8,2205,3240.18689,6.862292,3073.025747,2570.569716,Benign
172.30.15.1998,51310,184.29.26.27,443,16,5710,10,1219,6,4491,4077.54143,4.708017,2071.360405,7631.238375,Benign
192.168.215.49,48504,34.238.177.126,443,33,11349,16,2615,17,8734,612.2087937,5.882110232,3556.546745,11878.73012,Benign
172.30.15.2182,51494,31.24.224.56,443,7,402,4,228,3,174,4261.943333,6.305151,289.2872827,220.7718737,Benign
192.168.43.233,51166,52.70.107.220,443,14,1548,7,970,7,578,1010.006533,27.158044,285.7348637,170.2626301,Benign
192.168.43.233,50994,172.82.241.224,443,8,456,4,228,4,228,513.963629,13.807547,132.1016687,132.1016687,Benign
172.30.15.1851,51163,35.161.208.104,443,6,340,4,228,2,112,3887.99411,9.491498,192.1719838,94.40027275,Benign
172.30.1.136,50390,172.217.161.3,443,3,198,3,198,0,0,734.617696,9.002696,175.947294,0,Benign
10.0.2.15,48803,119.254.87.201,80,11,1513,6,705,5,808,13016.17825,2.303022,2448.956198,2806.746961,Malicious
172.30.15.2206,51520,111.221.29.253,443,32,8420,18,2184,14,6236,4405.057024,2.291691,7624.064501,21769.07794,Benign
172.30.6.255,56255,52.8.9.72,80,6,348,4,228,2,120,530.107591,37.273271,48.9358715,25.75572184,Benign
192.168.137.97,48602,23.57.214.252,443,14,1667,8,1080,6,587,122.5351952,10.65553073,810.846519,440.7100988,Benign
172.30.6.255,57412,103.243.221.109,80,27,17433,10,4552,17,12881,2769.888377,23.142972,1573.523055,4452.66926,Benign
172.30.1.136,51862,74.125.24.188,5228,2,132,2,132,0,0,4164.539754,3.000192,351.9774734,0,Benign
172.30.15.1217,50525,173.241.248.220,80,9,1921,6,1443,3,478,3467.150643,10.47313,1102.24928,365.1248481,Benign
10.0.2.15,57830,119.254.87.201,80,12,1656,7,779,5,877,10851.68801,7.695498,809.8241335,911.7018808,Malicious
10.0.2.15,53746,119.254.87.201,80,11,1579,6,705,5,874,22411.57959,1.125978,5008.978861,6209.712801,Malicious
172.30.6.255,58117,54.194.27.245,443,22,8301,11,2824,11,5477,4893.328778,5.754904,3925.695372,7613.680437,Benign
172.30.6.255,57657,157.240.16.39,443,19,1933,10,1125,9,808,3534.09047,61.070603,147.3704132,105.8447057,Benign
172.30.1.136,50629,52.214.173.82,443,33,13015,17,2402,16,10613,1714.762509,21.801933,881.3897373,3894.33359,Benign
10.0.2.15,55655,119.254.87.201,80,11,1582,6,705,5,877,17486.41614,2.619426,2153.143475,2678.449401,Malicious
172.30.15.1911,51223,34.255.159.221,443,6,348,4,228,2,120,3985.063432,2.385943,764.4776091,402.3566363,Benign
10.0.2.15,47306,119.254.87.201,80,11,1513,6,705,5,808,22203.84182,1.48296,3803.204402,4358.849868,Malicious
172.30.6.255,55695,103.243.221.87,80,43,45057,9,4217,34,40840,53.188656,0.752604,44825.69851,434119.4041,Benign
10.0.2.15,53891,119.254.87.201,80,11,1582,6,705,5,877,17191.27935,1.183055,4767.31851,5930.408984,Malicious
172.30.6.255,56407,172.217.166.197,443,17,1779,10,1150,7,629,665.456076,164.750374,55.84205836,30.54317801,Benign
172.30.15.1176,50484,107.6.122.24,443,16,4805,9,1153,7,3652,3464.378358,2.844227,3243.060417,10272.03525,Benign
172.30.15.227,49496,172.217.166.197,443,193,127085,76,7640,117,119445,46.83803,2.620887,23320.34918,364594.1241,Benign
172.30.6.255,57261,52.84.110.11,443,8,480,5,294,3,186,2252.377992,18.489783,127.2053869,80.47687742,Benign
172.30.6.255,56655,103.243.221.17,80,13,6834,8,5172,5,1662,1090.866624,1.725009,23985.96181,7707.785872,Benign
192.168.137.97,33460,52.94.216.31,443,16,2050,11,1748,5,302,3739.953794,61.42914764,227.6443763,39.32986364,Benign
192.168.215.49,38318,158.85.224.176,443,30,8012,15,3060,15,4952,1230.823528,1.236408919,19799.27484,32041.17941,Benign
10.0.2.15,35339,119.254.87.201,80,11,1582,6,705,5,877,24248.98741,1.220372,4621.541628,5749.066678,Malicious
172.30.6.255,55831,103.231.98.48,80,44,23861,21,18384,23,5477,91.549448,74.373342,1977.482738,589.1358223,Benign
192.168.137.97,45534,185.199.108.153,80,10,700,7,486,3,214,19.80634695,15.18852866,255.9826621,112.7166455,Benign
172.30.15.2079,51391,34.205.118.138,443,32,5703,17,3377,15,2326,4122.828144,4.769894,5663.85752,3901.13491,Benign
192.168.43.233,51251,151.101.153.176,443,86,20026,41,4074,45,15952,1931.074461,604.342257,53.9297056,211.1651114,Benign
192.168.43.224,59528,49.44.150.71,443,52,12954,29,7113,23,5841,53.65382122,463.9685266,122.6462502,100.713728,Benign
172.30.15.694,49981,54.248.216.124,443,15,2683,8,1497,7,1186,2402.409654,3.909064,3063.648996,2427.179499,Benign
172.30.15.1877,51189,54.86.233.56,443,75,28578,37,4563,38,24015,3965.294979,12.176908,2997.805354,15777.40425,Benign
172.30.15.1865,51177,54.201.241.25,443,21,8165,11,2238,10,5927,3929.874909,7.67783,2331.908886,6175.703291,Benign
172.30.6.255,56067,184.29.25.121,80,14,1586,8,920,6,666,286.54469,125.078701,58.84295201,42.59718047,Benign
192.168.43.233,51217,52.175.28.154,443,58,30362,34,16479,24,13883,1247.383657,121.890639,1081.559676,911.1774367,Benign
172.30.15.931,50237,103.229.205.253,80,13,3514,8,2324,5,1190,3440.953026,6.288238,2956.631094,1513.937609,Benign
192.168.43.233,51037,163.53.79.200,443,17,6927,9,1173,8,5754,820.077337,18.221695,514.9905099,2526.219432,Benign
172.30.6.255,57080,172.217.166.206,443,17,1783,10,1154,7,629,1684.439514,135.741575,68.01158746,37.07044065,Benign
172.30.15.1024,50330,203.174.85.189,80,13,4127,7,3395,6,732,3446.661549,0.50833,53429.85856,11520.07554,Benign
172.30.15.490,49768,172.217.166.212,443,32,6677,16,1915,16,4762,1833.857298,1.931218,7932.817528,19726.411,Benign
172.30.15.902,50208,173.241.248.220,80,18,8651,9,1931,9,6720,3438.519985,8.719979,1771.563899,6165.152462,Benign
172.30.15.1082,50388,217.182.174.173,80,12,1398,7,927,5,471,3452.817074,1.307652,5671.233631,2881.500583,Benign
10.0.2.15,43289,119.254.87.201,80,11,1552,6,705,5,847,8841.81329,1.873771,3009.972937,3616.236989,Malicious
192.168.43.224,41040,172.217.166.202,443,76,15548,37,6769,39,8779,26.90497267,253.1271373,213.9320208,277.4574104,Benign
192.168.137.97,58588,223.165.30.126,443,46,10273,24,2884,22,7389,1.210942516,315.7457083,73.07146034,187.2139461,Benign
192.168.43.233,51040,49.44.170.2,443,44,16148,20,2443,24,13705,820.549452,318.477874,61.36690048,344.2625342,Benign
172.30.15.2353,51687,192.168.121.37,443,8,480,5,294,3,186,5321.724087,6.12786,383.8207792,242.8253909,Benign
172.30.15.391,49659,62.210.213.13,80,33,21518,14,1538,19,19980,1466.486278,4.02236,3058.900745,39737.86533,Benign
172.30.15.1248,50556,50.31.185.52,443,12,1412,6,904,6,508,3469.516759,7.832565,923.3246069,518.859403,Benign
192.168.43.233,51369,204.79.197.229,443,46,14549,24,2168,22,12381,3201.964513,6.521191,2659.636867,15188.63655,Benign
192.168.43.224,56882,117.18.237.70,443,17,5983,9,1245,8,4738,32.62605434,11.32301348,879.6244934,3347.518755,Benign
192.168.43.224,35222,205.185.216.10,443,32,9651,18,2875,14,6776,94.3240454,12.37432667,1858.686991,4380.6828,Benign
10.0.2.15,59682,119.254.87.201,80,11,1582,6,705,5,877,14092.71076,1.941216,2905.395381,3614.229431,Malicious
10.0.2.15,34449,119.254.87.201,80,11,1513,6,705,5,808,17278.33296,1.488349,3789.433795,4343.067385,Malicious
10.0.2.15,47373,119.254.87.201,80,11,1582,6,705,5,877,25024.45818,1.051555,5363.485505,6672.023812,Malicious
172.30.15.1051,50357,52.84.112.65,80,24,16721,9,919,15,15802,3448.441608,8.663179,848.6492083,14592.33383,Benign
192.168.43.233,50935,52.94.220.16,443,10,560,5,282,5,278,441.200289,12.974025,173.8858989,171.4194323,Benign
10.0.2.15,54242,119.254.87.201,80,11,1582,6,705,5,877,3822.348948,1.224589,4605.626867,5729.269167,Malicious
172.30.1.136,50669,172.217.161.3,443,54,17606,30,4620,24,12986,1798.346119,26.041426,1419.277116,3989.336068,Benign
10.0.2.15,42227,119.254.87.201,80,11,1579,6,705,5,874,25990.99986,0.933167,6043.934258,7492.763889,Malicious
172.30.6.255,55801,104.36.113.23,80,7,402,4,228,3,174,89.685962,12.477537,146.1826962,111.5604786,Benign
10.0.2.15,36756,119.254.87.201,80,11,1579,6,705,5,874,20645.17207,1.491751,3780.791835,4687.10931,Malicious
172.30.15.1853,51165,52.6.46.142,443,37,9436,20,4473,17,4963,3898.333857,19.096084,1873.89205,2079.16974,Benign
192.168.215.49,49872,103.229.206.182,443,38,9192,20,3762,18,5430,613.1261509,366.8017324,82.04977606,118.4291026,Benign
172.30.15.683,49970,23.23.150.12,80,22,11407,13,5032,9,6375,2398.672062,7.710181,5221.148505,6614.630707,Benign
172.30.6.255,56445,35.168.107.25,80,13,1577,7,794,6,783,700.729649,62.369525,101.8446108,100.4336653,Benign
172.30.15.960,50266,159.127.41.169,443,20,8060,10,1717,10,6343,3442.177565,1.559309,8809.030154,32542.61984,Benign
172.30.15.1884,51196,52.84.108.203,443,8,480,5,294,3,186,3967.675049,9.616464,244.5805444,154.7346301,Benign
172.30.15.731,50018,104.31.90.207,80,12,2646,7,1908,5,738,2439.907186,6.33523,2409.383716,931.9314374,Benign
172.30.1.136,50551,157.240.16.20,443,92,36392,43,5818,49,30574,1462.152997,82.029842,567.4032628,2981.744132,Benign
172.30.15.1020,50326,173.241.248.143,80,6,535,4,228,2,307,3445.5648,1.676267,1088.132141,1465.160383,Benign
172.30.15.2007,51319,52.84.110.163,443,19,7543,10,1207,9,6336,4079.559512,2.688968,3590.968729,18850.35449,Benign
10.0.2.15,46723,119.254.87.201,80,11,1513,6,705,5,808,19831.4726,1.247537,4520.907997,5181.409449,Malicious
172.30.6.255,57867,172.217.166.206,443,17,1779,10,1150,7,629,4241.40638,86.007263,106.9677104,58.50668681,Benign
172.30.1.136,50416,52.84.103.186,443,17,2054,10,1157,7,897,827.397663,2.700827,3427.098441,2656.96396,Benign
10.0.2.15,50493,119.254.87.201,80,11,1582,6,705,5,877,26261.31607,1.488167,3789.897236,4714.524647,Malicious
172.30.6.255,56443,54.251.174.92,80,13,2140,7,1216,6,924,700.568905,61.3786,158.4917219,120.4328544,Benign
10.0.2.15,39417,119.254.87.201,80,11,1582,6,705,5,877,6975.331938,1.42722,3951.738344,4915.850394,Malicious
172.30.1.136,50194,172.217.161.14,443,25,6811,14,1450,11,5361,357.848765,17.598816,659.1352509,2436.982124,Benign
172.30.15.2396,51730,14.139.45.128,80,313,269322,127,7827,186,261495,5340.500338,2.94596,21254.87108,710111.4747,Benign
10.0.2.15,59213,119.254.87.201,80,11,1579,6,705,5,874,22982.22374,2.222978,2537.13712,3145.330273,Malicious
172.30.6.255,58171,157.240.16.39,443,19,1933,11,1179,8,754,4998.096413,61.280965,153.9140253,98.43187032,Benign
192.168.43.224,39012,103.37.200.184,443,453,343423,217,16700,236,326723,2458.226602,58.01794373,2302.735868,45051.30365,Benign
10.0.2.15,39521,119.254.87.201,80,11,1582,6,705,5,877,5928.85073,1.720823,3277.501521,4077.118913,Malicious
10.0.2.15,44236,119.254.87.201,80,11,1579,6,705,5,874,5864.212546,1.631131,3457.723506,4286.596233,Malicious
192.168.215.49,58542,104.113.234.195,443,38,13922,20,4674,18,9248,480.1246242,143.0563411,261.3795356,517.1668689,Benign
10.0.2.15,50025,119.254.87.201,80,11,1582,6,705,5,877,3826.468722,1.353913,4165.703409,5182.016865,Malicious
172.30.6.255,55908,72.251.245.181,80,9,534,5,294,4,240,121.805833,30.189905,77.90683674,63.59741775,Benign
192.168.43.224,48032,151.101.153.177,443,26,10095,14,2071,12,8024,65.96267218,13.84633739,1196.561916,4636.027434,Benign
10.0.2.15,39267,119.254.87.201,80,11,1582,6,705,5,877,17611.81046,1.409506,4001.40191,4977.630461,Malicious
192.168.43.224,37796,4.31.198.61,443,9,618,5,338,4,280,744.6151478,59.18300423,45.6887925,37.84870385,Benign
192.168.215.49,43698,52.33.0.53,443,6,412,4,272,2,140,510.9107196,19.73473959,110.2624127,56.7527124,Benign
192.168.43.224,51336,209.167.231.17,443,32,3865,16,2252,16,1613,107.7348944,304.7437853,59.11851486,42.34376753,Benign
172.30.15.1718,51029,184.29.25.7,443,18,4556,9,3555,9,1001,3618.892276,8.188795,3473.038463,977.92166,Benign
172.30.1.136,50163,180.149.59.201,80,57,58925,14,1138,43,57787,154.039841,1.446096,6295.570972,319685.5534,Benign
192.168.137.97,45822,54.251.174.92,443,6,412,4,272,2,140,375.0109927,15.81035515,137.6313169,70.8396484,Benign
10.0.2.15,59275,119.254.87.201,80,12,1587,7,779,5,808,16527.63249,4.876614,1277.935879,1325.509872,Malicious
172.30.6.255,57600,172.217.166.226,80,37,19037,16,1328,21,17709,3362.336111,255.555339,41.57220914,554.3691654,Benign
172.30.6.255,56575,173.241.248.220,80,8,669,6,337,2,332,888.1266,63.70193,42.32210861,41.69418415,Benign
172.30.15.1187,50495,151.101.130.49,80,12,1677,6,955,6,722,3465.127358,1.407309,5428.80064,4104.286976,Benign
172.30.15.1465,50773,103.231.98.244,443,8,973,5,799,3,174,3506.111701,0.382542,16709.27637,3638.81613,Benign
192.168.215.49,34182,52.86.98.206,443,41,8511,19,3252,22,5259,1220.699804,301.4111247,86.31400061,139.5834346,Benign
172.30.6.255,56956,184.29.26.182,443,36,9303,20,4794,16,4509,1390.043581,305.776604,125.4249001,117.9684761,Benign
10.0.2.15,49241,119.254.87.201,80,11,1579,6,705,5,874,22717.47562,3.415036,1651.519925,2047.416191,Malicious
192.168.43.224,44524,35.176.197.116,443,7,478,4,272,3,206,1904.863781,11.54395198,188.4969727,142.7587367,Benign
10.0.2.15,53652,119.254.87.201,80,11,1579,6,705,5,874,25210.03353,2.149414,2623.970999,3252.979649,Malicious
192.168.43.233,51406,151.101.152.223,443,19,6117,8,1054,11,5063,3646.579726,0.440456,19143.79643,91959.24224,Benign
172.30.15.2183,51495,77.88.21.119,443,387,278952,196,266646,191,12306,4271.592888,6.130802,347942.7325,16057.93174,Benign
172.30.15.1757,51069,184.29.25.7,443,46,31230,20,8866,26,22364,3638.240309,8.928387,7944.100093,20038.55792,Benign
192.168.43.224,35360,54.152.213.221,443,30,9107,17,2584,13,6523,3249.162384,18.51844231,1116.292594,2817.947596,Benign
10.0.2.15,49386,119.254.87.201,80,11,1582,6,705,5,877,5386.196924,0.887611,6354.134863,7904.363511,Malicious
192.168.43.233,51278,13.107.54.254,443,39,14956,21,2726,18,12230,2718.651387,183.171536,119.0577995,534.144126,Benign
10.0.2.15,43923,119.254.87.201,80,12,1608,7,779,5,829,24276.53174,3.861829,1613.743125,1717.32099,Malicious
172.30.6.255,57786,172.30.13.95,7680,3,198,3,198,0,0,4010.382722,9.005214,175.8980964,0,Benign
10.0.2.15,34723,119.254.87.201,80,11,1579,6,705,5,874,22206.8341,0.817729,6897.150523,8550.51001,Malicious
172.30.1.136,50305,172.217.161.14,443,225,78116,96,35893,129,42223,517.922033,98.227366,2923.258677,3438.79729,Benign
172.30.6.255,55938,52.23.112.47,80,6,348,4,228,2,120,152.489593,10.576943,172.4505843,90.7634654,Benign
172.30.1.136,51516,172.217.161.14,443,64,14714,29,6976,35,7738,9.569802,241.445448,231.141239,256.3891782,Benign
172.30.6.255,56945,103.15.158.129,80,12,5805,7,3187,5,2618,1388.349489,10.254345,2486.36066,2042.451273,Benign
172.30.6.255,56195,54.169.126.196,80,6,348,4,228,2,120,466.860209,24.070089,75.77869779,39.88352515,Benign
192.168.215.49,55828,104.197.3.80,80,10,911,5,425,5,486,562.79271,0.77706693,4375.427481,5003.430013,Benign
172.30.15.445,49719,66.117.24.115,443,27,9510,12,3280,15,6230,1632.079151,8.606814,3048.74719,5790.760669,Benign
192.168.43.233,51467,54.81.94.76,80,11,655,6,349,5,306,3816.109115,76.348466,36.56916958,32.06351258,Benign
192.168.43.224,41718,34.232.42.95,443,48,16241,27,8370,21,7871,28.81548404,81.85452454,818.0366373,769.267189,Benign
172.30.15.2392,51726,14.139.45.128,80,33,25599,13,1079,20,24520,5339.901489,0.204117,42289.47123,961017.4557,Benign
192.168.42.240,50993,216.58.221.46,443,40,11325,20,4289,20,7036,331.541335,39.599794,866.4691539,1421.421536,Benign
172.30.15.2362,51696,104.19.199.151,443,35,10920,17,1993,18,8927,5332.796697,5.588625,2852.937887,12778.81411,Benign
192.168.43.224,59396,74.125.24.188,5228,23,6892,13,1660,10,5232,5.938097767,1.496372693,8874.794403,27971.64115,Benign
172.30.6.255,58217,54.194.27.245,443,22,7159,12,1856,10,5303,5157.390337,6.712771,2211.903251,6319.893826,Benign
192.168.43.224,42496,49.44.90.18,443,18,5243,10,1261,8,3982,36.84104574,13.03859802,773.7028158,2443.207464,Benign
10.0.2.15,49708,119.254.87.201,80,11,1579,6,705,5,874,4066.723991,1.358106,4152.842267,5148.3463,Malicious
172.30.6.255,58337,210.176.156.21,80,15,5549,8,3971,7,1578,5419.839548,9.29707,3416.990514,1357.84715,Benign
172.30.6.255,58412,103.243.221.51,80,25,11486,14,9327,11,2159,5551.098593,0.878957,84891.52484,19650.56311,Benign
172.30.1.136,51894,13.107.4.52,80,11,1739,6,644,5,1095,4691.061151,0.564868,9120.714928,15508.0479,Benign
10.0.2.15,53807,119.254.87.201,80,11,1579,6,705,5,874,5383.864976,2.464578,2288.424225,2836.996841,Malicious
192.168.43.233,51249,13.107.21.200,443,53,14300,28,4543,25,9757,2196.701215,61.294806,592.9376789,1273.452109,Benign
192.168.137.97,44476,172.217.161.10,443,35,7469,18,3037,17,4432,9323.73063,241.067888,100.7848876,147.0789009,Benign
192.168.43.233,50864,172.217.166.206,443,3,162,2,108,1,54,3.006518,0.124988,6912.663616,3456.331808,Benign
172.30.6.255,56692,210.176.156.41,80,14,5511,8,3958,6,1553,1155.905592,3.60284,8788.622309,3448.390714,Benign
192.168.43.224,38250,140.98.193.112,443,48,26799,25,4895,23,21904,2297.343612,5.80315609,6748.052162,30195.98255,Benign
172.30.1.136,50414,74.125.24.188,5228,17,942,9,498,8,444,827.347419,27.577042,144.4679962,128.8027918,Benign
172.30.15.2473,51807,14.139.45.128,80,10,1391,5,655,5,736,5423.912008,0.370453,14144.84429,15894.05404,Benign
172.30.15.1898,51210,23.57.219.27,80,12,3028,7,637,5,2391,3983.706276,117.737143,43.28285765,162.4635991,Benign
172.30.15.260,49523,172.217.166.197,443,47,12593,22,5429,25,7164,85.411558,4.096515,10602.18259,13990.42845,Benign
172.30.6.255,57438,103.243.221.109,80,20,10614,10,4552,10,6062,2829.859094,31.171914,1168.23112,1555.759457,Benign
172.30.15.1043,50349,210.176.156.55,443,41,23882,23,18203,18,5679,3447.681195,9.538684,15266.6762,4762.921174,Benign
172.30.15.2360,51694,14.139.45.128,80,27,18566,10,924,17,17642,5332.709495,0.262441,28166.33072,537781.8252,Benign
10.0.2.15,39872,119.254.87.201,80,11,1579,6,705,5,874,25778.33749,5.112601,1103.156691,1367.601344,Malicious
172.30.1.136,50162,180.149.59.201,80,22,19525,6,505,16,19020,153.609072,0.229762,17583.4124,662250.5027,Benign
10.0.2.15,47368,119.254.87.201,80,11,1582,6,705,5,877,14753.44593,1.489378,3786.815704,4710.691309,Malicious
172.30.15.2526,51860,46.105.202.39,443,51,25773,27,2673,24,23100,5491.440147,6.565571,3256.990138,28146.82836,Benign
10.0.2.15,52763,119.254.87.201,80,11,1582,6,705,5,877,13824.72979,1.884065,2993.527293,3723.86303,Malicious
172.30.15.2100,51412,64.74.232.52,443,8,468,5,294,3,174,4146.107365,11.613869,202.5164913,119.8566989,Benign
172.30.15.409,49681,192.168.121.7,443,28,11151,14,2514,14,8637,1542.107436,8.328188,2414.931075,8296.642679,Benign
192.168.137.97,48488,104.244.46.7,443,18,5881,11,1341,7,4540,1747.905055,1.323951767,8103.014224,27433.02355,Benign
172.30.15.1199,50507,50.116.239.135,80,6,531,4,228,2,303,3465.378959,1.880809,969.7954444,1288.807104,Benign
172.30.15.1291,50599,103.243.220.231,80,11,3209,6,2133,5,1076,3471.108793,0.925074,18446.09188,9305.20153,Benign
10.0.2.15,53161,119.254.87.201,80,11,1579,6,705,5,874,18627.51047,3.710969,1519.818678,1884.144007,Malicious
192.168.137.97,50342,104.237.191.1,443,12,816,7,470,5,346,3585.372297,120.8179694,31.12119844,22.91049928,Benign
172.30.6.255,57119,111.221.29.253,443,24,6067,14,1455,10,4612,1856.127377,108.737142,107.0471394,339.3136818,Benign
10.0.2.15,37465,119.254.87.201,80,11,1513,6,705,5,808,25598.10195,0.952141,5923.492424,6788.910466,Malicious
172.30.1.136,51870,52.84.110.171,443,37,6957,19,4895,18,2062,4182.110992,160.714514,243.6618761,102.641632,Benign
172.30.15.398,49670,195.154.150.142,80,14,3446,7,1042,7,2404,1483.412578,3.086068,2701.171847,6231.878235,Benign
10.0.2.15,43059,119.254.87.201,80,11,1579,6,705,5,874,24817.22357,1.108303,5088.861079,6308.744089,Malicious
172.30.15.1666,50977,184.29.25.7,443,12,1423,6,904,6,519,3590.878299,6.479928,1116.061783,640.7478602,Benign
192.168.137.97,47522,172.217.166.206,443,9,606,5,338,4,268,1231.456439,56.84736669,47.56596756,37.71502754,Benign
172.30.6.255,57186,103.243.221.75,80,15,5426,9,4245,6,1181,2043.863075,29.167013,1164.329032,323.9275822,Benign
172.30.1.136,51842,74.125.24.188,5228,36,3826,18,2304,18,1522,3484.636841,348.877224,52.83233967,34.90052994,Benign
10.0.2.15,54944,119.254.87.201,80,11,1579,6,705,5,874,2170.457207,1.427238,3951.688506,4898.972701,Malicious
192.168.43.233,51489,216.58.196.194,443,9,535,5,295,4,240,3818.892779,58.188494,40.55784637,32.99621399,Benign
172.30.15.1828,51140,104.16.120.145,443,15,5566,8,1066,7,4500,3864.05218,0.142858,59695.64183,251998.488,Benign
172.30.15.1234,50542,202.131.200.84,80,10,1261,5,736,5,525,3468.555804,1.189827,4948.618581,3529.924939,Benign
172.30.6.255,57508,161.69.38.37,80,7,398,4,228,3,170,3067.73794,0.547604,3330.874135,2483.546504,Benign
10.0.2.15,51671,119.254.87.201,80,11,1579,6,705,5,874,7485.715597,0.888324,6349.034812,7871.002022,Malicious
192.168.137.97,52112,172.217.161.3,443,23,6236,13,1657,10,4579,8269.268156,19.04377492,696.0804806,1923.568208,Benign
172.30.15.517,49800,162.247.242.19,443,24,6638,12,2808,12,3830,2118.412901,7.773054,2889.983782,3941.822609,Benign
172.30.15.1864,51176,52.6.46.142,443,6,348,4,228,2,120,3923.590273,3.85216,473.5005815,249.2108324,Benign
192.168.137.97,51622,104.244.42.195,443,33,8393,18,3041,15,5352,38.01758933,151.0490703,161.0602432,283.457554,Benign
10.0.2.15,48507,119.254.87.201,80,11,1579,6,705,5,874,6404.708483,2.086469,2703.131463,3351.116168,Malicious
172.30.6.255,56493,103.243.221.109,80,96,72636,58,63334,38,9302,818.0831,26.991967,18771.21441,2756.968397,Benign
172.30.6.255,57064,103.243.221.17,80,27,17368,11,4606,16,12762,1679.858972,16.132697,2284.05703,6328.514073,Benign
172.30.1.136,50131,104.17.39.113,443,7,402,4,228,3,174,112.712801,19.512935,93.47645549,71.33729498,Benign
172.30.1.136,50583,172.217.161.3,443,51,8212,25,3077,26,5135,1593.913516,201.572256,122.1199806,203.7978877,Benign
172.30.15.1882,51194,52.84.110.171,443,8,480,5,294,3,186,3967.463273,9.828357,239.3075465,151.3986519,Benign
192.168.215.49,52768,34.196.177.243,443,200,25410,113,10902,87,14508,2046.209704,35.88648664,2430.329858,3234.197907,Benign
10.0.2.15,54887,119.254.87.201,80,11,1579,6,705,5,874,13764.66895,2.089464,2699.256843,3346.312739,Malicious
10.0.2.15,39065,119.254.87.201,80,11,1582,6,705,5,877,1029.129333,1.822946,3093.893072,3848.715212,Malicious
192.168.43.233,51023,117.18.232.102,443,7,402,4,228,3,174,736.760704,43.575961,41.8579409,31.94421805,Benign
172.30.15.854,50159,204.79.197.200,443,877,740215,305,28726,572,711489,3404.468485,12.455245,18450.70089,456989.164,Benign
192.168.43.224,40150,104.16.44.54,80,7,410,4,236,3,174,1174.339105,60.77474698,31.06553451,22.90425002,Benign
192.168.43.233,51465,35.177.238.167,80,7,402,4,228,3,174,3815.772363,13.930593,130.9348425,99.92395873,Benign
192.168.43.224,43408,172.217.161.14,443,19,6016,10,1443,9,4573,2894.859827,14.16384155,815.033122,2582.915084,Benign
172.30.15.867,50173,180.149.59.136,80,86,73948,33,2689,53,71259,3434.520673,12.452284,1727.554559,45780.51705,Benign
172.30.15.2338,51672,34.232.42.95,443,6,348,4,228,2,120,5220.844326,7.221475,252.5799785,132.9368308,Benign
10.0.2.15,54566,119.254.87.201,80,11,1582,6,705,5,877,1211.751377,1.62707,3466.35363,4312.045579,Malicious
10.0.2.15,40922,119.254.87.201,80,11,1579,6,705,5,874,9742.928493,1.893315,2978.902084,3692.993506,Malicious
192.168.43.233,51322,151.101.154.109,443,9,534,5,294,4,240,3365.295614,15.264662,154.0813678,125.7807084,Benign
192.168.43.224,49182,172.217.166.234,80,65,34669,33,2581,32,32088,804.297804,269.5164316,76.61128442,952.4614082,Benign
172.30.6.255,57389,103.243.221.17,80,24,13815,10,5275,14,8540,2664.880692,17.232914,2448.802333,3964.506525,Benign
172.30.15.775,50067,34.200.202.18,443,142,101903,69,7652,73,94251,2657.619594,8.827651,6934.574101,85414.34182,Benign
172.30.15.1395,50703,172.30.30.101,7680,3,198,3,198,0,0,3497.976834,8.985221,176.2894869,0,Benign
192.168.43.233,51309,52.84.110.71,443,28,2503,15,1445,13,1058,3031.203016,255.806131,45.19047278,33.08755723,Benign
10.0.2.15,41623,119.254.87.201,80,11,1579,6,705,5,874,22321.46565,1.030825,5471.345767,6782.916596,Malicious
10.0.2.15,50133,119.254.87.201,80,11,1579,6,705,5,874,19618.49401,1.427283,3951.563916,4898.818244,Malicious
172.30.6.255,57350,157.240.16.39,443,28,5555,15,3409,13,2146,2497.08912,61.022746,446.9153191,281.3377163,Benign
192.168.215.49,48562,54.209.180.26,443,14,1660,8,1080,6,580,481.2926954,27.74114221,311.4507664,167.2605968,Benign
172.30.15.2000,51312,52.84.108.11,443,49,32940,23,2497,26,30443,4078.386619,3.924242,5090.409817,62061.41211,Benign
10.0.2.15,40398,119.254.87.201,80,11,1579,6,705,5,874,18657.56164,1.687494,3342.234106,4143.42214,Malicious
172.30.6.255,58467,216.58.196.162,80,38,11286,22,6432,16,4854,5672.9081,6.176147,8331.407915,6287.415115,Benign
192.168.43.233,51163,182.161.72.94,443,4,240,2,120,2,120,951.652827,10.912301,87.97411288,87.97411288,Benign
10.0.2.15,46388,119.254.87.201,80,11,1579,6,705,5,874,20909.80105,4.389988,1284.741553,1592.71506,Malicious
10.0.2.15,45512,119.254.87.201,80,11,1513,6,705,5,808,7730.707569,2.025936,2783.898405,3190.623988,Malicious
10.0.2.15,46982,119.254.87.201,80,11,1579,6,705,5,874,17216.15369,2.217275,2543.662829,3153.420302,Malicious
10.0.2.15,44528,119.254.87.201,80,11,1582,6,705,5,877,4096.753091,1.878707,3002.064718,3734.483344,Malicious
192.168.43.224,41936,23.251.156.28,443,8,544,5,338,3,206,945.0113289,57.54414902,46.99000761,28.63888038,Benign
192.168.43.224,50946,172.217.166.205,443,24,8743,13,1677,11,7066,10.59156682,4.779373656,2807.062382,11827.49123,Benign
10.0.2.15,49154,119.254.87.201,80,11,1579,6,705,5,874,9292.318171,1.954352,2885.867029,3577.65643,Malicious
172.30.15.1110,50418,50.31.185.52,443,12,1412,7,958,5,454,3458.269324,8.67684,883.2708682,418.585568,Benign
10.0.2.15,44713,119.254.87.201,80,11,1579,6,705,5,874,13644.52942,2.214239,2547.150511,3157.744038,Malicious
10.0.2.15,39728,119.254.87.201,80,11,1582,6,705,5,877,25900.9384,0.8295,6799.276673,8458.107294,Malicious
192.168.43.224,48264,104.237.191.1,443,37,5883,19,3267,18,2616,1680.662861,48.159873,542.692461,434.552641,Benign
172.30.1.136,50417,52.84.103.186,443,14,1798,7,970,7,828,827.398281,1.940609,3998.744724,3413.361476,Benign
192.168.137.97,33600,172.217.161.5,443,106,53188,54,7295,52,45893,7120.385038,244.6767882,238.5187431,1500.526481,Benign
192.168.42.240,50990,216.58.221.46,443,33,5154,17,3714,16,1440,325.431162,45.518621,652.7438518,253.0832382,Benign
10.0.2.15,51289,119.254.87.201,80,11,1579,6,705,5,874,9622.716831,1.834295,3074.75079,3811.81871,Malicious
192.168.215.49,33258,54.87.224.116,443,28,7655,15,2981,13,4674,1523.119011,10.4698921,2277.769415,3571.383511,Benign
192.168.137.97,57356,104.244.42.200,443,125,19737,65,8932,60,10805,147.1543769,1130.925221,63.18366474,76.43299345,Benign
192.168.43.224,41712,34.226.175.200,443,30,9193,16,4387,14,4806,303.9579952,38.51651189,911.1936226,998.2212332,Benign
172.30.15.2223,51538,184.29.25.145,443,22,8958,12,2228,10,6730,4444.840264,2.751407,6478.140093,19568.17003,Benign
172.30.6.255,56066,103.71.26.126,80,8,1499,4,702,4,797,286.544361,35.231148,159.4043998,180.9762202,Benign
192.168.43.233,50698,13.107.4.52,80,10,1476,5,393,5,1083,1838.231658,0.263976,11910.17365,32821.16556,Benign
192.168.43.233,51235,188.138.1.175,2004,674,89573,323,31585,351,57988,1537.699694,358.655149,704.5207652,1293.454175,Benign
172.30.15.971,50277,104.122.118.96,80,10,1542,6,812,4,730,3442.439282,4.568452,1421.925851,1278.332354,Benign
192.168.137.97,56616,172.217.161.14,443,15,1034,9,618,6,416,2478.817182,58.97024583,83.83889078,56.4352404,Benign
172.30.6.255,56064,103.15.158.128,443,22,9387,11,3094,11,6293,286.389657,10.317192,2399.102391,4879.622285,Benign
10.0.2.15,40502,119.254.87.201,80,11,1579,6,705,5,874,3135.708131,1.286537,4383.861482,5434.74459,Malicious
172.30.15.1403,50711,35.186.239.238,443,35,10263,17,2254,18,8009,3499.851089,7.163372,2517.250256,8944.390994,Benign
172.30.6.255,57420,103.243.221.17,80,6,340,4,228,2,112,2771.247939,21.783182,83.73432311,41.13264995,Benign
10.0.2.15,59260,119.254.87.201,80,11,1582,6,705,5,877,13431.90185,1.024957,5502.669868,6845.165212,Malicious
172.30.6.255,56259,151.101.128.166,80,6,348,4,228,2,120,529.952783,36.28399,50.27010536,26.45795019,Benign
192.168.137.97,50872,103.211.218.251,443,714,628148,281,23347,433,604801,593.6561198,9.242160685,20209.1271,523514.8105,Benign
10.0.2.15,39047,119.254.87.201,80,11,1582,6,705,5,877,10914.26424,1.792594,3146.278522,3913.881225,Malicious
10.0.2.15,34457,119.254.87.201,80,11,1579,6,705,5,874,19741.32314,2.365965,2383.805339,2955.242364,Malicious
192.168.43.233,51328,139.59.72.43,443,790,709038,293,20367,497,688671,3075.143434,182.590771,892.356164,30173.31035,Benign
192.168.43.224,36200,43.245.63.29,443,616,476307,256,21801,360,454506,2469.881047,333.3727937,523.1620675,10906.85284,Benign
10.0.2.15,53847,119.254.87.201,80,11,1582,6,705,5,877,14067.60625,1.214192,4645.064372,5778.328304,Malicious
192.168.215.49,32912,172.217.161.19,443,48,8113,23,2719,25,5394,479.7803107,240.5183149,90.43801929,179.4125326,Benign
192.168.43.224,48368,169.237.6.105,80,9,1795,5,742,4,1053,27.61230134,3.130489493,1896.189083,2690.95297,Benign
192.168.137.97,49450,104.17.161.9,443,50,9944,27,2546,23,7398,734.8955417,400.1597778,50.89966841,147.9009218,Benign
10.0.2.15,52273,119.254.87.201,80,11,1513,6,705,5,808,9080.096422,1.835234,3073.177589,3522.166656,Malicious
172.30.15.1260,50568,184.29.26.86,80,8,468,5,282,3,186,3469.532456,7.975557,282.8642564,186.5700414,Benign
192.168.43.224,50002,172.217.166.195,443,19,5802,10,1278,9,4524,901.6429934,60.96571544,167.7008123,593.6451288,Benign
192.168.43.224,51474,54.197.248.134,443,9,626,6,412,3,214,347.0976903,19.91609247,165.4943109,85.96063723,Benign
172.30.6.255,56608,103.243.221.109,80,40,33690,18,10868,22,22822,958.871338,2.479039,35071.65478,73647.8934,Benign
192.168.43.233,51361,172.217.160.238,443,20,5948,10,1351,10,4597,3436.293132,28.53415,378.7742056,1288.841616,Benign
192.168.137.97,45814,54.251.174.92,443,30,8706,15,2385,15,6321,374.7607609,61.98356883,307.8235145,815.8291133,Benign
192.168.137.97,50644,192.168.121.7,443,28,7237,15,4391,13,2846,2934.997372,7.339380933,4786.234741,3102.168999,Benign
172.30.6.255,58136,157.240.16.20,443,126,88931,55,4950,71,83981,4912.901949,6.032254,6564.710306,111375.9467,Benign
172.30.6.255,57510,172.217.163.133,443,17,1779,10,1150,7,629,3069.436786,70.733016,130.066559,71.14075271,Benign
10.0.2.15,55331,119.254.87.201,80,11,1579,6,705,5,874,14428.12878,1.524888,3698.632293,4585.254786,Malicious
172.30.15.310,49573,14.139.45.149,80,158,154754,45,3273,113,151481,728.926292,1.06334,24624.29703,1139661.82,Benign
172.30.6.255,57026,52.213.19.114,443,17,6324,8,1087,9,5237,1549.952296,44.763556,194.2651741,935.9399419,Benign
172.30.6.255,55936,77.238.185.35,443,48,9795,20,2407,28,7388,152.296869,217.7332,88.43851099,271.4514828,Benign
10.0.2.15,44486,119.254.87.201,80,11,1579,6,705,5,874,22864.83333,0.818678,6889.155443,8540.598379,Malicious
10.0.2.15,40163,119.254.87.201,80,11,1582,6,705,5,877,12530.81759,1.618404,3484.914768,4335.135108,Malicious
172.30.15.1225,50533,173.241.248.143,80,6,535,4,228,2,307,3467.402144,10.221455,178.4481759,240.2789035,Benign
192.168.43.233,51348,139.59.46.160,443,1507,1418192,519,41072,988,1377120,3083.952287,188.093684,1746.87418,58571.66368,Benign
172.30.15.598,49883,111.221.29.14,443,16,5244,10,1186,6,4058,2321.43173,4.628708,2049.816061,7013.620215,Benign
192.168.42.240,51024,104.108.212.173,443,24,3069,10,1130,14,1939,491.673279,116.541803,77.568733,133.1024542,Benign
172.30.1.136,50169,104.237.191.1,443,57,9567,26,3275,31,6292,196.301901,187.037451,140.0788979,269.1225727,Benign
10.0.2.15,57731,119.254.87.201,80,11,1579,6,705,5,874,6289.233693,0.881661,6397.01654,7930.485754,Malicious
172.30.6.255,56087,184.29.25.201,80,17,6725,9,3884,8,2841,305.651602,7.286872,4264.106739,3119.033791,Benign
172.30.6.255,57421,172.217.166.206,443,17,1779,10,1150,7,629,2774.427154,145.746453,63.12332006,34.52571158,Benign
172.30.6.255,57025,52.213.19.114,443,18,6378,9,1141,9,5237,1549.678814,45.03131,202.7034079,930.3748881,Benign
10.0.2.15,52310,124.95.142.227,80,28,15473,15,1279,13,14194,178.514478,0.738428,13856.46265,153775.3173,Malicious
172.30.15.2271,51589,146.185.29.13,443,6,348,4,228,2,120,4527.616296,10.256981,177.8301042,93.59479168,Benign
172.30.6.255,56838,104.122.112.145,443,137,79828,70,14373,67,65455,1326.922449,80.74302,1424.073561,6485.266466,Benign
172.30.6.255,56772,23.198.126.238,443,19,6491,9,1372,10,5119,1245.554561,1.767821,6208.7734,23165.24128,Benign
192.168.215.49,52768,34.196.177.243,443,697,65432,394,30755,303,34677,18.65443611,1665.248483,147.7497218,166.5913543,Benign
172.30.15.296,49559,104.25.219.21,443,275,217311,101,7451,174,209860,613.921261,16.092031,3704.193709,104329.9009,Benign
192.168.137.97,33310,172.217.161.5,443,1713,1153862,724,102773,989,1051089,334.6085282,268.7407429,3059.394683,31289.30846,Benign
172.30.6.255,55668,172.217.166.193,80,11,2997,6,808,5,2189,39.376097,34.260752,188.6706982,511.1388098,Benign
172.30.15.919,50225,184.29.24.49,443,45,30437,19,2335,26,28102,3440.030888,6.960466,2683.72836,32298.98688,Benign
192.168.137.97,50120,169.237.6.105,80,12,3395,7,925,5,2470,1955.293051,1.405330372,5265.665745,14060.75069,Benign
192.168.137.97,39900,172.217.161.14,443,9,610,5,350,4,260,4954.752338,52.54600852,53.28663544,39.58435776,Benign
10.0.2.15,54433,119.254.87.201,80,11,1582,6,705,5,877,10043.18527,1.743562,3234.757353,4023.946381,Malicious
172.30.15.1499,50807,13.232.120.220,443,17,4169,8,1599,9,2570,3520.988611,6.049038,2114.716423,3398.887559,Benign
192.168.137.97,51936,172.217.161.3,443,9,610,5,350,4,260,5409.058511,56.16067269,49.85695266,37.03659341,Benign
172.30.1.136,50751,172.217.160.228,443,18,1104,9,546,9,558,1894.36177,26.934764,162.1696036,165.7337707,Benign
172.30.6.255,57056,103.243.221.17,80,20,10291,9,4216,11,6075,1663.843072,16.189097,2083.377473,3002.020434,Benign
192.168.43.224,53968,104.244.42.136,443,7,478,4,272,3,206,947.8527581,55.07724159,39.50815141,29.92161467,Benign
172.30.1.136,50318,157.240.16.20,443,39,10967,15,1551,24,9416,567.438847,118.149771,105.0192471,637.5636564,Benign
172.30.15.1565,50874,54.169.137.62,443,92,81673,32,3807,60,77866,3557.421194,9.66578,3150.909704,64446.73891,Benign
172.30.15.1836,51148,104.16.118.145,443,16,5620,8,1066,8,4554,3864.766881,0.172351,49480.42077,211382.5855,Benign
192.168.43.224,34080,52.84.108.208,443,22,7893,13,2070,9,5823,2884.942556,24.08083642,687.6837545,1934.484301,Benign
192.168.137.97,50578,104.17.161.9,443,72,18121,37,3417,35,14704,120.5324206,401.4619876,68.09112904,293.009061,Benign
10.0.2.15,51276,119.254.87.201,80,11,1513,6,705,5,808,22627.33475,6.630962,850.5553191,974.820848,Malicious
10.0.2.15,39554,119.254.87.201,80,11,1579,6,705,5,874,4302.847688,1.21895,4626.933016,5736.084335,Malicious
172.30.6.255,56522,23.198.119.247,443,21,9981,11,1314,10,8667,831.968258,41.617138,252.5882486,1666.044407,Benign
172.30.15.626,49913,172.217.160.226,80,19,9747,10,984,9,8763,2392.102248,4.035273,1950.797381,17372.80229,Benign
172.30.6.255,58063,103.231.98.53,80,39,17444,20,15698,19,1746,4826.853305,45.749943,2745.008884,305.3118558,Benign
192.168.137.97,39752,192.168.125.6,80,47,30276,24,2178,23,28098,8301.869846,21.5667993,807.9084781,10422.68706,Benign
172.30.1.136,51868,13.107.4.52,80,11,1585,6,502,5,1083,4170.089184,9.104949,441.0788023,951.5704042,Benign
172.30.15.1186,50494,54.169.236.175,443,103,80543,40,3878,63,76665,3464.910148,2.31324,13411.49211,265134.6164,Benign
172.30.15.1419,50727,159.127.41.201,443,20,8207,11,1810,9,6397,3500.248593,1.666194,8690.464616,30714.31058,Benign
172.30.6.255,55775,172.217.166.197,443,3440,2539237,2178,2370820,1262,168417,62.844507,348.801687,54376.34251,3862.756547,Benign
10.0.2.15,52352,119.254.87.201,80,11,1579,6,705,5,874,25805.36977,2.107896,2675.653827,3317.051695,Malicious
192.168.43.224,41928,23.251.156.28,443,214,143877,109,12167,105,131710,892.9912382,52.0899031,1868.615494,20228.10444,Benign
192.168.43.224,54432,52.206.154.207,443,32,6720,17,2737,15,3983,37.75220534,13.66674399,1602.137277,2331.499005,Benign
192.168.43.224,41784,34.232.42.95,443,19,1978,11,1254,8,724,35.84234504,14.2129142,705.8369492,407.5167075,Benign
172.30.6.255,57588,172.217.163.133,443,933,695018,462,33358,471,661660,3325.439599,103.038126,2589.953936,51372.05232,Benign
172.30.6.255,57065,103.243.221.75,80,23,13591,15,11542,8,2049,1679.872023,1.760627,52444.95285,9310.319562,Benign
192.168.137.97,42256,176.9.122.53,443,10,696,6,404,4,292,77.80059071,20.24100728,159.6758479,115.4092762,Benign
192.168.43.224,41490,157.240.16.20,443,66,35390,35,2690,31,32700,8.646838887,67.39992978,319.2881665,3881.309682,Benign
192.168.137.97,57352,104.197.3.80,80,10,911,5,425,5,486,5123.812938,1.160547355,2929.652104,3350.143347,Benign
192.168.137.97,46548,151.101.193.170,443,134,61109,71,7912,63,53197,382.7903457,603.4474886,104.8906511,705.2411487,Benign
172.30.15.2429,51763,52.55.184.84,443,20,9658,10,2562,10,7096,5402.765333,5.291521,3873.366467,10728.10634,Benign
192.168.43.233,51033,172.82.241.224,443,14,1541,7,968,7,573,819.736083,18.772667,412.5146416,244.1848034,Benign
10.0.2.15,57929,119.254.87.201,80,11,1513,6,705,5,808,432.885336,1.755117,3213.460983,3682.945354,Malicious
192.168.43.224,42730,107.21.25.13,443,19,5408,11,1389,8,4019,57.07201521,13.33667346,833.1912776,2410.796073,Benign
192.168.43.233,51469,54.81.94.76,80,11,655,6,349,5,306,3816.109547,76.457866,36.51684445,32.01763439,Benign
192.168.43.224,36332,52.20.136.189,443,996,830045,447,155067,549,674978,2852.172853,177.0343521,7007.31799,30501.5605,Benign
192.168.43.224,36196,52.20.114.147,443,34,7965,17,2804,17,5161,57.11948491,61.6187465,364.0450557,670.0558247,Benign
172.30.6.255,58416,216.58.196.162,80,10,1188,6,816,4,372,5552.843755,6.195242,1053.711865,480.3686442,Benign
192.168.137.97,43324,169.60.79.77,443,35,9364,21,4478,14,4886,4040.933981,8.404103729,4262.679419,4651.061108,Benign
172.30.15.952,50258,172.217.160.226,80,14,4576,8,2044,6,2532,3441.696044,5.310963,3078.914314,3813.997574,Benign
10.0.2.15,58381,119.254.87.201,80,11,1582,6,705,5,877,9983.154085,1.947259,2896.378961,3603.013261,Malicious
10.0.2.15,34149,119.254.87.201,80,11,1582,6,705,5,877,12625.82367,2.311541,2439.930765,3035.204654,Malicious
172.30.6.255,57101,172.30.10.168,139,3,198,3,198,0,0,1779.355736,9.006061,175.8815535,0,Benign
172.30.6.255,56552,172.217.166.210,443,32,6918,16,2238,16,4680,845.003514,11.112114,1611.214572,3369.295887,Benign
172.30.6.255,55978,54.254.228.105,443,6,348,4,228,2,120,176.099485,37.825925,48.22089612,25.37941901,Benign
10.0.2.15,42055,119.254.87.201,80,11,1579,6,705,5,874,3944.717502,4.922875,1145.67199,1420.308255,Malicious
10.0.2.15,42437,119.254.87.201,80,11,1582,6,705,5,877,7756.036152,2.221991,2538.264106,3157.528541,Malicious
172.30.1.136,50376,172.217.167.2,443,49,9347,23,2783,26,6564,689.612371,137.541572,161.8710596,381.7900235,Benign
192.168.137.97,40880,103.211.218.251,80,14,4853,8,2676,6,2177,609.8006668,11.61514048,1843.111586,1499.422243,Benign
172.30.15.1800,51112,180.149.59.203,443,10250,10169040,3300,226576,6950,9942464,3663.185751,23.870956,75933.61573,3332070.655,Benign
192.168.137.97,50642,192.168.121.7,443,19,3540,10,2381,9,1159,2934.997163,7.33949226,2595.274894,1263.302647,Benign
192.168.43.233,50730,151.101.129.181,443,271,210462,103,8531,168,201931,1855.964487,15.610933,4371.807886,103481.8355,Benign
192.168.43.224,48868,151.101.153.177,443,21,9142,12,1410,9,7732,3245.176979,19.19023741,587.7988769,3223.305614,Benign
10.0.2.15,33519,119.254.87.201,80,11,1582,6,705,5,877,26376.09659,1.226288,4599.245854,5721.331368,Malicious
10.0.2.15,51711,119.254.87.201,80,11,1579,6,705,5,874,19378.23928,5.174614,1089.93637,1351.211897,Malicious
192.168.43.224,48148,152.14.93.202,80,382,334145,151,10429,231,323716,2216.887799,8.144150115,10244.40842,317986.2801,Benign
172.30.6.255,56652,172.30.16.59,7680,3,198,3,198,0,0,1075.255215,9.004814,175.9059099,0,Benign
172.30.6.255,57706,103.243.221.87,80,45,28837,23,13508,22,15329,3712.839646,26.214186,4122.348106,4678.07774,Benign
172.30.6.255,56414,103.243.220.231,80,33,21324,20,19004,13,2320,678.09631,19.956082,7618.329089,930.0422798,Benign
192.168.137.97,53278,52.222.190.164,443,23,8451,13,1674,10,6777,306.6178108,10.91808601,1226.588615,4965.705522,Benign
172.30.15.1879,51191,52.84.108.203,443,1738,1529241,688,45348,1050,1483893,3967.450168,19.803295,18319.37564,599452.9698,Benign
10.0.2.15,49148,119.254.87.201,80,11,1513,6,705,5,808,6347.071026,2.017615,2795.379693,3203.782684,Malicious
192.168.43.233,51202,52.84.110.171,443,449,151058,219,38158,230,112900,781.613194,950.309186,321.2259804,950.427517,Benign
172.30.6.255,57537,103.243.220.231,80,17,5504,9,4215,8,1289,3147.855175,14.176183,2378.637465,727.4172462,Benign
10.0.2.15,53796,119.254.87.201,80,12,1653,7,779,5,874,11329.71607,6.91748,900.9061103,1010.772709,Malicious
172.30.15.1725,51036,184.29.25.7,443,83,69422,34,10974,49,58448,3619.520421,7.514967,11682.28683,62220.36637,Benign
172.30.6.255,57024,52.213.19.114,443,19,6444,10,1207,9,5237,1549.678574,45.042698,214.3743698,930.1396644,Benign
10.0.2.15,59243,119.254.87.201,80,11,1582,6,705,5,877,8389.396533,1.157162,4873.993443,6063.109573,Malicious
172.30.6.255,57603,103.243.221.51,80,77,57357,47,49274,30,8083,3375.847808,26.216064,15036.27699,2466.57927,Benign
10.0.2.15,34034,119.254.87.201,80,11,1551,6,705,5,846,10521.42835,0.89446,6305.480402,7566.576482,Malicious
172.30.15.1660,50971,184.29.25.7,443,83,58501,36,5121,47,53380,3587.459162,9.922285,4128.88765,43038.4735,Benign
172.30.6.255,57481,172.217.166.206,443,17,1783,10,1154,7,629,3013.409602,62.050484,148.7820788,81.09525785,Benign
172.30.6.255,57044,103.243.221.75,80,71,48031,42,40002,29,8029,1614.841438,49.190182,6505.688473,1305.789029,Benign
192.168.43.224,57980,172.217.166.206,443,9,606,5,338,4,268,16.98774266,57.44169469,47.07382007,37.32480408,Benign
172.30.15.355,49623,104.25.218.21,443,17,6432,9,1091,8,5341,1334.378026,5.894332,1480.744553,7248.997851,Benign
172.30.15.2161,51473,13.107.21.200,443,167,99635,66,11433,101,88202,4227.846618,9.592734,9534.716589,73557.34038,Benign
172.30.6.255,56187,54.85.156.219,80,13,1684,7,856,6,828,466.791342,61.307378,111.6994434,108.0457233,Benign
192.168.43.233,51147,74.125.158.9,443,12,696,6,348,6,348,476.005009,14.301295,194.6676857,194.6676857,Benign
172.30.15.246,49515,13.107.4.50,80,738,720137,240,13842,498,706295,53.917414,4.000567,27680.07635,1412389.794,Benign
172.30.15.2404,51738,14.139.45.128,80,163,144739,62,4175,101,140564,5343.615855,0.938717,35580.47846,1197924.401,Benign
192.168.43.224,52616,192.229.237.96,443,169,97321,73,6071,96,91250,517.6250046,240.0569535,202.3186551,3040.945031,Benign
10.0.2.15,60693,119.254.87.201,80,12,1587,7,779,5,808,12140.57082,4.274342,1458.002191,1512.279551,Malicious
192.168.43.224,40174,54.243.243.77,443,59,27843,35,14087,24,13756,2530.688098,108.8670953,1035.17045,1010.847214,Benign
192.168.43.233,51349,104.16.2.213,443,9,534,5,294,4,240,3417.095459,19.880273,118.3082345,96.57815061,Benign
172.30.6.255,55679,172.217.166.198,443,16,5235,8,1219,8,4016,41.55235,11.485165,849.095333,2797.347709,Benign
172.30.6.255,57147,103.243.221.75,80,6,340,4,228,2,112,1877.014875,45.029106,40.50713332,19.89824093,Benign
172.30.6.255,58245,103.243.221.109,80,8,448,5,282,3,166,5222.100363,40.077175,56.29139279,33.1360681,Benign
172.30.6.255,58525,35.190.41.40,443,84,18609,36,5775,48,12834,5781.817617,7.549225,6119.833493,13600.33646,Benign
10.0.2.15,40439,119.254.87.201,80,11,1582,6,705,5,877,20341.79924,1.89278,2979.74408,3706.717104,Malicious
172.30.6.255,56052,54.239.17.112,80,15,2074,9,1018,6,1056,254.482979,157.339657,51.76063146,53.69275719,Benign
10.0.2.15,56225,119.254.87.201,80,11,1513,6,705,5,808,13194.09875,1.852641,3044.302701,3489.073166,Malicious
10.0.2.15,39654,119.254.87.201,80,11,1560,6,705,5,855,25057.51405,2.410978,2339.299654,2837.022984,Malicious
192.168.43.224,35032,34.232.42.95,443,523,460819,208,37288,315,423531,3014.921518,26.19273622,11388.80633,129358.3065,Benign
192.168.42.240,50921,13.35.129.85,443,19,1378,6,384,13,994,179.259967,0.340752,9015.354275,23336.62018,Benign
192.168.43.224,34324,172.217.166.206,443,54,10567,28,3418,26,7149,1402.365874,245.9192818,111.1909558,232.5641145,Benign
172.30.6.255,56209,173.198.245.125,80,11,1226,6,787,5,439,469.803126,6.248369,1007.622949,562.0666769,Benign
192.168.43.233,51300,104.16.88.20,80,7,402,4,228,3,174,2530.721864,13.473413,135.377725,103.3145796,Benign
172.30.6.255,55880,52.89.235.78,80,51,38381,21,5771,30,32610,108.934973,64.204743,719.0746017,4063.251215,Benign
192.168.43.233,51307,52.84.110.71,443,637,177686,268,40835,369,136851,3031.201985,432.023441,756.1626731,2534.140271,Benign
192.168.137.97,37826,117.18.237.70,443,43,11941,21,2410,22,9531,680.1675282,180.5208401,106.8020733,422.3778262,Benign
172.30.6.255,58125,157.240.16.39,443,302,152683,150,49917,152,102766,4899.588654,29.344272,13608.65248,28016.64325,Benign
172.30.1.136,51558,172.217.161.14,443,2,132,2,132,0,0,739.508146,2.999857,352.0167795,0,Benign
10.0.2.15,52592,119.254.87.201,80,11,1552,6,705,5,847,12112.94292,0.890501,6333.513382,7609.199765,Malicious
172.30.1.136,50814,172.217.161.14,443,47,13864,22,9318,25,4546,1952.429043,7.427325,10036.45323,4896.513886,Benign
192.168.43.224,45924,104.31.92.239,80,69,36324,32,5629,37,30695,803.7624471,77.19092157,583.384666,3181.203113,Benign
192.168.43.224,41534,18.210.21.97,443,35,7589,18,2598,17,4991,1758.770266,70.33969492,295.4803831,567.6453395,Benign
172.30.6.255,58061,157.240.16.39,443,35,6695,18,3156,17,3539,4825.868337,46.668234,541.0104012,606.665339,Benign
192.168.43.224,43094,66.228.33.150,443,6,412,4,272,2,140,2618.999083,20.9930244,103.6534783,53.35105503,Benign
10.0.2.15,45119,119.254.87.201,80,11,1544,6,705,5,839,4575.329365,0.880502,6405.436898,7622.924196,Malicious
172.30.6.255,56976,103.243.220.231,80,20,10615,9,4498,11,6117,1436.859559,16.196809,2221.672182,3021.335869,Benign
172.30.6.255,58349,157.240.16.39,443,5,330,1,66,4,264,5425.092136,15.062415,35.05413972,140.2165589,Benign
10.0.2.15,34885,119.254.87.201,80,11,1587,6,705,5,882,26228.89024,1.224104,4607.451654,5764.216112,Malicious
172.30.6.255,57173,103.243.221.46,80,35,22075,15,8341,20,13734,2007.847702,26.433859,2524.338198,4156.487329,Benign
192.168.43.224,35060,34.232.42.95,443,17,1874,10,1220,7,654,3042.774409,15.88621724,614.3690376,329.3420907,Benign
10.0.2.15,33332,119.254.87.201,80,11,1579,6,705,5,874,16500.40473,3.588697,1571.601057,1948.339467,Malicious
192.168.137.97,37180,140.98.193.112,443,4,264,2,132,2,132,3.267441921,1.567749177,673.5771356,673.5771356,Benign
10.0.2.15,34569,119.254.87.201,80,11,1579,6,705,5,874,2681.076059,1.417214,3979.638925,4933.623292,Malicious
10.0.2.15,53325,119.254.87.201,80,11,1579,6,705,5,874,6136.890676,2.437202,2314.129071,2868.863557,Malicious
172.30.15.418,49692,54.222.61.197,443,45,24611,20,2223,25,22388,1614.439685,6.445633,2759.077347,27786.87524,Benign
172.30.6.255,57443,103.243.221.17,80,29,12796,16,9329,13,3467,2860.893239,30.13566,2476.534445,920.3714138,Benign
10.0.2.15,55571,119.254.87.201,80,11,1534,6,705,5,829,3522.090799,1.746828,3228.709409,3796.595887,Malicious
192.168.137.97,60476,104.113.242.64,443,5431,4439501,2420,191645,3011,4247856,22.23831521,112.3023774,13652.07074,302601.3233,Benign
172.30.1.136,51821,157.240.16.39,443,43,15050,29,12822,14,2228,3055.709359,164.964582,621.8062008,108.0474353,Benign
10.0.2.15,33160,119.254.87.201,80,11,1579,6,705,5,874,22594.41996,1.127841,5000.704887,6199.45542,Malicious
10.0.2.15,34043,119.254.87.201,80,11,1513,6,705,5,808,22471.64269,4.448492,1267.845373,1453.076683,Malicious
10.0.2.15,35283,119.254.87.201,80,11,1587,6,705,5,882,6169.086475,1.68904,3339.174916,4177.520959,Malicious
172.30.6.255,57929,103.243.221.17,80,42,28350,17,8943,25,19407,4499.885702,27.178563,2632.368753,5712.443296,Benign
172.30.6.255,58386,52.213.19.114,443,20,6624,10,1321,10,5303,5486.497492,12.688969,832.8493828,3343.37644,Benign
192.168.43.233,50949,54.77.120.226,443,7,426,4,240,3,186,461.699468,17.873638,107.4207724,83.25109863,Benign
172.30.6.255,57445,103.243.221.17,80,29,15429,14,8287,15,7142,2860.893878,30.13502,2199.965356,1896.000069,Benign
10.0.2.15,43638,119.254.87.201,80,11,1579,6,705,5,874,11214.49409,1.539602,3663.284407,4541.433435,Malicious
192.168.43.224,33448,18.211.245.141,443,11,754,6,416,5,338,390.3121765,82.78652823,40.19977732,32.66231907,Benign
10.0.2.15,40606,119.254.87.201,80,12,1656,7,779,5,877,23342.59691,5.152157,1209.590469,1361.759745,Malicious
192.168.43.224,42224,18.211.245.141,443,11,754,6,416,5,338,2927.142275,88.3310268,37.6764555,30.61212009,Benign
172.30.15.1837,51149,104.16.118.145,443,16,5620,8,1066,8,4554,3864.767967,0.165963,51384.94725,219518.8084,Benign
10.0.2.15,46538,119.254.87.201,80,11,1582,6,705,5,877,24964.40225,1.3612,4143.40288,5154.275639,Malicious
10.0.2.15,48263,119.254.87.201,80,11,1513,6,705,5,808,20912.32524,2.263719,2491.475311,2855.478087,Malicious
172.30.6.255,58193,103.231.98.53,80,19,6478,10,5744,9,734,5089.850746,24.184502,1900.059799,242.8001205,Benign
192.168.43.224,53376,151.101.152.143,443,167,129330,66,5351,101,123979,110.1473477,303.6743936,140.9667753,3266.1035,Benign
172.30.6.255,58574,180.149.59.210,80,9,4732,6,3560,3,1172,5879.95561,0.682857,41707.1217,13730.54681,Benign
10.0.2.15,40566,119.254.87.201,80,11,1582,6,705,5,877,14758.45146,1.551891,3634.275861,4520.936071,Malicious
172.30.6.255,57246,103.243.220.231,80,27,15263,15,8287,12,6976,2225.854551,26.373401,2513.744814,2116.071416,Benign
172.30.6.255,58131,157.240.16.20,443,47,26380,20,2420,27,23960,4906.254852,2.766058,6999.13017,69297.17309,Benign
192.168.43.224,41952,23.251.156.28,443,454,337769,208,21726,246,316043,1053.983656,172.6730959,1006.572559,14642.37371,Benign
172.30.6.255,56309,103.243.221.17,80,6,348,4,228,2,120,590.110983,15.92955,114.5041762,60.2653559,Benign
172.30.15.1855,51167,172.25.10.224,7680,3,198,3,198,0,0,3907.075856,9.033821,175.3410877,0,Benign
172.30.6.255,56768,52.230.3.194,443,69,15766,36,7408,33,8358,1244.911012,4469.255607,13.26037381,14.96088071,Benign
192.168.43.224,43136,117.18.232.205,443,11,638,6,344,5,294,926.5854256,16.2296483,169.566213,144.9199611,Benign
192.168.215.49,44202,172.217.161.5,443,35,5147,20,2711,15,2436,1982.953443,135.9744262,159.5005812,143.3210681,Benign
172.30.6.255,58322,157.240.16.39,443,27,5457,16,3453,11,2004,5364.089628,61.922906,446.1030947,258.902578,Benign
172.30.15.2305,51634,184.29.26.80,80,16,2884,9,958,7,1926,4994.697643,60.369864,126.9507581,255.2266806,Benign
172.30.6.255,56784,157.240.16.16,443,19,1941,11,1187,8,754,1251.125183,65.992784,143.8945203,91.40393289,Benign
192.168.43.224,41946,23.251.156.28,443,6,412,4,272,2,140,1027.571474,26.71924013,81.43944176,41.91735973,Benign
192.168.137.97,50118,169.237.6.105,80,12,3479,7,925,5,2554,1954.523887,1.237696286,5978.849645,16508.08864,Benign
10.0.2.15,43608,119.254.87.201,80,11,1579,6,705,5,874,18807.67653,1.589007,3549.386504,4400.232346,Malicious
172.30.1.136,51223,172.217.194.188,5228,1,66,1,66,0,0,1625.956425,0,0,0,Benign
172.30.6.255,58270,103.243.221.109,80,16,5544,9,4317,7,1227,5287.840764,28.034943,1231.891215,350.1344733,Benign
192.168.43.233,51468,54.81.94.76,80,11,655,6,349,5,306,3816.109342,76.354607,36.56622841,32.0609338,Benign
172.30.15.2016,51328,52.7.89.176,443,6,348,4,228,2,120,4089.42513,8.167978,223.3110814,117.5321481,Benign
192.168.43.233,51515,204.79.197.222,443,52,13912,28,3749,24,10163,3907.199154,11.181812,2682.212865,7271.093451,Benign
172.30.6.255,57052,157.240.16.39,443,26,6485,15,3443,11,3042,1643.095962,61.026398,451.3456619,398.7782468,Benign
172.30.1.136,50638,172.217.161.3,443,12,1681,7,1170,5,511,1745.579874,29.526346,317.0050232,138.4526213,Benign
192.168.137.97,35644,151.101.193.69,443,13,922,7,486,6,436,73.66482066,15.17493544,256.2119633,229.8527078,Benign
172.30.15.2364,51698,14.139.45.128,80,10,1612,5,656,5,956,5332.882196,0.438054,11980.25814,17459.03473,Benign
192.168.215.49,35114,13.127.174.179,443,1276,810374,566,91408,710,718966,1245.340287,298.7690488,2447.589545,19251.41853,Benign
172.30.6.255,57550,162.125.32.135,443,17,5289,9,1579,8,3710,3216.376664,1.768153,7144.178134,16785.87769,Benign
172.30.6.255,58532,172.217.166.226,80,42,11457,22,6432,20,5025,5790.842413,8.234337,6248.954834,4881.995964,Benign
10.0.2.15,50904,119.254.87.201,80,11,1579,6,705,5,874,24844.26349,1.089066,5178.749497,6420.180228,Malicious
172.30.6.255,58070,180.149.59.210,80,24,13023,15,9528,9,3495,4827.00845,45.507181,1674.988394,614.408526,Benign
192.168.43.233,51262,52.84.110.78,443,57,23528,27,2600,30,20928,2307.272296,181.762466,114.4350671,921.1142635,Benign
172.30.1.136,50197,52.95.120.67,80,10,580,6,348,4,232,358.034583,20.940934,132.9453596,88.6302397,Benign
10.0.2.15,60075,119.254.87.201,80,11,1513,6,705,5,808,10218.59195,0.895871,6295.549248,7215.324528,Malicious
192.168.43.224,48542,49.44.150.17,443,54,23854,25,5751,29,18103,3250.857059,95.93969187,479.5512588,1509.531636,Benign
10.0.2.15,49826,119.254.87.201,80,11,1579,6,705,5,874,17666.51639,1.555921,3624.862702,4493.801421,Malicious
172.30.15.2530,51864,54.254.246.72,443,31,10063,15,2571,16,7492,5493.849084,4.091807,5026.630044,14647.80719,Benign
172.30.15.2176,51488,77.88.21.119,443,6,348,4,228,2,120,4251.091923,7.270424,250.8794535,132.0418176,Benign
172.30.6.255,57720,210.176.156.62,80,12,4179,6,3843,6,336,3733.859898,17.818932,1725.35593,150.8507917,Benign
172.30.6.255,57092,103.243.221.17,80,52,38458,22,13640,30,24818,1734.845696,35.996727,3031.386715,5515.612572,Benign
192.168.43.224,49940,34.196.177.243,443,39,8971,21,3674,18,5297,2047.817373,6.888979105,4266.524771,6151.274282,Benign
172.30.15.1615,50925,161.202.1.35,443,20,7367,11,3279,9,4088,3573.953428,3.225223,8133.391086,10140.07404,Benign
192.168.43.224,49826,34.205.118.138,443,9,622,5,350,4,272,364.1977037,41.73590761,67.08851347,52.13735904,Benign
172.30.15.1832,51144,52.84.108.83,443,36,24025,16,1957,20,22068,3864.660009,2.481801,6308.322061,71135.43753,Benign
192.168.215.49,44980,132.72.23.98,443,24,6886,14,2009,10,4877,825.5723197,52.55715808,305.8004007,742.3536854,Benign
172.30.15.2374,51708,14.139.45.128,80,10,1372,5,651,5,721,5334.548072,0.186661,27900.84699,30900.93806,Benign
172.30.15.564,49848,144.2.194.69,443,6,360,3,198,3,162,2254.569198,1.090918,1451.988142,1187.990298,Benign
192.168.215.49,46386,223.31.160.67,443,109,70700,51,5769,58,64931,282.7217466,10.33996289,4463.458958,50236.93077,Benign
10.0.2.15,34292,119.254.87.201,80,11,1579,6,705,5,874,24789.74764,2.059696,2738.268172,3394.675719,Malicious
192.168.137.97,49482,157.240.16.52,443,34,8960,16,2069,18,6891,7086.744036,66.75085373,247.966866,825.8770775,Benign
192.168.43.224,50888,104.16.118.145,443,29,7433,16,1599,13,5834,152.1314538,1.833081594,6978.412768,25460.95065,Benign
172.30.15.825,50124,172.217.166.196,443,19,3235,10,1490,9,1745,3102.164762,1.256348,9487.81707,11111.571,Benign
172.30.6.255,57144,103.243.220.231,80,45,32171,19,9478,26,22693,1875.863073,46.179528,1641.939692,3931.26582,Benign
10.0.2.15,44405,119.254.87.201,80,11,1579,6,705,5,874,22534.31246,1.516981,3717.910771,4609.15463,Malicious
192.168.43.224,59982,49.44.90.18,443,263,197846,107,10120,156,187726,7.954146405,127.8545641,633.2194755,11746.22127,Benign
172.30.6.255,58010,157.240.16.39,443,28,6463,16,3361,12,3102,4754.090649,61.06391,440.325554,406.3938913,Benign
10.0.2.15,48739,119.254.87.201,80,11,1579,6,705,5,874,20399.30695,5.329344,1058.291602,1311.981362,Malicious
172.30.6.255,58208,103.243.221.87,80,31,20731,13,5455,18,15276,5155.863205,1.53268,28473.00154,79734.84354,Benign
172.30.15.1927,51239,34.201.201.2,443,11,1407,7,964,4,443,3991.666173,5.534355,1393.47765,640.3636919,Benign
172.30.15.285,49548,192.0.72.17,443,4940,5369186,1224,67766,3716,5301420,390.536182,4.236884,127954.4118,10010035.68,Benign
192.168.43.224,40190,54.243.243.77,443,31,10423,17,5733,14,4690,2639.992845,164.454685,278.8853355,228.1479546,Benign
172.30.15.349,49617,52.21.142.16,443,191,132407,103,122979,88,9428,1129.451339,7.830741,125637.1523,9631.78325,Benign
172.30.6.255,57708,103.243.221.87,80,54,39333,22,9640,32,29693,3712.8435,26.210332,2942.351131,9062.990885,Benign
10.0.2.15,39455,119.254.87.201,80,11,1513,6,705,5,808,5205.996935,1.084409,5200.989663,5960.850565,Malicious
192.168.43.224,39774,54.243.243.77,443,79,37744,46,20558,33,17186,405.8526463,161.7747062,1016.623698,849.8732789,Benign
172.30.6.255,56800,172.30.20.1,80,6,360,3,198,3,162,1261.29238,1.110666,1426.171324,1166.867447,Benign
192.168.43.224,39010,103.37.200.184,443,447,352595,205,17137,242,335458,2457.975609,18.77973655,7300.208907,142902.1112,Benign
192.168.43.224,43334,136.146.208.40,443,21,5533,11,1377,10,4156,93.32698552,15.12134302,728.5067198,2198.746498,Benign
172.30.15.1366,50674,151.101.128.166,443,39,19295,20,4884,19,14411,3493.387016,3.639873,10734.44046,31673.63257,Benign
192.168.43.233,51676,49.44.149.244,443,26,10146,12,4872,14,5274,894.526671,4.287782,9090.014371,9840.052503,Benign
172.30.15.2488,51822,14.139.45.128,80,478,444036,172,10451,306,433585,5434.180063,2.956613,28278.30359,1173193.786,Benign
172.30.1.136,50686,151.101.0.188,443,29,12307,16,3602,13,8705,1806.180476,18.377152,1568.034046,3789.488164,Benign
172.30.15.1504,50812,13.232.236.27,443,22,7716,11,1954,11,5762,3521.107731,5.929806,2636.173932,7773.610132,Benign
172.30.15.1827,51139,104.16.124.127,443,30,9016,16,2262,14,6754,3861.704904,5.469152,3308.739636,9879.410921,Benign
192.168.215.49,53448,159.153.191.240,443,35,7233,18,2656,17,4577,1497.577596,344.2777544,61.71760949,106.3559859,Benign
10.0.2.15,41440,119.254.87.201,80,11,1579,6,705,5,874,8689.632353,2.043763,2759.615474,3421.140318,Malicious
172.30.6.255,56523,23.198.119.247,443,22,9500,12,1368,10,8132,831.968349,41.616574,262.9721514,1563.223345,Benign
192.168.43.224,34178,54.191.37.172,443,7,478,4,272,3,206,176.9432688,21.08040383,103.223829,78.17687049,Benign
172.30.6.255,57033,157.240.16.39,443,18,1879,9,1071,9,808,1582.088248,61.066376,140.3063447,105.8520322,Benign
192.168.43.224,50578,49.44.150.71,443,135,64320,70,19744,65,44576,2283.078314,525.4584062,300.5984834,678.6607575,Benign
172.30.15.2118,51430,35.200.76.2,443,11,1323,6,904,5,419,4178.091037,9.538612,758.1815887,351.4138116,Benign
192.168.43.224,33140,172.217.166.195,443,17,5671,9,1212,8,4459,110.6703805,15.82411717,612.7356046,2254.280578,Benign
192.168.43.224,49806,172.217.166.195,443,198,160882,72,5835,126,155047,23.05336738,240.7221061,193.9165487,5152.729927,Benign
192.168.43.233,50900,172.217.166.195,443,6,361,4,241,2,120,225.414794,49.82183,38.69789608,19.26866195,Benign
172.30.6.255,56687,35.190.43.164,80,22,5302,12,3846,10,1456,1155.903579,85.585613,359.4996743,136.0976406,Benign
192.168.43.224,51334,209.167.231.17,443,31,3992,16,2226,15,1766,107.7320705,304.7407537,58.4365556,46.36071752,Benign
172.30.6.255,58078,205.185.216.42,443,125,105106,48,4106,77,101000,4848.416701,0.999812,32854.17659,808151.9326,Benign
192.168.43.224,52252,192.0.73.2,443,32,10280,17,2124,15,8156,1903.254714,11.45589677,1483.253589,5695.582048,Benign
192.168.215.49,58514,104.113.219.181,443,62,17856,32,7944,30,9912,612.5544416,367.270113,173.0388555,215.9064873,Benign
172.30.15.2106,51418,64.74.232.52,443,14,2864,9,2093,5,771,4146.356419,10.968665,1526.530348,562.329144,Benign
172.30.6.255,57196,103.243.221.75,80,41,26918,17,8924,24,17994,2072.855066,15.170828,4705.873668,9488.7372,Benign
10.0.2.15,58043,119.254.87.201,80,11,1551,6,705,5,846,22111.17427,2.149346,2624.054015,3148.864817,Malicious
172.30.6.255,55920,13.250.69.79,80,6,348,4,228,2,120,121.80708,30.122275,60.55319527,31.87010277,Benign
172.30.15.710,49997,104.16.208.165,443,25,7295,13,1764,12,5531,2404.85403,1.339668,10533.95319,33029.07885,Benign
192.168.42.240,50963,216.58.221.46,443,100,23481,44,13004,56,10477,234.746628,60.972492,1706.212041,1374.652688,Benign
172.30.6.255,56266,103.243.223.145,443,29,13440,16,5859,13,7581,530.275464,76.155525,615.4773406,796.3703224,Benign
192.168.43.233,51169,184.50.104.173,443,11,666,6,360,5,306,1011.732344,26.296033,109.5222234,93.09388987,Benign
172.30.6.255,56625,192.168.240.1,7680,3,198,3,198,0,0,994.913768,9.003462,175.9323247,0,Benign
10.0.2.15,37781,119.254.87.201,80,11,1579,6,705,5,874,14007.61212,1.327412,4248.869228,5267.39249,Malicious
192.168.43.233,51131,52.84.110.163,443,40,9290,19,2724,21,6566,922.415819,182.572261,119.3609581,287.7107383,Benign
10.0.2.15,53327,119.254.87.201,80,11,1513,6,705,5,808,24243.59804,1.224639,4605.438827,5278.290174,Malicious
172.30.6.255,57298,103.243.221.51,80,37,24119,15,9543,22,14576,2402.879908,21.152366,3609.241633,5512.763915,Benign
172.30.15.1587,50896,151.101.66.110,443,19,2512,10,1528,9,984,3571.325604,5.793783,2109.847745,1358.697763,Benign
10.0.2.15,34577,119.254.87.201,80,11,1513,6,705,5,808,3375.92061,0.824672,6839.08269,7838.26782,Malicious
192.168.43.233,51100,106.10.193.30,443,37,9274,18,2801,19,6473,918.448066,119.02521,188.2626378,435.0674954,Benign
172.30.6.255,56468,103.243.221.75,80,36,23657,17,9731,19,13926,762.868804,8.747993,8898.955452,12735.26396,Benign
10.0.2.15,59774,119.254.87.201,80,11,1513,6,705,5,808,24188.93114,1.41434,3987.725724,4570.329624,Malicious
172.30.6.255,58477,35.190.43.164,80,10,1629,6,1175,4,454,5681.828335,7.257001,1295.30091,500.482224,Benign
172.30.6.255,57985,157.240.16.39,443,18,1879,10,1125,8,754,4693.086131,61.054365,147.4096078,98.79719493,Benign
192.168.43.233,51115,34.251.148.205,443,45,10274,21,2516,24,7758,919.859422,91.089055,220.9705656,681.3551859,Benign
10.0.2.15,49778,119.254.87.201,80,11,1579,6,705,5,874,3496.087518,1.750521,3221.897938,3994.239429,Malicious
172.30.15.2163,51475,104.24.0.12,443,6,348,4,228,2,120,4228.067631,9.429699,193.4314128,101.8060067,Benign
172.30.1.136,50462,157.240.16.16,443,1,66,1,66,0,0,882.084895,0,0,0,Benign
172.30.6.255,56591,157.240.16.39,443,19,1933,10,1125,9,808,911.094618,61.056428,147.4046271,105.8692788,Benign
192.168.43.224,48534,49.44.150.17,443,56,24409,26,5826,30,18583,3250.856925,95.93981544,485.8045618,1549.554784,Benign
172.30.15.1514,50822,104.20.90.77,443,6,348,4,228,2,120,3524.736243,2.301449,792.5441754,417.1285134,Benign
172.30.6.255,55960,103.243.221.51,443,17,4553,10,3067,7,1486,165.84502,17.605445,1393.659746,675.2456413,Benign
172.30.15.589,49874,23.198.129.83,443,9,534,5,294,4,240,2313.237024,3.018398,779.2212955,636.0990168,Benign
10.0.2.15,60434,119.254.87.201,80,11,1579,6,705,5,874,9530.620958,2.081035,2710.189881,3359.866605,Malicious
192.168.43.233,50978,49.44.170.2,443,560,411088,248,41438,312,369650,502.152408,658.746341,503.2346738,4489.133094,Benign
172.30.15.1981,51293,52.52.93.212,443,17,6436,8,1087,9,5349,4076.778384,5.789408,1502.053405,7391.429314,Benign
10.0.2.15,56743,119.254.87.201,80,11,1513,6,705,5,808,6584.942113,4.211023,1339.342008,1535.018925,Malicious
192.168.137.97,46552,103.229.206.27,443,17,4977,10,1323,7,3654,349.6809433,14.07633618,751.900201,2076.676746,Benign
192.168.137.97,44480,172.217.161.10,443,9,606,5,338,4,268,9323.873006,56.35016986,47.98565837,38.04780013,Benign
192.168.42.240,51035,172.217.27.4,443,38,9545,19,6193,19,3352,608.356837,8.207782,6036.222697,3267.143304,Benign
192.168.43.233,51097,49.44.178.209,443,37,10540,18,3671,19,6869,917.131147,318.987151,92.06640427,172.2702618,Benign
10.0.2.15,50998,119.254.87.201,80,11,1579,6,705,5,874,22447.13412,1.027377,5489.708257,6805.680875,Malicious
172.30.15.1758,51070,184.29.25.7,443,13,1477,6,904,7,573,3638.242185,8.934142,809.4789628,513.0878824,Benign
172.30.15.2203,51515,77.88.21.119,443,11,1342,6,904,5,438,4311.281338,7.235617,999.5001117,484.2710718,Benign
192.168.137.97,60802,23.57.218.60,443,3,198,2,132,1,66,8.231683056,0.074358033,14201.5591,7100.779549,Benign
10.0.2.15,41796,119.254.87.201,80,11,1579,6,705,5,874,6887.617747,2.160347,2610.691708,3236.517097,Malicious
172.30.15.885,50191,50.23.131.235,80,16,5973,8,904,8,5069,3437.797803,4.836904,1495.171291,8383.875305,Benign
10.0.2.15,36013,124.95.142.227,80,17,6479,9,730,8,5749,145.96048,33.937281,172.0821418,1355.205799,Malicious
10.0.2.15,35848,119.254.87.201,80,11,1582,6,705,5,877,14698.36231,1.914595,2945.792713,3664.482567,Malicious
192.168.137.97,50596,192.168.121.7,443,186,108837,100,16723,86,92114,2901.55105,21.17395098,6318.329542,34802.76311,Benign
10.0.2.15,39345,119.254.87.201,80,11,1582,6,705,5,877,25089.91665,0.823715,6847.028402,8517.50909,Malicious
192.168.43.224,39966,185.199.110.153,80,30,4754,16,1425,14,3329,59.24571952,458.4025507,24.86897157,58.09740797,Benign
10.0.2.15,38499,119.254.87.201,80,11,1569,6,705,5,864,24669.56778,2.220807,2539.617355,3112.382121,Malicious
172.30.15.1648,50958,184.29.25.7,443,13,1477,6,904,7,573,3577.473115,10.031688,720.9155628,456.9520105,Benign
192.168.43.224,33162,35.171.73.174,443,41,9061,22,3468,19,5593,1907.834779,75.17218166,369.0726993,595.2201866,Benign
10.0.2.15,42045,119.254.87.201,80,11,1582,6,705,5,877,12203.07647,1.243046,4537.241582,5644.199812,Malicious
10.0.2.15,40921,119.254.87.201,80,11,1579,6,705,5,874,14723.41252,1.825976,3088.759107,3829.18505,Malicious
10.0.2.15,44097,119.254.87.201,80,11,1582,6,705,5,877,16710.6417,2.107635,2675.985168,3328.849635,Malicious
172.30.6.255,57451,103.243.221.109,80,40,24351,23,20203,17,4148,2890.840797,31.19154,5181.661438,1063.878218,Benign
172.30.6.255,55800,104.36.113.23,80,62,33853,31,19422,31,14431,89.431949,322.452782,481.8565963,358.0307147,Benign
172.30.6.255,55655,172.217.166.198,80,14,3078,8,1548,6,1530,37.486051,21.090548,587.1824668,580.3547637,Benign
192.168.43.233,50715,172.217.166.206,443,22,7148,11,1663,11,5485,1843.413565,11.574237,1149.449419,3791.178632,Benign
172.30.15.1457,50765,103.231.98.244,443,9,718,6,544,3,174,3502.911647,0.781683,5567.474283,1780.773024,Benign
172.30.15.1103,50411,23.23.178.66,80,16,4397,9,3742,7,655,3458.199864,11.091866,2698.914682,472.4182568,Benign
192.168.43.224,33366,174.129.238.218,443,9,610,5,338,4,272,473.3513887,69.13116995,39.11404945,31.47639482,Benign
192.168.137.97,55938,172.217.161.5,443,27,7738,15,2238,12,5500,66.49896976,6.602143995,2711.846336,6664.501718,Benign
192.168.137.97,33270,161.202.24.166,443,1355,604150,641,63323,714,540827,121.3734569,1718.687898,294.7504318,2517.394814,Benign
10.0.2.15,50631,119.254.87.201,80,12,1656,7,779,5,877,2773.622998,4.613509,1350.815616,1520.751341,Malicious
172.30.15.1533,50841,107.6.122.24,443,11,1354,6,904,5,450,3528.356175,8.705169,830.7707754,413.5473993,Benign
192.168.43.233,51315,172.217.161.5,443,139,64308,59,11382,80,52926,3287.089941,542.722856,167.7762397,780.1550926,Benign
172.30.6.255,56939,103.15.158.129,443,4,240,2,120,2,120,1387.788757,10.284261,93.34652242,93.34652242,Benign
172.30.1.136,50141,104.17.39.113,80,13,1823,7,1098,6,725,115.382119,52.057891,168.7352259,111.4144251,Benign
172.30.6.255,56650,103.243.221.17,80,17,6258,9,4506,8,1752,1071.851133,19.217279,1875.811867,729.3436287,Benign
192.168.215.49,42982,158.85.224.178,443,7,478,4,272,3,206,1305.035142,21.39915082,101.686278,77.01240174,Benign
192.168.43.224,60168,151.101.153.2,443,8,552,5,338,3,214,880.0982816,33.9089687,79.74291475,50.48811762,Benign
172.30.15.1764,51076,157.240.16.39,443,17,5552,9,1091,8,4461,3638.823981,8.167962,1068.565206,4369.266165,Benign
192.168.43.233,51191,192.229.237.96,443,7,402,4,228,3,174,1102.529714,35.834803,50.90023796,38.84491844,Benign
172.30.6.255,57782,103.243.221.75,80,40,24255,23,20107,17,4148,3994.834925,47.224626,3406.188966,702.6842309,Benign
192.168.43.224,36112,107.21.25.13,443,6,412,4,272,2,140,57.15780674,15.19571908,143.198225,73.70496877,Benign
192.168.215.49,48508,52.222.190.45,443,1412,928972,607,122733,805,806239,472.6938806,343.1756414,2861.112159,18794.78384,Benign
10.0.2.15,41416,119.254.87.201,80,11,1513,6,705,5,808,20164.62033,1.652422,3413.171696,3911.83366,Malicious
192.168.43.224,44580,192.168.121.2,443,7,518,7,518,0,0,2461.522515,64.8017273,63.94891267,0,Benign
192.168.43.233,51042,172.82.241.224,443,10,564,7,390,3,174,822.128561,52.687997,59.21652326,26.41967961,Benign
172.30.15.1143,50451,192.229.237.25,443,11,1342,6,904,5,438,3458.317175,8.714795,829.8531406,402.0748623,Benign
192.168.43.224,37350,104.197.3.80,80,10,911,5,425,5,486,2189.539291,1.756148002,1936.055501,2213.936408,Benign
172.30.15.1441,50749,103.231.98.244,443,8,664,5,490,3,174,3501.437643,0.37713,10394.29374,3691.034922,Benign
10.0.2.15,53828,119.254.87.201,80,11,1579,6,705,5,874,16074.86646,4.045288,1394.214701,1728.430708,Malicious
192.168.137.97,47192,157.240.16.20,443,632,523226,250,20587,382,502639,224.182336,68.73241761,2396.190993,58503.86382,Benign
192.168.42.240,50995,172.217.163.67,443,36,6468,19,4950,17,1518,332.383125,38.807928,1020.410056,312.9257506,Benign
10.0.2.15,34163,119.254.87.201,80,11,1582,6,705,5,877,17852.09214,2.256465,2499.484814,3109.288201,Malicious
172.30.6.255,57938,103.243.221.17,80,21,10914,10,4562,11,6352,4526.867179,27.946237,1305.936109,1818.348567,Benign
10.0.2.15,47011,119.254.87.201,80,11,1582,6,705,5,877,15629.31983,1.678527,3360.088935,4179.855314,Malicious
172.30.15.2004,51316,151.101.194.2,443,20,9062,11,1240,9,7822,4079.554609,2.695087,3680.771715,23218.54545,Benign
172.30.1.136,50593,54.239.32.228,443,18,992,8,444,10,548,1597.872069,55.188764,64.3609268,79.4364592,Benign
192.168.43.233,50894,54.239.25.120,443,81,57723,49,49174,32,8549,153.193638,15.996351,24592.60865,4275.475076,Benign
10.0.2.15,39878,119.254.87.201,80,11,1582,6,705,5,877,973.450688,1.483318,3802.286496,4729.936534,Malicious
172.30.15.1972,51284,18.215.97.76,443,6,348,4,228,2,120,4076.524134,1.034806,1762.649231,927.7101215,Benign
172.30.15.331,49599,104.25.218.21,443,17,6442,9,1103,8,5339,956.191109,0.287246,30719.31376,148694.8469,Benign
10.0.2.15,39097,119.254.87.201,80,11,1579,6,705,5,874,23227.87947,1.489807,3785.725265,4693.225364,Malicious
10.0.2.15,40508,119.254.87.201,80,11,1513,6,705,5,808,22897.63315,1.71752,3283.804555,3763.566072,Malicious
192.168.43.224,57284,139.59.82.147,443,10,692,6,412,4,280,2583.983202,14.7721494,223.1225741,151.6367009,Benign
172.30.6.255,57305,157.240.16.39,443,30,5581,16,3341,14,2240,2436.085738,61.029817,437.9498631,293.626966,Benign
172.30.15.1212,50520,52.76.199.39,443,20,7894,10,3397,10,4497,3466.648016,10.86057,2502.262773,3312.53332,Benign
172.30.6.255,57183,172.30.16.59,7680,3,198,3,198,0,0,2038.438651,9.010741,175.7902042,0,Benign
192.168.43.224,38964,13.229.196.49,443,29,10071,16,2992,13,7079,60.73950056,101.8323384,235.0530329,556.1298196,Benign
10.0.2.15,59515,119.254.87.201,80,11,1582,6,705,5,877,3374.197921,1.288265,4377.981238,5446.084462,Malicious
10.0.2.15,53658,119.254.87.201,80,11,1579,6,705,5,874,4485.251051,0.883738,6381.98199,7911.847176,Malicious
10.0.2.15,53286,119.254.87.201,80,11,1582,6,705,5,877,14305.26085,1.358062,4152.976815,5166.185344,Malicious
172.30.6.255,58045,143.204.192.51,80,17,6406,10,2057,7,4349,4816.550366,56.112418,293.268417,620.0410041,Benign
172.30.6.255,57356,103.243.221.51,80,72,48237,43,40214,29,8023,2527.84649,34.200645,9406.60622,1876.689752,Benign
10.0.2.15,43338,119.254.87.201,80,11,1579,6,705,5,874,4877.654582,1.55929,3617.030828,4484.092119,Malicious
172.30.15.388,49656,62.210.213.13,80,34,22592,14,1538,20,21054,1466.437505,4.069247,3023.655236,41391.44171,Benign
192.168.137.97,41474,169.55.74.56,443,330,196686,144,27819,186,168867,4049.83596,21.92062096,10152.6321,61628.54613,Benign
192.168.43.233,50880,172.217.166.206,443,21,6002,11,1405,10,4597,35.450815,30.047233,374.0777063,1223.939655,Benign
10.0.2.15,47233,119.254.87.201,80,11,1587,6,705,5,882,22294.0288,0.960056,5874.657312,7349.571275,Malicious
172.30.6.255,57366,103.243.221.17,80,31,15576,19,13225,12,2351,2580.86336,18.210707,5809.768945,1032.799001,Benign
192.168.43.224,50110,49.44.178.251,80,34,3693,18,2073,16,1620,1687.121315,529.081059,31.34491345,24.49530139,Benign
10.0.2.15,56491,119.254.87.201,80,11,1582,6,705,5,877,15176.09164,1.026373,5495.0783,6835.721516,Malicious
192.168.43.233,51203,52.84.110.171,443,11,644,6,350,5,294,781.746765,124.612233,22.46970408,18.87455143,Benign
192.168.43.224,39144,169.55.74.49,443,9,598,5,338,4,260,1768.73478,123.4214086,21.90867881,16.85282985,Benign
192.168.137.97,50958,104.237.191.1,443,7,518,7,518,0,0,9499.944064,65.35607593,63.40649957,0,Benign
172.30.6.255,56714,103.243.220.231,80,28,16775,12,4388,16,12387,1170.844172,20.171405,1740.28532,4912.696959,Benign
192.168.43.233,51423,13.107.246.10,443,152,111583,64,4548,88,107035,3652.397214,124.528081,292.1750637,6876.200076,Benign
192.168.43.233,51387,210.176.156.35,443,14,784,13,718,1,66,3478.48739,203.318345,28.25126282,2.596912738,Benign
172.30.6.255,57546,103.243.220.231,80,28,12752,15,9292,13,3460,3188.844488,30.183276,2462.820802,917.0641384,Benign
192.168.43.233,51474,31.13.79.26,443,11,643,6,349,5,294,3816.213466,75.076917,37.1885276,31.32787139,Benign
172.30.6.255,56026,103.243.221.75,80,27,20100,10,3668,17,16432,237.858998,15.170113,1934.329692,8665.459512,Benign
172.30.6.255,58050,35.190.41.40,443,86,32228,37,5547,49,26681,4819.982368,52.575049,844.0505686,4059.872583,Benign
10.0.2.15,36735,119.254.87.201,80,12,1653,7,779,5,874,12445.68332,4.213759,1478.964507,1659.326032,Malicious
192.168.137.97,46820,52.84.110.231,443,12,1532,7,1038,5,494,1355.415338,26.68762525,311.1554484,148.0836142,Benign
172.30.6.255,57401,103.243.221.75,80,94,70513,58,59706,36,10807,2711.26119,58.798053,8123.534295,1470.388824,Benign
192.168.137.97,47440,161.202.24.166,443,18,2086,14,1599,4,487,207.5350093,81.00097279,157.9240293,48.09818778,Benign
192.168.137.97,41094,23.57.218.60,443,466,361071,215,24795,251,336276,53.09918926,131.6265342,1506.990982,20438.18913,Benign
192.168.215.49,39070,209.58.138.46,443,95,62802,46,14558,49,48244,604.9875018,220.584352,527.979428,1749.679868,Benign
10.0.2.15,54798,119.254.87.201,80,11,1582,6,705,5,877,24519.39536,1.427657,3950.528733,4914.345673,Malicious
172.30.15.2030,51342,172.217.166.198,443,27,7322,13,2338,14,4984,4090.559454,7.000812,2671.690084,5695.339341,Benign
172.30.1.136,50125,204.79.197.213,443,58,25260,29,5488,29,19772,102.651879,85.964453,510.7227286,1840.016361,Benign
172.30.1.136,50642,157.240.16.20,443,19,5289,10,1209,9,4080,1746.241033,28.23696,342.5297907,1155.9318,Benign
192.168.137.97,34204,172.217.161.3,443,14,976,8,556,6,420,62.81122417,21.40159202,207.8350057,156.9976662,Benign
172.30.1.136,51844,52.230.80.159,443,114,22238,63,9443,51,12795,3527.56955,2226.732758,33.92593913,45.96869545,Benign
192.168.137.97,50134,169.237.6.105,80,9,1795,5,742,4,1053,1956.807558,1.115613572,5320.838818,7551.001719,Benign
172.30.6.255,57163,157.240.16.39,443,28,5420,15,3274,13,2146,1948.082787,61.042765,429.0762386,281.2454514,Benign
172.30.6.255,58123,157.240.16.63,443,36,12150,21,10440,15,1710,4895.916745,3.320791,25150.63429,4119.500444,Benign
192.168.43.233,51248,157.240.16.16,443,26,3764,13,2024,13,1740,1853.686666,65.507894,247.1763174,212.4934745,Benign
172.30.15.2505,51839,14.139.45.128,80,10,1440,5,692,5,748,5475.857309,0.145924,37937.55654,41007.64782,Benign
10.0.2.15,41953,119.254.87.201,80,12,1634,7,779,5,855,6949.926758,4.50479,1383.416319,1518.383765,Malicious
10.0.2.15,50605,119.254.87.201,80,11,1579,6,705,5,874,1782.275961,1.674659,3367.849813,4175.17835,Malicious
192.168.43.224,52418,104.17.161.9,443,25,11205,14,1405,11,9800,36.91859849,12.9613125,867.1961269,6048.770138,Benign
172.30.15.1949,51261,64.74.232.52,443,15,2781,9,1956,6,825,4028.432981,8.786311,1780.952211,751.1684938,Benign
10.0.2.15,54009,119.254.87.201,80,11,1568,6,705,5,863,1483.968837,1.74283,3236.115972,3961.373169,Malicious
10.0.2.15,59422,119.254.87.201,80,11,1582,6,705,5,877,11725.01899,1.747644,3227.201879,4014.547585,Malicious
172.30.6.255,56108,103.243.221.87,443,6,340,4,228,2,112,306.556602,17.468304,104.4176928,51.2929017,Benign
192.168.137.97,40878,103.211.218.251,80,30,14712,16,5374,14,9338,609.8005171,11.61533207,3701.314758,6431.499295,Benign
10.0.2.15,50438,119.254.87.201,80,11,1579,6,705,5,874,2771.168791,1.619497,3482.562796,4317.389906,Malicious
10.0.2.15,36935,119.254.87.201,80,12,1587,7,779,5,808,16495.29713,7.396277,842.586074,873.9532065,Malicious
192.168.137.97,60260,172.217.161.4,443,13,1603,7,1043,6,560,5227.582215,16.27842058,512.5804409,275.210975,Benign
192.168.137.97,47010,52.84.110.17,443,11,1529,7,1038,4,491,1818.203626,21.17187071,392.2185297,185.5291889,Benign
192.168.137.97,50890,104.197.3.80,80,11,977,6,491,5,486,642.3172035,1.481378548,2651.584232,2624.582356,Benign
172.30.1.136,50656,146.112.234.69,80,14,2392,7,1006,7,1386,1763.266899,61.100805,131.7167589,181.4706042,Benign
172.30.1.136,51907,52.84.108.201,443,6273,5607113,2437,144632,3836,5462481,5470.890878,348.757502,3317.651931,125301.5283,Benign
192.168.137.97,50124,54.152.129.23,443,47,10346,25,3670,22,6676,3029.18266,11.7004631,2509.302389,4564.605653,Benign
172.30.15.600,49885,13.107.21.200,443,255,108481,117,19366,138,89115,2336.131267,10.31001,15026.94954,69148.33254,Benign
192.168.215.49,43648,34.227.208.227,443,39,8224,20,3055,19,5169,560.130995,84.01221161,290.9100895,492.214158,Benign
10.0.2.15,49626,119.254.87.201,80,12,1643,7,779,5,864,14635.60509,4.557419,1367.44065,1516.64791,Malicious
172.30.6.255,57757,157.240.16.39,443,21,2438,11,1576,10,862,3900.080578,61.037481,206.5616043,112.9797607,Benign
172.30.15.2465,51799,14.139.45.128,80,47,33667,22,2104,25,31563,5422.535142,1.735916,9696.321711,145458.6512,Benign
192.168.43.233,51273,52.84.108.135,443,30,2814,16,1575,14,1239,2652.308004,189.01119,66.66271981,52.44133958,Benign
192.168.43.233,51118,49.44.136.233,443,72,43162,35,3077,37,40085,920.136311,70.637276,348.4845593,4539.812662,Benign
192.168.43.233,50918,204.147.113.115,80,80,67711,29,1998,51,65713,398.138578,3.346205,4776.754562,157104.5408,Benign
172.30.15.937,50243,161.170.232.82,80,11,1706,6,815,5,891,3441.00004,6.264105,1040.851007,1137.91196,Benign
172.30.6.255,56562,13.107.6.158,443,30,7664,14,2515,16,5149,876.493865,125.247701,160.6416712,328.8842803,Benign
172.30.15.1343,50651,35.201.123.46,443,7,402,4,228,3,174,3491.797145,5.215131,349.7515211,266.9156345,Benign
192.168.43.233,51702,52.84.108.201,443,12393,10928733,4766,272546,7627,10656187,1841.279723,419.57732,5196.582122,203179.4664,Benign
172.30.6.255,55888,184.84.52.113,80,67,54381,23,4004,44,50377,112.010038,116.849112,274.1313088,3449.029206,Benign
172.30.6.255,58460,161.69.13.161,443,31,11941,15,3756,16,8185,5655.028571,85.045243,353.3178217,769.9431231,Benign
172.30.1.136,51549,52.230.85.180,443,58,26203,32,17250,26,8953,715.668391,25.47671,5416.711969,2811.352015,Benign
172.30.15.939,50245,103.15.158.128,443,25,10895,12,3192,13,7703,3441.018164,10.519969,2427.383579,5857.811938,Benign
192.168.43.233,50959,163.53.78.128,80,14,1777,8,747,6,1030,476.100936,103.34721,57.82449279,79.73122835,Benign
192.168.43.224,49834,52.207.90.113,443,1,66,1,66,0,0,9.425793427,0,0,0,Benign
172.30.15.311,49574,14.139.45.149,80,306,306423,73,4502,233,301921,728.92702,0.697139,51662.58092,3464686.382,Benign
172.30.6.255,56582,204.79.197.200,443,140,77169,64,15089,76,62080,897.057567,109.608392,1101.302535,4531.039923,Benign
172.30.6.255,57400,103.231.98.53,80,177,91060,89,82520,88,8540,2709.840001,339.267559,1945.838859,201.3749862,Benign
192.168.215.49,59886,54.148.63.115,443,14,1660,8,1080,6,580,517.1243354,13.33402736,647.966272,347.9818868,Benign
172.30.15.2147,51459,52.6.46.142,443,148,102448,75,38671,73,63777,4178.980995,18.64774,16590.1069,27360.74184,Benign
192.168.42.240,50947,172.217.24.68,443,15,858,8,456,7,402,179.206319,32.465936,112.3639251,99.05767078,Benign
172.30.15.829,50128,172.217.166.196,443,16,2965,8,1370,8,1595,3104.554916,0.392197,27945.13981,32534.67008,Benign
172.30.15.749,50039,128.199.67.15,443,25,9132,13,2174,12,6958,2576.19138,10.143434,1714.60671,5487.687897,Benign
172.30.6.255,57815,172.217.166.206,443,42,6980,22,4057,20,2923,4060.43806,70.233041,462.1186772,332.9487043,Benign
10.0.2.15,48047,119.254.87.201,80,11,1593,6,705,5,888,3251.770455,0.825983,6828.2277,8600.661273,Malicious
10.0.2.15,52807,119.254.87.201,80,11,1579,6,705,5,874,19200.58476,1.885878,2990.649448,3707.556905,Malicious
172.30.15.595,49880,23.56.25.241,443,17,7831,9,1141,8,6690,2321.31668,4.743305,1924.396597,11283.2719,Benign
192.168.43.233,50857,172.217.166.206,443,2,108,1,54,1,54,3.007337,0.124169,3479.129251,3479.129251,Benign
192.168.43.224,33464,172.217.166.206,443,10,723,4,264,6,459,18.23140909,104.4221761,20.22558884,35.16494423,Benign
172.30.15.591,49876,131.253.61.80,443,7,398,4,228,3,170,2315.296394,1.944478,938.040955,699.4165015,Benign
172.30.15.726,50013,104.31.90.207,80,19,5670,11,4302,8,1368,2416.979248,9.694578,3550.025592,1128.878431,Benign
192.168.43.224,39238,54.89.94.62,443,6,412,4,272,2,140,3250.97033,13.72012254,158.5991666,81.631924,Benign
10.0.2.15,58379,119.254.87.201,80,11,1579,6,705,5,874,24664.04888,2.2785,2475.312706,3068.685539,Malicious
192.168.43.233,51310,52.84.110.71,443,28,2503,15,1445,13,1058,3031.203541,255.805776,45.19053549,33.08760315,Benign
10.0.2.15,47804,119.254.87.201,80,11,1513,6,705,5,808,12413.31132,1.624089,3472.716089,3980.077446,Malicious
10.0.2.15,59784,119.254.87.201,80,12,1653,7,779,5,874,22834.80009,5.363239,1161.98439,1303.689804,Malicious
172.30.15.348,49616,162.125.82.3,443,20,6578,12,2056,8,4522,1126.649873,1.978586,8313.00737,18283.76426,Benign
192.168.137.97,39104,157.240.16.16,443,9,598,5,338,4,260,390.3347384,105.733997,25.57360998,19.67200768,Benign
192.168.137.97,47186,157.240.16.20,443,46,11682,23,2722,23,8960,219.9829844,70.47908268,308.9711042,1017.039344,Benign
172.30.6.255,58168,13.250.67.150,443,27,9545,14,2542,13,7003,4971.777419,69.552734,292.3824677,805.4895441,Benign
192.168.43.224,56840,18.233.7.102,443,20,4138,10,2896,10,1242,2429.407332,10.39379219,2229.022821,955.9552292,Benign
10.0.2.15,56451,119.254.87.201,80,12,1656,7,779,5,877,13852.45384,4.614731,1350.457914,1520.34864,Malicious
172.30.6.255,57979,161.69.226.21,443,5,330,1,66,4,264,4691.817385,15.631863,33.77716399,135.108656,Benign
10.0.2.15,41330,119.254.87.201,80,11,1579,6,705,5,874,18597.44753,1.820225,3098.51804,3841.283358,Malicious
172.30.1.136,51872,74.125.24.188,443,9,535,5,295,4,240,4185.789488,56.562517,41.72374437,33.94474118,Benign
192.168.137.97,47824,104.244.46.7,443,73,22831,42,4716,31,18115,22.42991791,258.4495965,145.9781733,560.7282888,Benign
172.30.6.255,56481,52.232.69.150,443,31,18789,15,1977,16,16812,803.688619,9.21363,1716.587273,14597.50392,Benign
192.168.43.233,51455,173.241.248.143,80,9,908,5,294,4,614,3811.432999,17.917474,131.2685036,274.1457864,Benign
192.168.42.240,50985,172.217.163.99,443,17,943,9,499,8,444,297.398805,68.597386,58.19463733,51.78039875,Benign
172.30.15.1982,51294,64.74.232.52,443,6,348,4,228,2,120,4076.839208,0.797889,2286.032268,1203.174878,Benign
172.30.15.1400,50708,8.41.222.241,443,35,14846,17,3092,18,11754,3499.799274,7.389684,3347.369116,12724.76604,Benign
192.168.215.49,60088,192.82.210.131,443,13,874,11,734,2,140,1252.800671,100.1346246,58.64105472,11.18494232,Benign
172.30.6.255,56554,157.240.16.39,443,30,5737,17,3551,13,2186,850.099469,61.060145,465.2461929,286.4061328,Benign
10.0.2.15,38211,119.254.87.201,80,11,1582,6,705,5,877,5266.085884,1.836957,3070.295059,3819.359952,Malicious
172.30.6.255,57179,157.240.16.39,443,19,1933,10,1125,9,808,2009.100901,61.014456,147.5060271,105.9421066,Benign
172.30.1.136,50647,157.240.16.20,443,21,2905,11,1844,10,1061,1746.393847,28.084672,525.2687302,302.2289169,Benign
192.168.43.233,51215,52.175.28.154,443,35,15292,20,6478,15,8814,1247.203871,124.778144,415.3291461,565.0989648,Benign
172.30.1.136,51559,204.79.197.213,443,1,66,1,66,0,0,741.095666,0,0,0,Benign
172.30.15.1164,50472,210.176.156.62,80,14,5126,8,3606,6,1520,3460.536657,6.734025,4283.91638,1805.755102,Benign
172.30.13.95,50850,172.30.6.255,80,2,132,2,132,0,0,3473.000136,2.715671,388.8541727,0,Benign
192.168.43.224,35142,104.198.143.177,80,10,911,5,425,5,486,1523.808998,1.213893716,2800.904194,3202.916325,Benign
192.168.43.224,50176,49.44.90.17,443,33,11112,15,2120,18,8992,37.91210668,6.227939001,2723.212285,11550.5306,Benign
172.30.6.255,56115,103.243.221.87,80,23,15191,8,2867,15,12324,323.861793,16.590033,1382.51684,5942.845322,Benign
172.30.6.255,56982,115.114.126.213,443,84,37193,32,6500,52,30693,1437.09257,333.5607,155.8936649,736.1298858,Benign
192.168.43.233,50848,172.217.166.195,443,2,108,2,108,0,0,3.006727,6.00E-05,0,0,Benign
192.168.43.233,50710,172.217.166.206,443,23,7204,11,1663,12,5541,1843.412632,12.514878,1063.05471,3542.024141,Benign
192.168.43.233,51194,104.24.19.71,443,24713,21008789,9793,604271,14920,20404518,1139.297734,1139.903097,4240.85873,143201.7725,Benign
172.30.1.136,50793,74.125.68.188,443,23,2686,13,1558,10,1128,1931.586141,43.194482,288.5553761,208.915574,Benign
192.168.137.97,45818,52.84.110.78,443,23,7465,13,1517,10,5948,73.32386701,18.36440557,660.8436062,2591.099387,Benign
192.168.137.97,39330,172.217.160.238,443,15,1042,8,568,7,474,7409.06676,65.63575663,69.23055715,57.77338748,Benign
172.30.1.136,50209,52.95.120.67,443,8,452,4,228,4,224,368.457075,13.715803,132.9852871,130.6522119,Benign
192.168.43.233,51174,172.217.161.1,443,35,29221,11,3531,24,25690,549.196483,7.777412,3632.056525,26425.24274,Benign
172.30.6.255,57464,103.243.221.17,80,24,10877,14,8287,10,2590,2926.847236,24.182196,2741.521076,856.8287181,Benign
192.168.43.233,51487,23.43.115.95,443,26,8383,14,2211,12,6172,3818.721701,235.201154,75.20371265,209.9309428,Benign
10.0.2.15,34398,119.254.87.201,80,12,1628,7,779,5,849,25264.6771,4.001465,1557.429591,1697.378335,Malicious
172.30.1.136,51482,52.84.110.227,443,1,118,0,0,1,118,35.449189,0,0,0,Benign
172.30.6.255,58143,157.240.16.39,443,29,5474,16,3329,13,2145,4937.092331,61.030326,436.3732221,281.1716916,Benign
192.168.137.97,41622,104.198.143.177,80,11,977,6,491,5,486,1981.52902,1.365438906,2876.730685,2847.436076,Benign
172.30.6.255,57648,103.243.221.75,80,16,9381,11,8289,5,1092,3517.091858,39.969547,1659.063086,218.5664001,Benign
172.30.1.136,50481,172.217.161.3,443,43,5862,18,3372,25,2490,922.694841,32.00044,842.9884089,622.4914407,Benign
192.168.43.224,55178,23.66.246.24,443,40,9585,22,2894,18,6691,1904.625467,369.885909,62.59227355,144.7148937,Benign
192.168.137.97,60984,206.189.157.46,443,32,9094,17,2506,15,6588,422.2007808,146.1417525,137.1818776,360.636157,Benign
192.168.43.224,37454,157.240.16.20,443,16,5160,9,1183,7,3977,35.02159016,14.85847672,636.9428158,2141.269297,Benign
192.168.215.49,49942,172.217.161.14,443,18,5818,9,1224,9,4594,1517.853496,10.64171326,920.1525882,3453.57924,Benign
192.168.43.224,39106,103.37.200.184,443,61,32404,31,4827,30,27577,2583.732685,19.01333357,2030.995767,11603.22566,Benign
172.30.6.255,57338,172.217.166.206,443,17,1779,10,1150,7,629,2473.414317,63.03502,145.950616,79.82864129,Benign
192.168.137.97,42722,157.240.16.39,443,37,11931,20,9135,17,2796,150.159777,135.9957687,537.3696603,164.4757055,Benign
172.30.15.1069,50375,108.59.8.1,80,12,1393,7,922,5,471,3452.723689,1.491294,4946.04015,2526.664762,Benign
172.30.6.255,55631,157.240.16.63,443,100,68754,37,11528,63,57226,17.870868,40.732314,2264.148312,11239.4302,Benign
172.30.15.1674,50985,54.201.247.66,443,43,9406,23,7294,20,2112,3596.618718,20.836844,2800.424095,810.8713584,Benign
172.30.15.1965,51277,18.215.97.76,443,69,24348,34,5750,35,18598,4076.273187,6.294318,7308.178583,23637.82701,Benign
192.168.42.240,51040,216.58.221.35,443,2,132,2,132,0,0,615.133483,3.001073,351.8741463,0,Benign
10.0.2.15,43247,119.254.87.201,80,11,1513,6,705,5,808,3405.967981,1.684931,3347.31808,3836.358878,Malicious
172.30.15.1033,50339,173.241.248.143,80,6,535,4,228,2,307,3447.067563,10.188619,179.0232808,241.0532772,Benign
172.30.1.136,51881,74.125.68.188,5228,29,2882,15,1612,14,1270,4417.521093,278.381867,46.32485635,36.49663,Benign
10.0.2.15,58314,119.254.87.201,80,11,1582,6,705,5,877,25180.00965,2.233686,2524.974414,3140.996541,Malicious
192.168.43.233,50979,49.44.170.2,443,594,453016,255,41516,339,411500,502.154315,658.743823,504.1838548,4997.390313,Benign
192.168.43.233,51126,35.186.193.174,443,234,174184,96,7772,138,166412,921.267914,241.464452,257.4954594,5513.424394,Benign
192.168.43.224,60270,172.217.194.189,443,7,466,4,272,3,194,75.51894112,34.92340622,62.30778254,44.4401096,Benign
192.168.43.233,51306,104.244.42.194,443,7,402,4,228,3,174,2532.28767,59.313747,30.75172439,23.46842124,Benign
172.30.15.835,50137,34.232.42.95,443,6,348,4,228,2,120,3214.096633,2.963133,615.5646743,323.9814075,Benign
192.168.43.224,36798,169.55.74.36,443,27,7859,14,3039,13,4820,1154.180146,1.083665609,22434.96499,35582.9323,Benign
192.168.43.233,51199,172.217.160.227,443,9,535,5,295,4,240,724.608114,57.720058,40.8869998,33.26399984,Benign
172.30.1.136,50198,52.95.120.67,80,10,580,6,348,4,232,358.034997,20.818589,133.7266421,89.15109473,Benign
172.30.6.255,57770,103.243.221.75,80,55,36977,33,31741,22,5236,3975.885543,19.165142,13249.47136,2185.634732,Benign
10.0.2.15,53178,119.254.87.201,80,11,1569,6,705,5,864,5173.719043,1.222625,4613.025253,5653.409672,Malicious
192.168.43.224,46110,104.17.40.113,443,8,476,5,290,3,186,36.7639331,14.28839654,162.3695138,104.1404468,Benign
192.168.43.224,39110,52.91.190.240,443,334,56642,174,15732,160,40910,81.75574867,2607.005272,48.2760819,125.5386798,Benign
10.0.2.15,37991,119.254.87.201,80,11,1513,6,705,5,808,461.133479,1.182667,4768.882534,5465.61289,Malicious
10.0.2.15,41301,119.254.87.201,80,11,1579,6,705,5,874,7278.123044,0.825099,6835.543371,8474.134619,Malicious
172.30.6.255,55615,157.240.16.20,443,1635,1627691,409,39411,1226,1588280,2.592748,56.010557,5629.081675,226854.3768,Benign
172.30.15.669,49956,52.84.110.109,80,62,40693,32,3414,30,37279,2397.196109,8.980938,3041.107733,33207.22178,Benign
172.30.15.2062,51374,54.236.156.42,443,37,10822,19,6006,18,4816,4104.555088,2.970614,16174.43397,12969.70929,Benign
192.168.137.97,46906,54.85.227.48,443,34,9384,19,2955,15,6429,3028.332935,52.54974852,449.8594316,978.7297076,Benign
10.0.2.15,40935,119.254.87.201,80,11,1582,6,705,5,877,4605.366312,1.814206,3108.798009,3867.25653,Malicious
10.0.2.15,46550,119.254.87.201,80,11,1582,6,705,5,877,6104.472686,0.840462,6710.594887,8347.789668,Malicious
172.30.6.255,58242,35.190.43.164,80,10,1629,6,1175,4,454,5221.892002,37.126358,253.1893918,97.82807137,Benign
172.30.6.255,57723,103.243.221.87,80,16,5473,9,4245,7,1228,3738.840542,23.27449,1459.108234,422.0930298,Benign
172.30.15.628,49915,104.16.208.165,443,37,11050,18,2350,19,8700,2392.429481,3.743206,5022.432642,18593.6868,Benign
10.0.2.15,51569,119.254.87.201,80,13,1727,8,853,5,874,851.439606,9.84374,693.2324503,710.2991343,Malicious
192.168.137.97,55244,52.172.156.220,443,9,626,6,412,3,214,8274.754302,17.20009026,191.6269014,99.53436139,Benign
10.0.2.15,46839,119.254.87.201,80,11,1582,6,705,5,877,11695.01191,1.447838,3895.463443,4845.846013,Malicious
172.30.6.255,56185,8.41.222.241,80,13,1968,6,834,7,1134,466.613953,7.450855,895.4677014,1217.578385,Benign
192.168.137.97,33432,172.217.161.5,443,1178,1070801,435,30800,743,1040001,4932.843006,242.6533894,1015.440174,34287.62327,Benign
172.30.1.136,50364,52.84.108.177,80,42,20117,22,2469,20,17648,652.665916,130.79803,151.0114487,1079.404636,Benign
172.30.6.255,57463,103.243.221.17,80,33,18687,16,9316,17,9371,2926.845305,24.184423,3081.653013,3099.846542,Benign
10.0.2.15,34104,119.254.87.201,80,11,1579,6,705,5,874,15866.86011,1.026824,5492.66476,6809.3461,Malicious
192.168.43.233,51701,172.217.166.206,443,25,2306,12,1244,13,1062,1812.966871,286.197624,34.77317478,29.68578104,Benign
172.30.6.255,57404,103.243.221.17,80,31,19016,15,9262,16,9754,2721.859573,48.199669,1537.271968,1618.932279,Benign
10.0.2.15,46609,119.254.87.201,80,11,1513,6,705,5,808,12923.81455,2.206559,2556.015951,2929.448068,Malicious
172.30.6.255,56734,103.243.221.75,80,14,5429,8,4255,6,1174,1222.955296,0.557749,61031.03726,16839.1158,Benign
192.168.137.97,57368,104.244.46.135,443,10,684,6,404,4,280,680.4272827,58.98537895,54.79323958,37.97551258,Benign
172.30.6.255,58506,103.243.221.87,80,25,14414,11,5347,14,9067,5747.864758,1.35288,31618.47318,53615.98959,Benign
10.0.2.15,36459,119.254.87.201,80,11,1582,6,705,5,877,2324.867506,1.42248,3964.906361,4932.231033,Malicious
172.30.1.136,50554,54.229.103.82,443,38,16089,21,2743,17,13346,1471.96342,28.042305,782.5319638,3807.390298,Benign
172.30.15.612,49899,151.139.104.40,80,6,348,4,228,2,120,2389.290515,7.005691,260.3597561,137.0314506,Benign
172.30.6.255,57943,103.243.221.17,80,12,6637,9,5605,3,1032,4558.857747,1.2473,35949.65125,6619.09725,Benign
192.168.43.233,51459,49.44.178.243,80,9,2166,5,756,4,1410,3813.390437,4.138664,1461.341148,2725.51722,Benign
172.30.15.1023,50329,50.116.239.135,443,29,8860,16,3045,13,5815,3446.634573,10.309349,2362.903807,4512.409076,Benign
192.168.137.97,54068,140.98.193.112,443,46,25181,25,10493,21,14688,15.80060447,19.23738594,4363.586625,6108.106389,Benign
192.168.137.97,56164,172.217.161.14,443,20,6927,11,1521,9,5406,342.027858,13.68318941,889.2663573,3160.666619,Benign
172.30.6.255,56845,157.240.16.39,443,41,9435,23,6188,18,3247,1338.093488,122.052458,405.5960921,212.8265209,Benign
192.168.43.224,41088,103.102.166.224,443,22,6371,12,1414,10,4957,730.1096034,13.46361745,840.1902417,2945.419398,Benign
10.0.2.15,60860,119.254.87.201,80,11,1582,6,705,5,877,8091.067633,4.150182,1358.976546,1690.528271,Malicious
192.168.215.49,56932,13.228.153.206,443,82,25575,46,7081,36,18494,612.209713,67.98447871,833.2490162,2176.261447,Benign
10.0.2.15,47393,119.254.87.201,80,13,1661,8,853,5,808,16197.17539,11.251335,606.5058058,574.5096026,Malicious
172.30.6.255,56995,115.114.126.194,443,15,6740,8,1054,7,5686,1480.377423,18.095114,465.982143,2513.827766,Benign
10.0.2.15,59072,119.254.87.201,80,11,1534,6,705,5,829,12145.41826,1.423945,3960.827139,4657.48326,Malicious
172.30.15.856,50162,180.149.59.138,80,40,31159,16,1375,24,29784,3433.443968,3.60041,3055.207601,66179.1296,Benign
172.30.6.255,58398,157.240.16.39,443,29,5966,16,3473,13,2493,5547.098547,61.051143,455.0938547,326.6769305,Benign
172.30.1.136,50421,74.125.24.188,5228,3,198,3,198,0,0,833.104392,8.999831,176.003305,0,Benign
172.30.15.1931,51243,34.201.201.2,443,36,8918,22,2985,14,5933,3991.667981,5.784894,4127.992665,8204.817582,Benign
192.168.43.233,51065,49.44.170.52,443,5,294,3,174,2,120,896.290838,11.61739,119.8203727,82.63473982,Benign
192.168.43.233,50983,74.207.230.33,443,42,20424,20,2970,22,17454,509.044274,75.315619,315.4724122,1853.958075,Benign
192.168.43.233,51640,52.46.6.89,443,11,654,6,348,5,306,839.735878,15.2235,182.8751601,160.8040201,Benign
10.0.2.15,59705,119.254.87.201,80,11,1582,6,705,5,877,3281.781964,1.628095,3464.171317,4309.330844,Malicious
172.30.15.1697,51008,184.29.25.7,443,75,54519,35,19501,40,35018,3609.576196,7.552484,20656.51513,37092.96173,Benign
192.168.43.224,45816,54.173.101.22,443,33,6841,18,2217,15,4624,705.5588457,62.00573503,286.0380575,596.5899764,Benign
172.30.15.2248,51565,104.121.244.70,443,115,82739,55,7627,60,75112,4468.154465,9.577454,6370.795412,62740.68244,Benign
172.30.6.255,56171,35.190.43.164,80,97,29107,50,21561,47,7546,434.87665,421.236584,409.4801035,143.3113891,Benign
192.168.43.224,33550,18.211.245.141,443,27,6444,14,1966,13,4478,1153.413891,68.40277753,229.9321836,523.7214232,Benign
172.30.6.255,56610,172.30.6.35,80,3,198,3,198,0,0,959.371959,9.003521,175.9311718,0,Benign
10.0.2.15,57803,119.254.87.201,80,11,1579,6,705,5,874,1872.356559,1.221038,4619.020866,5726.275513,Malicious
10.0.2.15,59163,119.254.87.201,80,11,1579,6,705,5,874,8386.67533,1.421265,3968.295849,4919.561095,Malicious
172.30.15.2307,51636,87.250.251.119,443,6,348,4,228,2,120,4998.61624,9.164141,199.0366582,104.7561359,Benign
10.0.2.15,37285,119.254.87.201,80,11,1579,6,705,5,874,13857.37418,1.41834,3976.479547,4929.706558,Malicious
172.30.6.255,57223,103.243.220.231,80,36,22484,16,8594,20,13890,2157.844769,41.489836,1657.080544,2678.246306,Benign
192.168.43.224,58786,104.197.3.80,80,11,977,6,491,5,486,1222.808966,1.378442508,2849.592912,2820.574654,Benign
192.168.215.49,56672,104.25.219.21,443,76,22518,39,3587,37,18931,80.32640992,403.0594964,71.19544449,375.7460161,Benign
10.0.2.15,39777,119.254.87.201,80,12,1656,7,779,5,877,14728.393,4.816687,1293.835369,1456.602848,Malicious
192.168.215.49,43276,52.76.101.181,443,37,9806,19,2909,18,6897,612.5599548,67.92314709,342.6225226,812.3298517,Benign
10.0.2.15,34162,119.254.87.201,80,11,1579,6,705,5,874,15055.9531,3.056141,1845.464591,2287.852557,Malicious
192.168.43.233,51013,163.53.78.128,443,26,11045,15,3384,11,7661,689.903819,39.299436,688.8648478,1559.513475,Benign
192.168.137.97,35104,104.198.143.177,80,11,977,6,491,5,486,5423.812928,1.143333919,3435.566753,3400.581348,Benign
172.30.6.255,56797,103.243.221.51,80,6,340,4,228,2,112,1254.102953,10.942089,166.6957745,81.88564359,Benign
172.30.6.255,56711,103.243.221.46,80,25,13717,15,11561,10,2156,1170.836756,20.178821,4583.419418,854.7575698,Benign
172.30.1.136,50386,172.217.161.3,443,20,5080,14,4696,6,384,700.937975,38.595593,973.3753799,79.59457962,Benign
10.0.2.15,45496,119.254.87.201,80,11,1582,6,705,5,877,4422.969897,1.886422,2989.787015,3719.21023,Malicious
172.30.1.136,50284,52.84.103.186,443,14,864,8,492,6,372,484.253785,25.599519,153.7528889,116.2521843,Benign
172.30.15.1683,50994,184.29.25.7,443,91,52069,36,3960,55,48109,3606.990416,10.136281,3125.406646,37969.74452,Benign
172.30.6.255,56616,172.217.166.206,443,17,1779,10,1150,7,629,968.423268,81.789292,112.4841624,61.52394619,Benign
172.30.15.2217,51532,104.121.244.70,443,408,341053,172,20725,236,320328,4442.213665,15.60783,10622.87326,164188.3593,Benign
10.0.2.15,47732,119.254.87.201,80,11,1579,6,705,5,874,15624.34805,1.691172,3334.965338,4134.410929,Malicious
10.0.2.15,37378,119.254.87.201,80,12,1656,7,779,5,877,5233.748973,5.410132,1151.912744,1296.826029,Malicious
10.0.2.15,36540,119.254.87.201,80,11,1579,6,705,5,874,21065.52276,1.891824,2981.249841,3695.904059,Malicious
172.30.6.255,57900,103.243.221.75,80,21,11079,10,4562,11,6517,4405.841624,12.220475,2986.463292,4266.282612,Benign
192.168.137.97,47204,157.240.16.20,443,19,5323,11,1279,8,4044,225.2782727,1.149284361,8902.931552,28149.69132,Benign
192.168.137.97,48362,172.217.194.189,443,13,894,7,494,6,400,3522.459847,37.35574085,105.7936454,85.66287075,Benign
10.0.2.15,34688,119.254.87.201,80,13,1727,8,853,5,874,20825.25556,10.659765,640.1642062,655.9244036,Malicious
172.30.6.255,55817,8.41.222.241,80,7,398,3,174,4,224,90.877117,7.449366,186.8615396,240.5573843,Benign
192.168.137.97,57566,104.198.143.177,80,11,977,6,491,5,486,1662.829743,1.100874743,3568.071686,3531.736943,Benign
10.0.2.15,40904,119.254.87.201,80,12,1653,7,779,5,874,1602.134091,3.821456,1630.792033,1829.66911,Malicious
192.168.43.224,58880,52.211.15.183,443,55,11571,29,3518,26,8053,1635.551675,107.0273189,262.9608989,601.9397724,Benign
172.30.6.255,58072,176.34.147.227,443,38,15440,21,9099,17,6341,4828.376369,44.321792,1642.352367,1144.53856,Benign
192.168.43.233,51493,35.177.33.121,443,31,9914,15,2782,16,7132,3828.395317,163.004452,136.5361481,350.0272496,Benign
10.0.2.15,42761,119.254.87.201,80,11,1582,6,705,5,877,4547.367903,1.089342,5177.437389,6440.585234,Malicious
10.0.2.15,45094,219.234.85.216,80,11,1631,6,796,5,835,36785.37344,2.628703,2422.48744,2541.177151,Malicious
10.0.2.15,45994,119.254.87.201,80,11,1579,6,705,5,874,6284.623051,4.306269,1309.718459,1623.679338,Malicious
192.168.43.224,38688,23.213.72.244,443,34,7996,19,2519,15,5477,2296.460215,72.23727866,278.9695345,606.5566258,Benign
172.30.6.255,56518,23.198.119.247,443,13,3346,7,1179,6,2167,831.968082,41.616915,226.6386156,416.561391,Benign
172.30.6.255,58006,52.175.39.99,443,36,9105,20,3751,16,5354,4738.822501,1.77428,16912.77589,24140.49643,Benign
192.168.137.97,39418,172.217.161.4,443,40,6960,24,3741,16,3219,280.7607512,59.50497551,502.949539,432.7705335,Benign
192.168.215.71,10002,104.36.224.25,5223,9,594,0,0,9,594,1704.97998,70.53286148,0,67.37285146,Benign
192.168.137.97,50692,205.185.208.52,80,63,38627,32,2725,31,35902,8274.178791,22.86043015,953.6128524,12563.89307,Benign
10.0.2.15,56369,119.254.87.201,80,11,1513,6,705,5,808,21723.25808,2.016581,2796.813022,3205.425421,Malicious
172.30.15.925,50231,50.31.185.52,443,6,348,4,228,2,120,3440.545589,6.718124,271.5043664,142.8970349,Benign
192.168.215.49,38258,205.185.216.42,443,19,3894,10,1613,9,2281,790.7876513,34.7844199,370.9706827,524.6026828,Benign
192.168.137.97,34368,172.217.161.3,443,9,638,8,572,1,66,236.1446527,65.13421155,70.25493809,8.10633901,Benign
192.168.43.224,45540,192.0.73.2,443,46,17715,24,2534,22,15181,1202.776209,11.24146824,1803.323158,10803.57098,Benign
10.0.2.15,48814,119.254.87.201,80,11,1582,6,705,5,877,22026.67397,2.031695,2776.007225,3453.274237,Malicious
172.30.6.255,55796,184.29.25.201,443,38,11107,20,3994,18,7113,86.365637,308.116698,103.7009685,184.6832722,Benign
10.0.2.15,33774,119.254.87.201,80,11,1579,6,705,5,874,492.914688,1.68523,3346.724186,4148.988565,Malicious
172.30.6.255,58538,35.190.41.40,443,38,13258,18,3048,20,10210,5801.815498,7.3087,3336.297837,11175.72208,Benign
10.0.2.15,37442,119.254.87.201,80,11,1579,6,705,5,874,12715.93884,2.284444,2468.872076,3060.700985,Malicious
172.30.15.651,49938,180.149.59.224,80,24,11927,12,994,12,10933,2395.635115,10.528335,755.2951155,8307.486416,Benign
172.30.15.1048,50354,210.176.156.55,443,23,9295,13,5597,10,3698,3448.024044,9.195739,4869.211708,3217.1422,Benign
172.30.6.255,58240,103.243.221.109,80,25,14095,11,5347,14,8748,5221.883165,37.675511,1135.379425,1857.546139,Benign
172.30.6.255,55669,35.186.249.84,443,45,11811,19,5462,26,6349,39.459637,19.429675,2248.931081,2614.14563,Benign
172.30.6.255,56371,52.114.76.35,443,44,32332,26,25329,18,7003,611.629622,128.481575,1577.128861,436.0469585,Benign
172.30.15.2482,51816,14.139.45.128,80,176,172475,55,3389,121,169086,5424.978268,5.569573,4867.877663,242871.0424,Benign
172.30.6.255,57454,103.243.221.17,80,16,5473,9,4245,7,1228,2890.857407,31.174931,1089.336814,315.1249958,Benign
192.168.43.233,51219,52.114.132.73,443,23,9007,13,3889,10,5118,1533.878892,12.567164,2475.657993,3258.014298,Benign
10.0.2.15,51855,119.254.87.201,80,11,1513,6,705,5,808,14187.78512,1.115552,5055.793007,5794.440779,Malicious
172.30.6.255,56046,204.79.197.200,443,33,10566,16,2128,17,8438,254.231101,124.248844,137.0153593,543.2968052,Benign
172.30.6.255,56230,103.229.206.182,80,6,348,4,228,2,120,470.670753,20.350518,89.62916816,47.1732464,Benign
10.0.2.15,39852,119.254.87.201,80,12,1656,7,779,5,877,8571.55814,3.936812,1583.006758,1782.152666,Malicious
172.30.15.1063,50369,23.23.178.66,80,23,7609,14,6593,9,1016,3452.289021,17.543567,3006.458151,463.3037284,Benign
192.168.137.97,37984,144.76.137.80,443,8,544,5,338,3,206,38.30287574,58.59337656,46.14856079,28.12604593,Benign
172.30.6.255,56126,18.211.245.141,443,27,6171,13,1765,14,4406,340.265851,60.796294,232.2509987,579.7721815,Benign
172.30.6.255,56375,103.243.221.46,80,6,348,4,228,2,120,631.874302,18.183141,100.3127017,52.79615882,Benign
172.30.1.136,51503,13.107.21.200,443,1,54,0,0,1,54,115.953817,0,0,0,Benign
192.168.137.97,45450,104.17.41.113,443,365,181192,177,12954,188,168238,631.5924443,1000.827247,103.5463416,1344.791525,Benign
10.0.2.15,50976,119.254.87.201,80,11,1579,6,705,5,874,1091.649122,1.814673,3107.99797,3853.035781,Malicious
10.0.2.15,60778,119.254.87.201,80,11,1582,6,705,5,877,16230.07586,1.557306,3621.638907,4505.216059,Malicious
192.168.43.224,49828,52.207.90.113,443,6,473,2,132,4,341,27.81542074,14.31628577,73.76214873,190.5522176,Benign
172.30.6.255,55787,172.217.166.202,443,21,4414,11,1054,10,3360,69.428746,100.711605,83.7242143,266.9007211,Benign
192.168.137.97,56172,172.217.161.14,443,19,6016,10,1443,9,4573,342.0767329,13.63423196,846.6923574,2683.246119,Benign
172.30.15.1653,50964,184.29.25.7,443,63,48485,24,4223,39,44262,3580.138569,7.360443,4589.941122,48107.97394,Benign
10.0.2.15,56092,119.254.87.201,80,11,1582,6,705,5,877,823.272893,0.887569,6354.435542,7904.737547,Malicious
172.30.6.255,56963,115.114.126.213,443,13,1454,7,958,6,496,1404.323302,15.015757,510.3971781,264.2557415,Benign
192.168.137.97,41918,23.57.214.252,443,12,840,7,478,5,362,31.20065355,21.62604484,176.8238265,133.912605,Benign
192.168.43.233,51240,172.217.160.229,443,90,38577,46,32260,44,6317,1634.692136,255.53647,1009.953687,197.7643348,Benign
172.30.1.136,50822,52.230.84.217,443,45,10225,23,3464,22,6761,1963.354136,3.968396,6983.174058,13629.68817,Benign
172.30.15.1256,50564,54.85.78.249,80,6,348,4,228,2,120,3469.527073,8.097862,225.2446386,118.5498098,Benign
172.30.15.1088,50394,162.210.197.200,80,7,402,4,228,3,174,3453.014136,4.306504,423.5454095,323.232023,Benign
172.30.15.511,49793,162.247.242.19,443,7,398,4,228,3,170,2029.427543,6.815348,267.6312347,199.5496048,Benign
172.30.15.999,50305,104.121.243.213,80,10,1992,5,837,5,1155,3443.22315,0.31025,21582.59468,29782.43352,Benign
172.30.1.136,51546,52.84.110.135,443,18,6918,10,1210,8,5708,713.975725,18.580422,520.9784794,2457.640628,Benign
172.30.6.255,56631,103.243.221.17,80,31,23654,11,4614,20,19040,1011.893073,13.178368,2800.953806,11558.3356,Benign
172.30.6.255,55624,157.240.16.17,443,14,4869,7,971,7,3898,5.26751,0.086798,89495.14966,359270.9509,Benign
172.30.1.136,50486,172.217.161.3,443,18,1884,10,1179,8,705,945.715042,9.42207,1001.053909,598.5945764,Benign
172.30.6.255,56166,103.243.221.17,80,31,26461,9,3923,22,22538,434.860818,30.168803,1040.279921,5976.504935,Benign
172.30.6.255,57798,103.243.221.46,80,16,5769,9,4541,7,1228,4041.920125,3.437385,10568.49902,2857.986522,Benign
10.0.2.15,52418,219.234.85.243,80,8,940,4,684,4,256,183.262998,64.291879,85.11183815,31.85472305,Malicious
172.30.15.1079,50385,54.37.85.231,80,6,360,3,198,3,162,3452.787225,1.812348,874.0043303,715.0944521,Benign
172.30.15.1761,51073,184.29.25.7,443,30,18091,13,3684,17,14407,3638.451624,8.719643,3379.95489,13217.97234,Benign
10.0.2.15,33746,119.254.87.201,80,11,1579,6,705,5,874,25565.03633,1.290863,4369.170082,5416.531421,Malicious
192.168.43.224,38500,140.98.193.112,443,34,16722,18,4433,16,12289,3265.897881,9.483497857,3739.54848,10366.63913,Benign
172.30.1.136,50413,172.217.161.4,443,7,402,4,228,3,174,827.299063,4.104564,444.3833742,339.1346803,Benign
10.0.2.15,36377,119.254.87.201,80,11,1513,6,705,5,808,22053.60739,2.042973,2760.682593,3164.016362,Malicious
192.168.137.97,54828,52.84.108.88,443,9,618,5,338,4,280,1839.755642,63.813087,42.37375321,35.10251745,Benign
172.30.6.255,56389,119.81.99.200,443,29,7567,15,2452,14,5115,650.67256,205.518169,95.44654906,199.1064839,Benign
172.30.29.42,59040,172.30.1.136,31461,2,132,2,132,0,0,3673.569322,2.058441,513.0096029,0,Benign
192.168.43.233,51160,172.217.160.238,443,18,5759,9,1285,9,4474,480.461211,20.146171,510.2706614,1776.615517,Benign
172.30.15.1162,50470,103.243.220.231,80,11,2984,7,1971,4,1013,3460.531432,7.095861,2222.140484,1142.074232,Benign
192.168.137.97,41306,157.240.16.16,443,31,7517,16,2435,15,5082,5244.570316,65.29465714,298.3398773,622.6543148,Benign
172.30.15.1521,50829,34.199.78.214,443,6,348,4,228,2,120,3526.093072,1.105393,1650.091868,868.4694041,Benign
172.30.15.1534,50842,107.6.122.24,443,16,4414,9,2563,7,1851,3528.382086,8.669962,2364.946928,1707.965963,Benign
172.30.1.136,51495,172.217.161.3,443,13,817,6,328,7,489,40.976032,148.875796,17.62543053,26.27693759,Benign
192.168.43.224,54090,151.101.194.217,443,9,618,5,338,4,280,66.21315642,15.77261769,171.4363495,142.0182777,Benign
172.30.6.255,58472,161.69.45.59,443,26,12171,12,4767,14,7404,5678.434218,9.993725,3815.994537,5926.919142,Benign
192.168.137.97,44546,74.125.24.188,443,54,9395,29,2796,25,6599,10925.45755,687.1611356,32.55131707,76.8262308,Benign
172.30.1.136,50433,52.84.103.186,443,1,66,1,66,0,0,857.260505,0,0,0,Benign
192.168.43.224,60694,54.165.86.233,443,76,19542,39,4306,37,15236,54.43637018,613.7243442,56.12943388,198.6038213,Benign
192.168.43.233,51376,52.212.88.15,443,21,2924,12,1694,9,1230,3477.111662,148.325464,91.36664491,66.34059813,Benign
172.30.6.255,56953,23.198.141.211,443,33,9464,16,2805,17,6659,1389.708187,306.205741,73.28406034,173.9745304,Benign
192.168.137.97,47764,151.101.64.223,443,23,8372,13,2076,10,6296,2063.61891,0.392129767,42353.32637,128447.275,Benign
10.0.2.15,51306,119.254.87.201,80,11,1544,6,705,5,839,20099.02468,2.212152,2549.553557,3034.149552,Malicious
172.30.6.255,57738,103.243.221.87,80,14,5372,8,4191,6,1181,3799.836965,1.017186,32961.52326,9288.370072,Benign
172.30.6.255,55658,35.190.43.164,80,44,15491,21,12429,23,3062,37.639266,20.972907,4740.973676,1167.983055,Benign
10.0.2.15,49851,115.182.31.2,80,8,756,4,500,4,256,36784.88899,0.66673,5999.430054,3071.708188,Malicious
192.168.43.233,51250,13.107.21.200,443,29,10355,16,1312,13,9043,2196.701223,61.294645,171.2384499,1180.266237,Benign
192.168.43.224,57664,13.32.226.81,443,20,7795,11,1377,9,6418,93.44083988,12.8108023,859.8993057,4007.867643,Benign
192.168.43.224,45024,157.240.16.52,443,8,544,5,338,3,206,2084.942636,59.20468634,45.67206022,27.83563434,Benign
10.0.2.15,37842,119.254.87.201,80,11,1513,6,705,5,808,24784.16281,2.084384,2705.835393,3101.156025,Malicious
172.30.15.688,49975,104.16.208.165,443,42,12004,22,2392,20,9612,2399.905874,6.288926,3042.808899,12227.207,Benign
192.168.43.233,51057,23.213.64.67,443,64,36287,33,2757,31,33530,891.087707,107.299108,205.5562289,2499.927586,Benign
192.168.137.97,41464,104.244.42.193,443,54,21525,28,14565,26,6960,304.5822886,80.10945036,1454.510042,695.0490828,Benign
192.168.43.233,51046,23.213.64.67,443,23,9425,9,1141,14,8284,887.655674,0.294518,30993.01231,225018.5048,Benign
10.0.2.15,57215,119.254.87.201,80,11,1582,6,705,5,877,6645.032769,1.951726,2889.749893,3594.766888,Malicious
172.30.15.1294,50602,210.176.156.62,80,14,5295,7,3713,7,1582,3471.13612,1.995755,14883.59042,6341.459748,Benign
10.0.2.15,35382,119.254.87.201,80,11,1579,6,705,5,874,2893.68729,1.79688,3138.773875,3891.189172,Malicious
172.30.15.2067,51379,52.207.90.113,443,41,8639,22,6550,19,2089,4120.530512,7.046217,7436.614569,2371.769135,Benign
172.30.6.255,56551,52.109.120.3,443,61,41189,32,23094,29,18095,844.442612,2.814855,65634.64193,51427.16055,Benign
10.0.2.15,54857,119.254.87.201,80,11,1579,6,705,5,874,8897.141043,2.080344,2711.090089,3360.982607,Malicious
10.0.2.15,55816,119.254.87.201,80,11,1579,6,705,5,874,9467.68941,0.882111,6393.753167,7926.440097,Malicious
172.30.6.255,58498,52.229.175.79,443,30,10147,17,2298,13,7849,5727.959515,98.504365,186.6313234,637.4539849,Benign
192.168.43.233,51132,52.84.110.163,443,9,534,5,294,4,240,922.507129,17.8081,132.07473,107.8161062,Benign
172.30.1.136,51879,74.125.68.188,5228,19,2423,10,1348,9,1075,4402.048417,15.005821,718.6544475,573.1109281,Benign
172.30.1.136,51869,13.107.4.52,80,10,1519,5,436,5,1083,4179.196966,0.139614,24983.16788,62056.81379,Benign
172.30.15.2416,51750,172.217.161.10,443,44,20803,22,2725,22,18078,5348.29987,9.55068,2282.559985,15142.79612,Benign
192.168.137.97,46264,172.217.161.14,443,2,120,1,66,1,54,29.88537553,1.109201022,476.0183137,389.4695294,Benign
192.168.215.49,51320,18.211.245.141,443,29,6614,14,1990,15,4624,2054.876968,60.93902642,261.2447382,607.0329996,Benign
192.168.43.233,51267,163.53.78.128,443,36,13966,19,7036,17,6930,1969.314409,45.932701,1225.445027,1206.983234,Benign
172.30.6.255,56426,217.182.126.163,80,8,1289,5,686,3,603,678.979565,0.567172,9676.077098,8505.3564,Benign
172.30.6.255,57914,161.69.226.28,443,17,4714,9,1926,8,2788,4446.950598,156.605344,98.38744711,142.4217043,Benign
172.30.15.953,50259,52.77.33.157,80,14,3577,8,1588,6,1989,3441.830505,5.232058,2428.107639,3041.250689,Benign
172.30.6.255,56542,23.198.119.247,443,22,10365,11,1632,11,8733,832.253522,41.334069,315.8653458,1690.227981,Benign
192.168.137.97,55966,169.44.84.154,443,7,478,4,272,3,206,2863.258624,38.6779921,56.25938374,42.60820974,Benign
192.168.43.233,51348,104.16.2.213,443,16,4549,9,1120,7,3429,3416.934084,19.284261,464.6276049,1422.507194,Benign
172.30.6.255,56793,103.243.221.51,80,15,6136,9,4508,6,1628,1253.886052,3.647492,9887.341768,3570.67267,Benign
10.0.2.15,48048,119.254.87.201,80,11,1582,6,705,5,877,16320.19465,2.149683,2623.642649,3263.737025,Malicious
192.168.43.233,51314,49.44.164.116,443,18,5062,11,2890,7,2172,3135.962888,63.793759,362.4178973,272.3777415,Benign
192.168.215.49,54642,13.127.131.111,443,22,8699,12,2179,10,6520,281.3905124,0.140669308,123921.8437,370798.7246,Benign
10.0.2.15,51140,119.254.87.201,80,11,1582,6,705,5,877,5896.617073,3.615223,1560.069738,1940.682497,Malicious
192.168.43.233,51190,172.217.161.5,443,119,18545,57,10961,62,7584,646.026053,733.886707,119.4843825,82.672161,Benign
10.0.2.15,38569,119.254.87.201,80,11,1579,6,705,5,874,22837.63197,1.15543,4881.299603,6051.426742,Malicious
172.30.15.2023,51335,52.207.90.113,443,30,8458,16,4077,14,4381,4090.22157,7.395122,4410.474905,4739.340338,Benign
192.168.42.240,50977,13.35.130.79,443,1290,692371,551,172103,739,520268,296.118426,311.012503,4426.908844,13382.56167,Benign
192.168.43.224,60190,151.101.153.2,443,10,696,6,404,4,292,927.1611939,14.32883264,225.559198,163.0279352,Benign
172.30.15.453,49727,18.204.234.216,443,22,4169,12,3066,10,1103,1633.416065,7.399425,3314.852168,1192.525095,Benign
192.168.43.224,50178,49.44.90.17,443,32,11062,15,2120,17,8942,37.91230675,6.227482187,2723.412045,11487.14647,Benign
172.30.6.255,56946,172.217.166.198,443,16,5029,8,1054,8,3975,1388.714095,12.124712,695.4391989,2622.742709,Benign
172.30.15.1077,50383,108.59.14.130,80,12,1396,6,871,6,525,3452.776794,1.660733,4195.737665,2529.003759,Benign
172.30.6.255,58021,104.122.91.146,80,3,198,3,198,0,0,4763.867941,9.000619,175.9878959,0,Benign
172.30.6.255,57963,103.243.221.75,80,32,18570,18,15379,14,3191,4630.789606,16.241501,7575.161926,1571.775909,Benign
10.0.2.15,59218,119.254.87.201,80,11,1582,6,705,5,877,7218.052433,1.960263,2877.164952,3579.111578,Malicious
10.0.2.15,34176,119.254.87.201,80,11,1582,6,705,5,877,12295.63189,1.457703,3869.100907,4813.051767,Malicious
172.30.6.255,57790,103.243.221.87,80,22,12083,13,9980,9,2103,4041.847125,1.730985,46124.02765,9719.321658,Benign
172.30.1.136,50345,172.217.161.14,443,70,18144,35,6943,35,11201,614.281533,246.908723,224.9576253,362.9195393,Benign
10.0.2.15,36116,119.254.87.201,80,11,1579,6,705,5,874,15834.5514,2.251718,2504.754148,3105.184575,Malicious
10.0.2.15,51897,119.254.87.201,80,11,1579,6,705,5,874,20999.94208,1.44597,3900.495861,4835.508344,Malicious
10.0.2.15,37042,119.254.87.201,80,11,1582,6,705,5,877,9772.981941,1.882619,2995.826559,3726.723251,Malicious
172.30.6.255,56592,192.168.1.35,7680,3,198,3,198,0,0,914.592204,9.008514,175.8336614,0,Benign
10.0.2.15,50438,119.254.87.201,80,11,1513,6,705,5,808,24667.03253,2.091908,2696.10327,3090.002046,Malicious
10.0.2.15,42120,119.254.87.201,80,11,1582,6,705,5,877,25595.0428,0.822058,6860.829771,8534.677602,Malicious
192.168.43.233,51142,103.243.221.75,443,5,286,3,174,2,112,925.521805,13.89017,100.2147562,64.50604996,Benign
192.168.43.233,51020,216.58.221.34,443,10,588,6,348,4,240,699.156049,39.343448,70.76146453,48.80101002,Benign
192.168.43.224,36340,52.20.136.189,443,187,133908,91,11227,96,122681,2882.594325,105.8818009,848.2666449,9269.279439,Benign
192.168.43.224,59038,104.197.3.80,80,14,1199,7,565,7,634,2423.810929,4.866446082,928.8092221,1042.239021,Benign
10.0.2.15,39232,119.254.87.201,80,11,1579,6,705,5,874,15836.84907,2.290081,2462.794984,3053.167115,Malicious
172.30.6.255,58094,172.217.166.197,443,56,18488,30,9754,26,8734,4872.419261,133.028041,586.5830949,525.2426441,Benign
192.168.137.97,55030,172.82.254.215,443,23,5569,12,1451,11,4118,0.0960183,22.04582086,526.5397044,1494.34218,Benign
172.30.6.255,57428,103.243.221.17,80,15,6166,9,5044,6,1122,2795.830265,3.683193,10955.71153,2437.015926,Benign
172.30.6.255,55895,63.251.88.56,443,4,236,2,120,2,116,114.468411,10.527118,91.19305018,88.15328184,Benign
192.168.43.233,50993,172.82.241.224,443,29,9007,14,3542,15,5465,513.805955,32.73246,865.6850111,1335.677184,Benign
172.30.1.136,51224,52.84.108.120,443,1,66,1,66,0,0,1627.350544,0,0,0,Benign
172.30.6.255,58385,52.213.19.114,443,20,7853,10,2430,10,5423,5486.317114,2.880882,6747.933445,15059.27699,Benign
172.30.15.1585,50894,184.29.25.7,443,167,95048,71,7911,96,87137,3571.075505,6.029346,10496.66083,115617.183,Benign
10.0.2.15,59478,119.254.87.201,80,11,1582,6,705,5,877,428.549971,1.497438,3766.433068,4685.335887,Malicious
192.168.215.49,38432,158.85.224.176,443,30,7996,15,3044,15,4952,1541.06849,1.220409732,19953.95428,32461.22918,Benign
172.30.6.255,55559,104.24.108.136,443,5,333,2,108,3,225,29.52997,0.001487,0,0,Benign
172.30.15.910,50216,67.202.94.86,80,8,1472,5,747,3,725,3439.702824,0.845314,7069.562316,6861.355662,Benign
172.30.15.978,50284,173.241.248.220,80,12,3816,8,2980,4,836,3442.616229,4.59698,5186.013426,1454.868196,Benign
172.30.15.1731,51042,162.247.242.19,443,24,6217,12,2391,12,3826,3623.727612,3.505229,5456.990114,8732.097104,Benign
172.30.6.255,58173,103.243.221.109,80,41,24478,24,20331,17,4147,5023.84445,17.686243,9196.300198,1875.80822,Benign
10.0.2.15,56987,119.254.87.201,80,11,1582,6,705,5,877,16617.63983,1.687385,3342.450004,4157.912984,Malicious
172.30.6.255,58166,157.240.16.17,443,4684,4380278,1661,100624,3023,4279654,4965.334813,133.540023,6028.095412,256381.804,Benign
172.30.6.255,55973,52.77.203.173,443,240,246823,59,17359,181,229464,174.017771,125.413869,1107.309751,14637.23282,Benign
172.30.1.136,50373,157.240.16.20,443,3,198,3,198,0,0,671.638751,9.002063,175.9596661,0,Benign
192.168.43.233,51137,52.68.47.152,443,7,402,4,228,3,174,925.499328,14.353152,127.0801006,96.98218203,Benign
172.30.1.136,50823,52.18.200.60,443,9,534,5,294,4,240,1965.903241,16.520982,142.3644188,116.2158521,Benign
172.30.15.312,49575,14.139.45.149,80,13,2654,7,822,6,1832,729.351028,0.07055,93210.48901,207739.1921,Benign
192.168.137.97,48598,172.217.194.189,443,110,18111,54,7634,56,10477,4203.843547,680.6467741,89.72642246,123.1416987,Benign
192.168.137.97,34594,172.217.161.3,443,53,12713,26,6311,27,6402,367.5377879,241.0742069,209.4292901,212.4491071,Benign
192.168.43.233,51240,54.152.236.192,443,9,523,5,283,4,240,1539.911183,53.873448,42.02441247,35.63907771,Benign
172.30.1.136,51813,52.84.110.171,443,46,11855,22,9297,24,2558,3010.028379,187.384479,396.916545,109.2086181,Benign
172.30.15.1239,50547,77.238.185.35,443,5,294,3,174,2,120,3468.74338,8.880116,156.7547091,108.1066959,Benign
172.30.6.255,56056,13.250.69.79,443,24,8633,13,2188,11,6445,256.637565,68.179844,256.7327669,756.2352299,Benign
172.30.15.322,49588,180.149.59.76,443,17,5406,9,1285,8,4121,806.509395,3.668539,2802.205456,8986.6838,Benign
172.30.6.255,58216,54.194.27.245,443,25,8953,12,3224,13,5729,5157.213893,6.871582,3753.429705,6669.788704,Benign
10.0.2.15,59539,119.254.87.201,80,11,1582,6,705,5,877,23378.11181,2.086001,2703.737918,3363.373268,Malicious
172.30.6.255,55650,151.139.104.15,80,30,23495,10,947,20,22548,36.877306,4.395045,1723.75937,41042.58318,Benign
172.30.15.1637,50947,184.29.25.7,443,85,72539,32,7014,53,65525,3575.55192,1.514013,37061.76895,346232.1658,Benign
10.0.2.15,55834,119.254.87.201,80,11,1579,6,705,5,874,12831.14384,0.894123,6307.856973,7819.953183,Malicious
172.30.6.255,58513,54.194.27.245,443,22,8297,11,2820,11,5477,5748.512149,10.691293,2110.128307,4098.288205,Benign
192.168.43.233,51329,137.117.84.54,443,15,6304,8,1087,7,5217,3366.126479,18.535206,469.1612276,2251.714926,Benign
192.168.43.233,51454,173.241.248.143,80,14,1985,8,1137,6,848,3811.181468,80.316122,113.25248,84.46622958,Benign
192.168.137.97,42536,54.172.89.157,443,6,412,4,272,2,140,349.1503417,14.7217196,147.8088199,76.07806905,Benign
10.0.2.15,42597,119.254.87.201,80,11,1579,6,705,5,874,10821.65981,1.147806,4913.722354,6091.621755,Malicious
192.168.43.233,51434,151.101.193.69,443,17,6273,9,1625,8,4648,3795.043774,17.344772,749.5053841,2143.816016,Benign
10.0.2.15,55070,119.254.87.201,80,11,1582,6,705,5,877,16887.92661,1.450789,3887.539815,4835.989244,Malicious
172.30.6.255,55912,70.42.146.149,80,10,1217,6,818,4,399,122.051579,30.796091,212.4945013,103.6495184,Benign
172.30.1.136,50627,52.214.173.82,443,125,48605,64,35786,61,12819,1714.762071,85.535942,3346.990672,1198.934595,Benign
172.30.6.255,55625,157.240.16.17,443,14,4869,7,971,7,3898,5.268117,0.091219,85157.69741,341858.604,Benign
172.30.6.255,57061,103.243.221.75,80,48,29981,28,24874,20,5107,1679.844354,16.147687,12323.251,2530.145649,Benign
192.168.43.224,49572,104.198.143.177,80,14,1199,7,565,7,634,3089.539024,2.031248373,2225.232552,2496.986615,Benign
10.0.2.15,43009,119.254.87.201,80,11,1579,6,705,5,874,1269.467074,1.42763,3950.603448,4897.627537,Malicious
192.168.43.224,50588,49.44.150.71,443,32,7540,18,2566,14,4974,2296.848174,301.8498385,68.00732477,131.827137,Benign
172.30.6.255,58352,35.190.43.164,80,6,348,4,228,2,120,5441.833612,7.183999,253.8975855,133.6303081,Benign
10.0.2.15,38306,119.254.87.201,80,11,1579,6,705,5,874,5688.62785,1.617613,3486.618864,4322.418279,Malicious
172.30.6.255,56660,157.240.16.39,443,19,1933,11,1179,8,754,1094.088797,61.583944,153.1568033,97.9476079,Benign
10.0.2.15,58429,119.254.87.201,80,11,1585,6,705,5,880,8837.05343,1.951623,2889.902404,3607.254065,Malicious
172.30.6.255,58550,35.190.43.164,80,10,1573,6,1119,4,454,5813.989017,5.110339,1751.742888,710.7160601,Benign
172.30.6.255,57547,103.243.220.231,80,29,16160,14,8569,15,7591,3188.846607,30.180532,2271.397999,2012.158036,Benign
172.30.6.255,55975,52.89.235.78,80,116,104290,41,18086,75,86204,174.779424,129.47278,1117.516748,5326.463215,Benign
10.0.2.15,39542,119.254.87.201,80,11,1579,6,705,5,874,24727.11126,2.019691,2792.506378,3461.915709,Malicious
192.168.43.233,51364,52.216.18.144,443,83,50480,34,3764,49,46716,3464.828916,109.047908,276.1355128,3427.190919,Benign
10.0.2.15,54979,119.254.87.201,80,11,1579,6,705,5,874,11960.35279,1.489071,3787.596428,4695.545075,Malicious
172.30.15.1501,50809,157.240.16.20,443,12,1688,7,971,5,717,3520.99162,5.973515,1300.406879,960.2386535,Benign
10.0.2.15,55347,119.254.87.201,80,11,1579,6,705,5,874,14365.42564,1.404665,4015.192234,4977.699309,Malicious
172.30.6.255,58442,173.241.248.220,80,10,2493,6,1300,4,1193,5616.851379,2.341957,4440.730551,4075.224268,Benign
192.168.43.224,54160,23.60.211.179,443,36,10529,19,3639,17,6890,44.63264713,223.9815135,129.9750124,246.0917383,Benign
172.30.15.2019,51331,52.207.90.113,443,16,4806,9,1153,7,3653,4089.523932,7.749283,1190.303671,3771.187605,Benign
172.30.6.255,57409,157.240.16.39,443,19,1933,10,1125,9,808,2741.096387,61.030067,147.4682962,105.9150074,Benign
172.30.1.136,50208,52.95.120.67,443,21,8148,10,2087,11,6061,368.206086,14.321243,1165.820593,3385.739632,Benign
192.168.215.49,32908,172.217.161.19,443,21,5256,11,1308,10,3948,479.7802198,0.276301439,37871.68115,114309.9367,Benign
192.168.43.224,46322,52.20.114.147,443,40,8996,19,2926,21,6070,63.35014764,64.06497791,365.3790381,757.9804378,Benign
172.30.6.255,57310,103.243.221.51,80,20,9667,9,4216,11,5451,2439.855708,14.03292,2403.491219,3107.549961,Benign
172.30.1.136,50794,34.225.100.237,443,42,21616,23,12175,19,9441,1931.835491,30.959941,3146.000827,2439.539533,Benign
192.168.43.233,51343,139.59.72.43,443,185,149714,71,9668,114,140046,3080.754655,191.325631,404.2532075,5855.817614,Benign
172.30.6.255,57207,172.217.166.210,443,47,7934,22,2596,25,5338,2099.960177,240.369293,86.40038726,177.6599642,Benign
172.30.15.2211,51526,13.107.21.200,443,28,10527,15,1492,13,9035,4438.554584,8.934262,1335.980521,8090.203757,Benign
172.30.15.917,50223,184.29.26.86,443,73,50644,34,3442,39,47202,3440.001857,6.988774,3940.032973,54031.79442,Benign
172.30.15.1411,50719,72.251.245.179,443,22,9087,12,1898,10,7189,3500.069766,7.059963,2150.719487,8146.21833,Benign
172.30.15.993,50299,52.220.73.112,80,16,3322,9,1588,7,1734,3443.010009,4.052911,3134.537127,3422.725049,Benign
10.0.2.15,33852,119.254.87.201,80,11,1579,6,705,5,874,14157.72664,1.115789,5054.719127,6266.417755,Malicious
172.30.6.255,58309,103.243.221.109,80,38,24224,23,20183,15,4041,5353.876704,5.288968,30528.45092,6112.345546,Benign
172.30.15.1231,50539,42.125.207.29,80,7,398,4,228,3,170,3468.42763,9.196395,198.3385881,147.884035,Benign
172.30.6.255,57621,103.243.221.87,80,43,32866,17,8648,26,24218,3430.841298,20.227956,3420.21705,9578.031512,Benign
10.0.2.15,58165,119.254.87.201,80,11,1582,6,705,5,877,7850.972095,2.095338,2691.689837,3348.385797,Malicious
172.30.15.1510,50818,184.29.24.49,443,39,27754,15,2698,24,25056,3524.11107,2.926378,7375.670539,68496.96109,Benign
192.168.137.97,52832,52.220.54.9,443,33,10497,19,2949,14,7548,1765.454854,73.92060385,319.153237,816.8764438,Benign
192.168.43.233,51288,52.230.84.217,443,41,13197,23,5932,18,7265,2484.316401,601.715183,78.86787859,96.59054922,Benign
10.0.2.15,54537,119.254.87.201,80,11,1579,6,705,5,874,26316.06629,0.819177,6884.958928,8535.395891,Malicious
192.168.43.224,49836,52.207.90.113,443,10,672,5,330,5,342,9.426223346,5.197520267,507.9345273,526.4048738,Benign
10.0.2.15,57162,119.254.87.201,80,11,1582,6,705,5,877,16707.75374,1.991451,2832.105836,3523.059317,Malicious
10.0.2.15,37905,119.254.87.201,80,11,1593,6,705,5,888,17461.63535,2.300278,2451.877556,3088.322368,Malicious
172.30.15.2293,51621,162.125.82.3,443,6,348,4,228,2,120,4917.605024,0.33203,5493.479505,2891.305003,Benign
192.168.137.97,42172,151.101.129.69,443,8,552,5,338,3,214,24.34404128,10.62224406,254.5601461,161.1712168,Benign
192.168.137.97,51260,216.58.221.34,443,52,8493,26,3066,26,5427,9531.549278,253.1316411,96.89819846,171.5155,Benign
192.168.43.224,48826,34.227.208.227,443,6,412,4,272,2,140,368.832074,37.14325009,58.58399561,30.15352715,Benign
172.30.6.255,58077,205.185.216.42,443,98,114240,14,1822,84,112418,4848.371098,0.693864,21006.99849,1296138.725,Benign
172.30.15.797,50089,52.84.108.164,443,82,57645,38,5092,44,52553,2677.550064,8.676006,4695.248021,48458.24219,Benign
10.0.2.15,60802,119.254.87.201,80,11,1582,6,705,5,877,21991.0854,1.054463,5348.694075,6653.623693,Malicious
192.168.215.49,32930,195.8.215.136,80,11,1935,6,849,5,1086,508.4054445,22.09372427,307.417614,393.2338384,Benign
172.30.6.255,55915,35.186.239.238,80,6,348,4,228,2,120,121.806615,30.080745,60.63679606,31.91410319,Benign
172.30.1.136,50585,13.107.21.200,443,44,15476,23,3866,21,11610,1594.869797,131.771451,234.7094136,704.8567751,Benign
192.168.137.97,33272,161.202.24.166,443,6,412,4,272,2,140,121.4994264,11.75633173,185.0917489,95.26781191,Benign
10.0.2.15,44342,119.254.87.201,80,12,1653,7,779,5,874,11630.10021,13.481312,462.2695477,518.6438827,Malicious
172.30.6.255,56343,103.243.221.46,80,16,4877,9,3649,7,1228,605.855689,26.221963,1113.265243,374.6477714,Benign
172.30.15.528,49812,169.44.165.64,443,34,11709,18,2390,16,9319,2246.374694,9.928999,1925.672467,7508.51118,Benign
172.30.15.2115,51427,64.74.232.52,443,12,1412,7,958,5,454,4178.04529,9.303619,823.7654616,390.3857198,Benign
192.168.137.97,39702,192.168.125.6,80,375,320368,167,11585,208,308783,8276.372397,18.4869134,5013.27604,133622.306,Benign
172.30.6.255,56497,131.253.33.254,443,30,8037,15,1323,15,6714,821.683909,102.529381,103.2289466,523.8693482,Benign
10.0.2.15,60368,119.254.87.201,80,11,1579,6,705,5,874,2685.135899,1.418488,3976.064655,4929.19221,Malicious
172.30.6.255,57365,103.243.221.17,80,60,38713,26,17658,34,21055,2580.861817,68.186026,2071.744143,2470.30088,Benign
10.0.2.15,43150,119.254.87.201,80,11,1579,6,705,5,874,23405.53314,2.022247,2788.976816,3457.540053,Malicious
10.0.2.15,40073,119.254.87.201,80,11,1582,6,705,5,877,23735.89788,1.350098,4177.474524,5196.659798,Malicious
192.168.43.224,49040,157.240.16.39,443,557,343660,258,48110,299,295550,34.83123861,89.25049828,4312.356877,26491.72885,Benign
192.168.43.224,35064,34.232.42.95,443,17,1874,10,1220,7,654,3042.774971,15.89932478,613.8625466,329.0705783,Benign
192.168.137.97,60732,23.57.218.60,443,46,8733,23,5970,23,2763,0.896007059,403.0991789,118.4820076,54.83514022,Benign
172.30.6.255,58418,35.190.43.164,80,11,1757,7,1303,4,454,5562.082014,7.248869,1438.017434,501.0436801,Benign
192.168.43.233,51346,137.117.84.54,443,15,6304,8,1087,7,5217,3390.727064,26.374613,329.710999,1582.430802,Benign
172.30.15.2264,51581,104.121.244.70,443,237,209955,90,17578,147,192377,4487.743252,20.940974,6715.255938,73493.04765,Benign
192.168.215.49,36630,54.173.224.161,443,31,11282,17,4185,14,7097,612.469104,113.2812842,295.5474971,501.1948833,Benign
192.168.43.233,50104,13.107.129.254,443,1,54,0,0,1,54,40.803604,0,0,0,Benign
172.30.15.680,49967,104.31.90.207,80,42,32642,17,2162,25,30480,2398.29378,7.979534,2167.545122,30558.17545,Benign
172.30.15.1485,50793,104.244.42.133,443,21,3066,12,1764,9,1302,3520.940056,6.179881,2283.539117,1685.469348,Benign
172.30.6.255,57866,103.243.221.109,80,25,14011,11,5338,14,8673,4237.842793,39.183744,1089.839705,1770.734313,Benign
172.30.15.712,49999,35.161.126.85,443,6,340,4,228,2,112,2405.135754,1.331945,1369.425915,672.7004493,Benign
10.0.2.15,49854,119.254.87.201,80,11,1579,6,705,5,874,2383.067842,1.770606,3185.3501,3948.930479,Malicious
172.30.6.255,57567,176.34.147.227,443,69,23135,39,15384,30,7751,3255.389212,317.482511,387.6496995,195.3115458,Benign
172.30.15.2483,51817,14.139.45.128,80,147,136266,51,3173,96,133093,5425.940777,1.972316,12870.1486,539844.528,Benign
172.30.6.255,57775,103.243.221.75,80,30,18080,17,14967,13,3113,3977.605011,17.44361,6864.175477,1427.686127,Benign
192.168.43.233,51448,216.58.196.194,80,20,1971,12,1155,8,816,3808.684043,243.352599,37.96959654,26.8252734,Benign
192.168.43.224,39776,54.91.247.198,443,52,10981,29,3646,23,7335,24.18437457,318.2856834,91.64094247,184.362675,Benign
10.0.2.15,36797,119.254.87.201,80,11,1582,6,705,5,877,4845.649319,9.098884,619.8562373,771.0835746,Malicious
192.168.137.97,53710,74.125.68.188,443,23,2846,14,1826,9,1020,131.1709606,206.4210076,70.76799097,39.53086023,Benign
172.30.6.255,56396,104.90.192.189,443,28,7393,15,2256,13,5137,650.889859,205.322021,87.90094658,200.1538841,Benign
172.30.1.136,50242,104.17.38.113,443,59,24727,35,7484,24,17243,435.628228,403.495732,148.38323,341.8722655,Benign
172.30.6.255,56978,103.243.220.231,80,16,5473,9,4245,7,1228,1436.863356,16.193487,2097.139424,606.6636543,Benign
172.30.6.255,56383,103.243.221.75,80,6,340,4,228,2,112,649.11547,27.949542,65.26046116,32.05777039,Benign
192.168.43.224,40678,52.84.108.164,443,1003,874550,390,28319,613,846231,3065.409809,227.8820292,994.1635187,29707.68702,Benign
192.168.137.97,37774,117.18.237.70,443,27,7870,15,1677,12,6193,285.353267,28.9367534,463.6318323,1712.147846,Benign
10.0.2.15,45073,119.254.87.201,80,11,1582,6,705,5,877,1604.11136,1.364115,4134.548773,5143.261382,Malicious
10.0.2.15,33974,119.254.87.201,80,11,1552,6,705,5,847,128.218402,1.287094,4381.964332,5264.572751,Malicious
172.30.6.255,56132,103.243.221.109,80,6,340,4,228,2,112,347.064022,21.962543,83.05049192,40.79673287,Benign
172.30.1.136,50689,172.217.161.4,443,3,198,3,198,0,0,1808.308716,9.002059,175.9597443,0,Benign
192.168.215.49,54336,18.210.21.97,443,24,3148,12,1783,12,1365,1229.391268,60.9099638,234.1817186,179.2810128,Benign
172.30.6.255,55723,122.15.34.17,80,10,2158,6,748,4,1410,57.87302,0.703663,8504.070841,16030.40092,Benign
10.0.2.15,59480,119.254.87.201,80,11,1579,6,705,5,874,22957.65365,1.087509,5186.163977,6429.372079,Malicious
172.30.6.255,56743,172.217.194.189,443,31,5277,18,3584,13,1693,1242.462231,0.83006,34542.0813,16316.89275,Benign
172.30.15.1277,50585,13.232.120.220,80,8,468,5,282,3,186,3469.551414,7.956603,283.5380878,187.0144834,Benign
172.30.6.255,55733,209.15.36.33,80,5,330,1,66,4,264,58.294289,7.492253,70.4727937,281.8911748,Benign
192.168.43.233,51436,104.16.3.35,443,304,213415,147,11685,157,201730,3799.971068,257.260455,363.3671564,6273.175564,Benign
172.30.6.255,57501,180.149.59.210,80,488,344632,311,254334,177,90298,3058.100425,1715.759051,1185.872806,421.028815,Benign
172.30.6.255,57696,172.217.166.202,443,17,1793,10,1164,7,629,3671.450221,128.758637,72.32136202,39.08087346,Benign
10.0.2.15,51187,119.254.87.201,80,11,1579,6,705,5,874,24003.32266,2.116565,2664.694918,3303.465757,Malicious
192.168.215.49,58282,157.240.16.16,443,419,108414,240,53303,179,55111,125.7004441,1999.864024,213.2264968,220.4589885,Benign
172.30.6.255,56373,172.217.166.206,443,17,1904,11,1329,6,575,630.498356,89.714292,118.5095458,51.27388176,Benign
192.168.215.49,43620,34.227.208.227,443,9,610,5,338,4,272,552.8844244,81.62822532,33.12579674,26.6574459,Benign
192.168.43.224,52278,192.229.179.87,443,13,965,6,408,7,557,42.69145842,45.03105345,72.48331429,98.95393642,Benign
10.0.2.15,37391,119.254.87.201,80,11,1579,6,705,5,874,17366.32715,1.430155,3943.628488,4888.980565,Malicious
192.168.43.233,51326,139.59.72.43,443,1264,1179195,435,31385,829,1147810,3074.990335,197.172749,1273.401123,46570.7358,Benign
10.0.2.15,45986,119.254.87.201,80,11,1579,6,705,5,874,24994.43106,2.092922,2694.797035,3340.783842,Malicious
192.168.43.233,51155,74.125.158.119,443,11,642,6,348,5,294,476.403047,25.087956,110.9695824,93.75016442,Benign
172.30.15.698,49985,217.12.15.54,443,23,10135,13,2550,10,7585,2402.6507,3.676851,5548.225914,16503.25238,Benign
172.30.15.687,49974,52.222.150.199,443,22,10144,12,1909,10,8235,2399.660047,6.652574,2295.65278,9902.933812,Benign
10.0.2.15,37910,119.254.87.201,80,11,1554,6,705,5,849,9920.873317,1.978689,2850.37214,3432.575812,Malicious
192.168.43.233,51253,151.101.153.170,443,19,7662,9,1108,10,6554,1931.63171,13.840847,640.4232342,3788.20747,Benign
172.30.15.1443,50751,103.231.98.244,443,8,664,5,490,3,174,3501.620599,0.318832,12294.8763,4365.935665,Benign
192.168.43.233,50868,157.240.16.16,443,7,420,3,192,4,228,20.925619,0.37576,4087.715563,4854.162231,Benign
10.0.2.15,37597,119.254.87.201,80,11,1582,6,705,5,877,788.85951,0.86327,6533.297809,8127.237133,Malicious
10.0.2.15,38779,119.254.87.201,80,11,1579,6,705,5,874,16440.33902,2.087098,2702.316805,3350.106224,Malicious
172.30.15.959,50265,13.232.120.220,80,10,1613,6,1100,4,513,3442.1471,4.854101,1812.900061,845.4706649,Benign
172.30.15.2210,51525,52.175.23.79,443,28,10082,15,2233,13,7849,4438.537806,70.632136,252.9160381,889.0004403,Benign
192.168.137.97,35014,52.84.108.69,443,28,8753,15,2266,13,6487,1.790960953,120.1848743,150.8342885,431.8014252,Benign
192.168.43.233,50927,52.16.255.206,443,409,188594,244,164738,165,23856,433.294003,236.654087,5568.904458,806.4428653,Benign
10.0.2.15,54921,119.254.87.201,80,11,1579,6,705,5,874,25330.14836,1.251316,4507.254762,5587.717251,Malicious
192.168.215.49,55854,156.154.202.36,443,21,8163,10,2688,11,5475,511.8966822,1.432961942,15006.67908,30566.05951,Benign
172.30.15.541,49825,63.131.135.113,443,3,198,3,198,0,0,2249.457667,9.003469,175.9321879,0,Benign
172.30.15.1053,50359,210.176.156.55,443,16,4430,9,1345,7,3085,3448.768218,8.451615,1273.129455,2920.151947,Benign
172.30.15.1215,50523,52.76.199.39,443,6,340,4,228,2,112,3466.846734,10.662065,171.0738023,84.03625377,Benign
172.30.15.1031,50337,173.241.248.143,80,9,1413,6,921,3,492,3446.970439,10.285801,716.3272943,382.6634406,Benign
172.30.15.1684,50995,184.29.25.7,443,37,27317,15,4027,22,23290,3607.742974,9.385781,3432.426135,19851.30486,Benign
172.30.6.255,57209,103.243.221.75,80,16,5473,9,4245,7,1228,2103.848662,27.175238,1249.667068,361.5055736,Benign
172.30.6.255,56344,103.243.221.46,80,40,26098,18,9870,22,16228,605.857659,26.220441,3011.390998,4951.251583,Benign
172.30.15.1775,51087,52.84.101.37,443,18,2687,10,1578,8,1109,3641.758408,5.408825,2333.963476,1640.282316,Benign
172.30.15.359,49627,52.21.142.16,443,130,94970,77,87825,53,7145,1372.907876,2.541663,276433.1857,22489.21277,Benign
192.168.43.224,34978,104.198.143.177,80,10,911,5,425,5,486,623.814373,1.175786275,2891.681994,3306.723409,Benign
172.30.15.386,49654,195.154.150.142,80,19,7054,9,1568,10,5486,1466.056687,8.766372,1430.922621,5006.404018,Benign
172.30.15.1095,50401,217.182.138.56,443,23,8904,12,1920,11,6984,3453.688912,5.302625,2896.678532,10536.66816,Benign
172.30.15.2312,51641,52.55.184.84,443,162,123082,71,17820,91,105262,5034.107179,13.736414,10378.25447,61303.91818,Benign
172.30.1.136,50452,172.217.161.14,443,3,198,3,198,0,0,857.446656,9.00228,175.9554246,0,Benign
10.0.2.15,59700,119.254.87.201,80,11,1579,6,705,5,874,10493.73664,2.484475,2270.097304,2814.276658,Malicious
192.168.43.233,50944,172.217.166.226,443,13,762,8,468,5,294,454.286496,21.40151,174.9409271,109.8987875,Benign
192.168.43.224,57674,13.32.226.81,443,8,552,5,338,3,214,93.69202961,13.00113343,207.9818667,131.6808268,Benign
172.30.6.255,58118,54.194.27.245,443,6,348,4,228,2,120,4893.480055,6.579043,277.24397,145.9178789,Benign
172.30.6.255,57529,104.25.219.21,443,6,348,4,228,2,120,3133.674761,14.252202,127.9802237,67.35801247,Benign
172.30.15.1339,50647,104.244.42.195,443,27,7041,14,2029,13,5012,3491.417566,5.722906,2836.321268,7006.230751,Benign
10.0.2.15,58336,119.254.87.201,80,11,1561,6,705,5,856,26351.43262,2.061671,2735.645018,3321.577497,Malicious
192.168.43.224,50048,34.227.238.173,443,34,8137,17,2809,17,5328,368.8599558,66.09752691,339.9824631,644.865277,Benign
10.0.2.15,43479,119.254.87.201,80,11,1582,6,705,5,877,9798.130645,2.012438,2802.570812,3486.318585,Malicious
172.30.15.2091,51403,54.236.156.42,443,19,2847,10,1684,9,1163,4140.948592,6.74833,1996.345763,1378.711474,Benign
192.168.43.233,51142,23.100.94.137,443,44,16748,23,10686,21,6062,313.092769,149.833013,570.5551686,323.6669879,Benign
172.30.1.136,50187,172.217.161.3,443,200,48346,87,15008,113,33338,353.091146,30.235485,3970.963257,8820.893728,Benign
172.30.15.2190,51502,77.88.21.119,443,33,16654,18,7165,15,9489,4282.280055,5.561397,10306.76285,13649.80777,Benign
192.168.137.97,59922,151.101.192.223,443,21,7282,11,1936,10,5346,2007.962023,0.459415806,33712.3795,93092.13885,Benign
10.0.2.15,43587,119.254.87.201,80,11,1582,6,705,5,877,16014.81281,1.894406,2977.186517,3703.535567,Malicious
10.0.2.15,36587,119.254.87.201,80,11,1513,6,705,5,808,24426.74638,1.609572,3504.037098,4015.974433,Malicious
192.168.137.97,45410,78.46.27.186,443,1775,1462843,787,59135,988,1403708,77.8005091,71.44775793,6621.341434,157173.0776,Benign
192.168.43.224,36108,107.21.25.13,443,16,4978,9,1245,7,3733,57.10742342,11.11642546,895.9714649,2686.475083,Benign
192.168.137.97,52226,172.217.161.3,443,16,1100,9,618,7,482,8399.396612,107.8301915,45.84986755,35.75992906,Benign
172.30.1.136,50130,104.17.39.113,443,747,409582,376,31512,371,378070,112.462096,284.700303,885.4785097,10623.66274,Benign
192.168.43.224,39078,103.37.200.184,443,163,113193,83,7123,80,106070,2541.953831,14.77056402,3857.943402,57449.39726,Benign
192.168.137.97,45546,192.168.121.7,8080,801,662274,340,42864,461,619410,2901.551462,104.8237403,3271.320017,47272.49747,Benign
192.168.137.97,41844,172.217.161.5,443,4,264,2,132,2,132,3.521543188,2.016195488,523.7587358,523.7587358,Benign
10.0.2.15,59786,119.254.87.201,80,11,1579,6,705,5,874,17761.98675,1.311737,4299.642383,5330.336798,Malicious
10.0.2.15,41636,119.254.87.201,80,11,1587,6,705,5,882,9077.305155,1.889347,2985.158364,3734.623656,Malicious
192.168.215.49,52668,104.198.143.177,80,10,911,5,425,5,486,958.762431,0.781954361,4348.079849,4972.157192,Benign
172.30.6.255,57731,103.243.221.87,80,36,19106,16,9316,20,9790,3779.856838,20.20881,3687.896516,3875.537451,Benign
172.30.15.1208,50516,199.166.0.200,443,6,348,4,228,2,120,3466.527488,0.909019,2006.558719,1056.083536,Benign
192.168.43.233,51380,34.225.143.92,443,24,6120,13,1769,11,4351,3477.456261,147.979361,95.63495818,235.2219915,Benign
192.168.137.97,58356,13.228.153.206,443,47,14949,25,4067,22,10882,1766.953325,63.25710912,514.3453511,1376.224763,Benign
192.168.43.233,51144,104.198.94.254,443,25,9030,13,1867,12,7163,925.538683,11.857488,1259.625985,4832.726797,Benign
172.30.6.255,57970,103.243.221.17,80,18,6331,9,4515,9,1816,4646.843242,50.215167,719.3045878,289.3149793,Benign
192.168.43.224,44792,172.82.254.215,443,5,342,3,214,2,128,2299.114257,11.81272854,144.928413,86.68615355,Benign
192.168.137.97,37692,23.57.214.252,443,54,7216,30,4411,24,2805,3532.580624,334.0301195,105.6431679,67.17957062,Benign
192.168.43.233,50989,172.217.166.226,443,101,18161,46,6624,55,11537,513.714208,425.420369,124.5638523,216.9524704,Benign
172.30.6.255,58199,103.243.221.87,80,26,14184,11,5347,15,8837,5090.094918,11.291701,3788.268924,6260.881332,Benign
172.30.6.255,56634,103.231.98.53,80,81,39992,41,36168,40,3824,1011.90474,138.24305,2093.009377,221.2914139,Benign
192.168.137.97,41666,104.197.3.80,80,11,977,6,491,5,486,481.5286582,0.885181579,4437.507618,4392.319149,Benign
10.0.2.15,58575,119.254.87.201,80,11,1579,6,705,5,874,23705.93274,1.25763,4484.625844,5559.663812,Malicious
10.0.2.15,39309,119.254.87.201,80,11,1582,6,705,5,877,25534.98935,0.827136,6818.709378,8482.281028,Malicious
10.0.2.15,56562,119.254.87.201,80,12,1653,7,779,5,874,15689.48949,4.392382,1418.82013,1591.846975,Malicious
172.30.6.255,58025,172.217.31.2,80,10,1598,6,928,4,670,4766.558251,7.302779,1016.599297,733.9671651,Benign
172.30.6.255,56291,52.84.107.243,80,15,1676,8,853,7,823,569.288291,128.583448,53.07059428,51.2041021,Benign
10.0.2.15,57802,119.254.87.201,80,11,1593,6,705,5,888,8871.837814,1.836007,3071.883713,3869.266294,Malicious
172.30.15.2049,51361,52.86.72.168,443,6,340,4,228,2,112,4091.145635,6.44812,282.8731475,138.9552304,Benign
192.168.137.97,47632,52.84.110.140,443,30,3635,16,2080,14,1555,1755.161751,187.5149034,88.73961319,66.34139352,Benign
172.30.6.255,55906,35.186.239.238,80,21,2447,11,1115,10,1332,121.805594,247.076188,36.10222447,43.1283973,Benign
172.30.6.255,57990,103.231.98.53,80,39,17419,20,15673,19,1746,4696.865477,63.111522,1986.705375,221.3225027,Benign
192.168.43.233,51518,13.107.18.11,443,77,21822,40,6846,37,14976,3916.381886,166.664163,328.6129364,718.8587987,Benign
172.30.6.255,55725,173.241.248.143,443,25,5707,13,1959,12,3748,58.000971,0.732703,21389.29416,40922.44743,Benign
172.30.6.255,58261,172.217.166.197,443,7,402,4,228,3,174,5268.835556,11.059821,164.9212948,125.8609882,Benign
192.168.43.224,57272,139.59.82.147,443,8,544,5,338,3,206,2571.252083,14.69615677,183.9936823,112.1381614,Benign
10.0.2.15,44081,119.254.87.201,80,11,1534,6,705,5,829,23858.60969,2.05814,2740.338364,3222.326955,Malicious
172.30.6.255,56990,115.114.126.213,443,17,7427,10,1712,7,5715,1456.522017,23.843716,574.40711,1917.486352,Benign
172.30.1.136,51896,172.217.194.188,5228,9,534,5,294,4,240,4698.268011,38.822035,60.58415021,49.45644915,Benign
172.30.15.1246,50554,122.15.34.17,80,12,1761,7,1219,5,542,3469.513071,7.993384,1220.008947,542.448605,Benign
192.168.43.233,50707,74.125.24.188,443,18,2707,9,1633,9,1074,1843.265303,1.399004,9338.071943,6141.512104,Benign
10.0.2.15,36023,119.254.87.201,80,11,1582,6,705,5,877,16167.17104,1.166651,4834.350633,6013.795042,Malicious
10.0.2.15,57872,119.254.87.201,80,11,1544,6,705,5,839,1273.789595,2.870317,1964.939761,2338.417673,Malicious
192.168.43.224,41514,74.125.68.188,5228,151,10990,76,5082,75,5908,39.36347422,3317.76701,12.25402503,14.24572607,Benign
172.30.6.255,55867,209.15.36.33,443,18,6414,10,1928,8,4486,105.153605,7.387709,2087.792034,4857.79827,Benign
192.168.43.224,41948,23.251.156.28,443,285,226891,117,11962,168,214929,1053.953204,114.1390265,838.4161226,15064.36539,Benign
10.0.2.15,41314,119.254.87.201,80,11,1513,6,705,5,808,20609.47866,2.494921,2260.59262,2590.863598,Malicious
172.30.6.255,56307,103.243.221.46,80,44,33549,18,10888,26,22661,588.857298,17.181818,5069.545027,10551.15355,Benign
10.0.2.15,41179,119.254.87.201,80,11,1582,6,705,5,877,7455.708996,2.21529,2545.942066,3167.079705,Malicious
172.30.6.255,58194,103.243.221.87,80,7,406,5,294,2,112,5089.889219,24.252474,96.97979678,36.94468449,Benign
172.30.6.255,58339,103.243.221.51,80,17,5606,10,4371,7,1235,5419.840822,9.903855,3530.746361,997.591342,Benign
172.30.6.255,57629,103.243.221.46,80,16,5881,9,4299,7,1582,3450.904228,46.164268,744.9917759,274.1514281,Benign
172.30.1.136,51551,52.230.85.180,443,23,8316,13,1401,10,6915,726.505205,14.640044,765.5714696,3778.677168,Benign
172.30.6.255,57118,13.125.182.143,443,21,8527,11,1802,10,6725,1846.725023,109.274203,131.925007,492.3394408,Benign
192.168.43.233,51176,151.101.153.170,443,9,534,5,294,4,240,1038.972768,13.792566,170.5266446,139.2054241,Benign
172.30.15.446,49720,66.117.24.115,443,7,402,4,228,3,174,1632.202107,8.484288,214.9856299,164.0679807,Benign
192.168.43.233,51328,137.117.84.54,443,79,50114,35,7381,44,42733,3365.987247,150.604691,392.0727808,2269.942574,Benign
192.168.137.97,39890,172.217.161.14,443,38,5746,20,3250,18,2496,4316.150401,240.478599,108.117729,83.03441589,Benign
172.30.6.255,57730,103.243.221.87,80,28,14791,14,8287,14,6504,3779.855845,20.210343,3280.300587,2574.523352,Benign
192.168.137.97,48646,54.255.158.169,443,104,30939,55,9755,49,21184,347.6146008,87.50925782,891.7913595,1936.617956,Benign
192.168.43.224,32862,172.217.166.195,443,29,6290,16,2114,13,4176,6.558670179,8.81318947,1918.942065,3790.682149,Benign
172.30.1.136,50332,172.217.161.4,443,29,5042,13,1864,16,3178,595.378753,35.76595,416.9328649,710.8436935,Benign
172.30.15.2426,51760,14.139.45.128,443,3,198,3,198,0,0,5386.613056,9.000834,175.9836922,0,Benign
10.0.2.15,50163,119.254.87.201,80,11,1579,6,705,5,874,3101.626008,1.764947,3195.56338,3961.592048,Malicious
192.168.43.224,60638,52.84.110.250,443,185,112688,95,8225,90,104463,3037.076423,188.1979704,349.6318258,4440.557984,Benign
10.0.2.15,48618,119.254.87.201,80,11,1513,6,705,5,808,21245.7185,1.088207,5182.837456,5940.046333,Malicious
172.30.6.255,55873,210.176.156.55,443,18,4550,10,1399,8,3151,105.84071,15.89421,704.1557901,1585.986343,Benign
192.168.137.97,46544,172.217.161.14,443,11,766,6,412,5,354,314.965371,19.93842314,165.3089603,142.0373106,Benign
192.168.137.97,55728,52.196.253.57,443,33,9164,16,2801,17,6363,348.9619252,62.85360143,356.5109953,809.8819932,Benign
192.168.43.224,33270,117.18.237.29,80,18,3532,10,1432,8,2100,32.28380491,180.3273783,63.52890009,93.1638898,Benign
192.168.43.224,59338,140.98.193.112,443,65,43580,30,8396,35,35184,50.13103271,7.585915229,8854.304059,37104.55383,Benign
192.168.43.224,36438,18.215.97.76,443,6,412,4,272,2,140,358.4096571,11.36157682,191.5227116,98.57786628,Benign
192.168.215.49,54640,157.240.16.20,443,522,415504,224,16766,298,398738,1250.21197,68.81687679,1949.056776,46353.5131,Benign
172.30.15.1999,51311,52.86.72.168,443,6,348,4,228,2,120,4077.751642,4.815812,378.7523267,199.3433298,Benign
192.168.43.233,51022,117.18.232.102,443,2185,1817126,914,55936,1271,1761190,736.509555,243.158615,1840.313163,57943.74178,Benign
192.168.43.233,51076,23.37.48.123,443,32,7337,17,2020,15,5317,916.230017,319.888369,50.51762291,132.9713867,Benign
172.30.6.255,56753,35.190.43.164,80,9,1649,5,1195,4,454,1244.370619,0.540217,17696.5923,6723.224186,Benign
172.30.6.255,56728,157.240.16.39,443,5,330,1,66,4,264,1216.097129,15.083253,35.0057113,140.0228452,Benign
172.30.15.2315,51645,52.55.184.84,443,101,84907,37,4095,64,80812,5039.098544,8.747338,3745.139378,73907.74199,Benign
172.30.6.255,57568,176.34.147.227,443,12,1416,6,904,6,512,3255.891837,33.802464,213.9489003,121.1745984,Benign
172.30.15.1008,50314,52.85.51.95,80,8,480,5,294,3,186,3443.628482,3.631884,647.5977757,409.7047152,Benign
172.30.6.255,56774,23.198.126.238,443,18,6438,9,1373,9,5065,1245.554772,1.767508,6214.39903,22924.9316,Benign
192.168.137.97,41738,104.197.3.80,80,10,911,5,425,5,486,1681.530793,1.018129129,3339.458526,3818.769043,Benign
172.30.6.255,57341,52.84.110.215,443,11,1405,7,958,4,447,2475.901263,35.517496,215.7809774,100.6827734,Benign
192.168.43.233,51206,52.175.28.154,443,5,294,3,174,2,120,1240.28393,0.631202,2205.316206,1520.907728,Benign
172.30.1.136,50568,172.217.161.14,443,36,8988,16,2909,20,6079,1561.183314,10.319181,2255.217735,4712.777109,Benign
10.0.2.15,37628,119.254.87.201,80,11,1579,6,705,5,874,22927.65448,1.022891,5513.783971,6835.52793,Malicious
10.0.2.15,53760,119.254.87.201,80,12,1642,7,779,5,863,8028.967464,4.427012,1407.721506,1559.516893,Malicious
192.168.137.97,35488,52.84.108.69,443,9,625,5,330,4,295,11.13607277,84.70459412,31.16714067,27.86153484,Benign
172.30.6.255,58054,151.139.104.15,80,20,13641,7,1816,13,11825,4819.999135,5.995247,2423.252954,15779.1664,Benign
10.0.2.15,40557,119.254.87.201,80,12,1656,7,779,5,877,3345.914342,5.669337,1099.246702,1237.534477,Malicious
10.0.2.15,34288,119.254.87.201,80,11,1579,6,705,5,874,21873.43107,2.084139,2706.153476,3354.862608,Malicious
10.0.2.15,56436,119.254.87.201,80,11,1582,6,705,5,877,15118.86434,1.81624,3105.316478,3862.925605,Malicious
172.30.6.255,57787,157.240.16.39,443,19,1933,11,1179,8,754,4022.102945,61.499544,153.3669908,98.08202806,Benign
10.0.2.15,49374,219.234.85.243,80,7,428,4,236,3,192,22.850811,0.743576,2539.081412,2065.693352,Malicious
172.30.6.255,58121,157.240.16.63,443,1244,1083023,480,32859,764,1050164,4895.140764,3.937491,66761.29545,2133671.417,Benign
192.168.43.233,51131,204.79.197.222,443,1,54,0,0,1,54,18.492728,0,0,0,Benign
172.30.1.136,50290,172.217.161.4,443,61,12401,27,3059,34,9342,490.391142,106.525294,229.7294763,701.579852,Benign
172.30.6.255,56243,103.243.221.46,80,77,58002,29,16747,48,41255,527.879058,38.745145,3457.8784,8518.228542,Benign
172.30.15.228,49497,40.77.226.92,443,28,9373,15,3161,13,6212,48.524338,0.711539,35539.865,69842.97417,Benign
10.0.2.15,37724,119.254.87.201,80,11,1579,6,705,5,874,19380.81014,2.067704,2727.663147,3381.528497,Malicious
192.168.137.97,55734,52.196.253.57,443,6,412,4,272,2,140,349.1496196,14.68739887,148.1542116,76.25584418,Benign
172.30.15.1129,50437,50.23.131.235,80,6,348,4,228,2,120,3458.299798,9.60015,189.9970313,99.99843752,Benign
172.30.1.136,50691,172.217.161.14,443,44,10264,21,6174,23,4090,1822.315513,5.828765,8473.836224,5613.53906,Benign
10.0.2.15,35752,119.254.87.201,80,11,1579,6,705,5,874,18567.39712,1.448937,3892.508784,4825.606634,Malicious
172.30.6.255,56911,54.148.146.218,80,13,2583,7,1763,6,820,1385.946431,67.216637,209.8290041,97.59488562,Benign
192.168.43.233,51271,172.82.241.224,443,8,456,4,228,4,228,1975.292472,16.966095,107.5085339,107.5085339,Benign
192.168.43.224,36040,34.204.88.0,443,21,7925,11,1926,10,5999,30.22421442,2.406631016,6402.310906,19941.56964,Benign
172.30.15.1109,50417,151.101.130.2,443,13,1479,6,904,7,575,3458.26796,9.371457,771.7049761,490.8521695,Benign
172.30.15.1708,51019,103.254.155.35,443,19,7605,10,1995,9,5610,3617.47946,9.602324,1662.097634,4673.868534,Benign
172.30.6.255,58570,103.243.221.51,80,22,15192,15,7035,7,8157,5879.861714,1.809258,31106.67467,36067.82449,Benign
10.0.2.15,50576,119.254.87.201,80,11,1560,6,705,5,855,12775.97464,2.135089,2641.576065,3203.613526,Malicious
192.168.43.224,51466,23.213.88.167,443,205,135147,100,8812,105,126335,1282.434353,154.8082958,455.3761129,6528.590698,Benign
192.168.215.28,54941,122.15.34.17,80,5,300,0,0,5,300,235.4133091,1.727026385,0,1389.671878,Benign
192.168.137.97,57130,18.211.245.141,443,57,11595,31,4844,26,6751,6799.184412,100.6390038,385.0594553,536.650781,Benign
172.30.6.255,57899,103.243.221.87,80,70,48306,44,40445,26,7861,4405.834438,28.248916,11453.89083,2226.209317,Benign
10.0.2.15,41033,119.254.87.201,80,11,1582,6,705,5,877,8749.688734,1.093181,5159.255421,6417.967381,Malicious
192.168.43.233,51122,52.216.17.48,443,36,7193,17,2168,19,5025,920.277522,17.189943,1008.962043,2338.57669,Benign
172.30.6.255,57935,103.243.221.75,80,7,406,5,294,2,112,4526.841819,27.973046,84.08093992,32.03083425,Benign
172.30.15.2185,51497,180.149.59.77,443,26,9310,14,2120,12,7190,4274.141769,3.436961,4934.591926,16735.71507,Benign
10.0.2.15,46852,119.254.87.201,80,11,1579,6,705,5,874,4185.06792,1.295987,4351.895505,5395.115846,Malicious
10.0.2.15,40688,119.254.87.201,80,11,1558,6,705,5,853,15178.88704,1.230735,4582.627454,5544.654211,Malicious
192.168.137.97,47624,52.84.108.11,443,28,4612,15,2783,13,1829,1820.886366,213.1897968,104.4327652,68.63367863,Benign
172.30.1.136,50624,172.217.161.14,443,246,74247,109,50908,137,23339,1659.327324,136.850968,2975.967258,1364.345483,Benign
10.0.2.15,56453,119.254.87.201,80,11,1513,6,705,5,808,431.013049,1.62553,3469.637595,3976.549187,Malicious
172.30.15.1274,50582,208.100.17.185,80,6,531,4,228,2,303,3469.547744,8.105205,225.0405758,299.067081,Benign
10.0.2.15,55732,119.254.87.201,80,11,1513,6,705,5,808,18207.05467,2.134121,2642.774238,3028.88168,Malicious
192.168.137.97,36292,52.84.103.186,443,425,332081,184,16366,241,315715,3708.691226,87.19623091,1501.532791,28965.93091,Benign
172.30.1.136,51887,52.84.110.171,443,39,8008,19,5352,20,2656,4531.167266,163.740566,261.4868206,129.7662547,Benign
10.0.2.15,46841,119.254.87.201,80,11,1593,6,705,5,888,12290.6226,1.544934,3650.641387,4598.254683,Malicious
192.168.43.224,41536,18.210.21.97,443,13,874,7,482,6,392,1758.834742,139.101805,27.72070427,22.54463916,Benign
172.30.6.255,58367,210.176.156.21,80,3,198,3,198,0,0,5484.862013,9.000552,175.989206,0,Benign
172.30.6.255,58357,65.52.162.217,443,21,9872,13,1097,8,8775,5462.502391,109.825783,79.90837634,639.1941681,Benign
10.0.2.15,49460,119.254.87.201,80,11,1582,6,705,5,877,15539.25911,1.497214,3766.996568,4686.036866,Malicious
192.168.137.97,45320,103.243.221.75,443,31,10766,18,4960,13,5806,347.3471398,15.8268289,2507.13521,2934.763514,Benign
172.30.15.394,49662,62.210.213.13,80,26,16080,11,1008,15,15072,1470.367199,4.456099,1809.654588,27058.64479,Benign
172.30.15.748,50038,104.19.196.151,443,16,5897,9,1091,7,4806,2576.169602,9.994009,873.3232079,3847.1048,Benign
10.0.2.15,54482,119.254.87.201,80,11,1579,6,705,5,874,19107.88346,2.192069,2572.91171,3189.680617,Malicious
172.30.15.1796,51108,184.29.24.149,443,17,3375,9,2310,8,1065,3648.841904,8.226249,2246.467375,1035.708985,Benign
172.30.6.255,57704,172.30.13.95,7680,3,198,3,198,0,0,3689.442527,9.005356,175.8953227,0,Benign
10.0.2.15,49755,119.254.87.201,80,11,1587,6,705,5,882,22354.09787,1.421368,3968.008285,4964.231642,Malicious
192.168.43.224,47428,104.16.121.145,443,2049,1704637,819,49018,1230,1655619,152.1318036,459.4016322,853.5973155,28830.87711,Benign
172.30.15.1642,50952,184.29.25.7,443,12,1423,6,904,6,519,3576.421581,0.644071,11228.57573,6446.494253,Benign
10.0.2.15,55044,119.254.87.201,80,11,1568,6,705,5,863,10428.81852,1.412101,3994.048584,4889.168693,Malicious
192.168.43.224,53974,14.139.116.17,443,15,1778,8,1159,7,619,1573.533238,61.76218426,150.1242242,80.17851148,Benign
172.30.15.733,50020,104.31.90.207,80,12,2626,7,1888,5,738,2469.906714,6.330377,2385.955844,932.6458756,Benign
10.0.2.15,55219,119.254.87.201,80,13,1661,8,853,5,808,17188.27972,10.066776,677.8734324,642.1122314,Malicious
172.30.6.255,58029,172.217.166.206,443,37,7213,21,4862,16,2351,4780.431318,91.049323,427.1970259,206.5693558,Benign
172.30.6.255,58492,157.240.16.17,443,533,448704,219,14893,314,433811,5710.945816,8.132549,14650.26525,426740.4967,Benign
10.0.2.15,54031,119.254.87.201,80,11,1582,6,705,5,877,11602.52682,1.487914,3790.541658,4715.326289,Malicious
192.168.43.233,51045,23.213.64.67,443,309,214316,129,16874,180,197442,887.655007,241.199072,559.6704783,6548.681912,Benign
172.30.6.255,56967,103.243.220.231,80,30,20658,14,5490,16,15168,1417.846776,1.533698,28636.66771,79118.57484,Benign
172.30.1.136,50247,52.84.103.186,443,686,494602,287,22116,399,472486,439.734255,192.269039,920.2105597,19659.36908,Benign
172.30.6.255,56948,13.228.173.43,443,24,9113,12,2693,12,6420,1389.149786,65.104209,330.9156248,788.889087,Benign
172.30.6.255,57394,157.240.16.39,443,27,5453,15,3397,12,2056,2680.089244,61.049369,445.1479261,269.4212941,Benign
172.30.6.255,57164,157.240.16.39,443,19,1933,10,1125,9,808,1948.082776,61.042888,147.4373231,105.8927618,Benign
172.30.6.255,56142,103.243.221.87,80,15,4177,8,2950,7,1227,368.848818,25.176553,937.3801092,389.8865742,Benign
172.30.6.255,58464,122.15.34.32,80,10,1221,6,705,4,516,5669.069575,60.105849,93.83446193,68.67884022,Benign
192.168.42.240,50983,172.217.163.67,443,22,1212,12,660,10,552,296.37858,31.606327,167.0551596,139.7188607,Benign
192.168.137.97,45806,52.84.110.78,443,22,7399,12,1451,10,5948,71.57815368,17.37824921,667.9614187,2738.135437,Benign
192.168.43.233,51207,52.175.28.154,443,27,10232,16,3524,11,6708,1240.285259,2.108668,13369.57738,25449.24094,Benign
172.30.15.1918,51230,205.185.216.42,443,115,94587,42,3334,73,91253,3985.591634,1.793889,14868.25551,406950.4858,Benign
10.0.2.15,42594,119.254.87.201,80,11,1579,6,705,5,874,18572.96694,1.911169,2951.073401,3658.493833,Malicious
192.168.43.224,38248,140.98.193.112,443,74,48515,37,8352,37,40163,2297.004742,9.445872013,7073.566094,34015.28197,Benign
192.168.43.224,55396,34.200.202.18,443,16,1816,9,1170,7,646,3150.032275,94.51254517,99.03447191,54.68057167,Benign
172.30.6.255,58250,157.240.16.39,443,5,330,1,66,4,264,5242.082605,15.053555,35.07477137,140.2990855,Benign
172.30.6.255,56584,23.58.55.14,443,34,9953,18,1853,16,8100,899.075774,70.759711,209.4977465,915.7753626,Benign
172.30.6.255,57091,103.243.221.46,80,101,71855,61,60015,40,11840,1734.844411,35.998598,13337.18608,2631.213582,Benign
172.30.6.255,57811,52.213.19.114,443,146,55263,84,43252,62,12011,4042.865948,731.152843,473.2471511,131.4198542,Benign
192.168.137.97,60104,172.217.161.4,443,13,922,10,716,3,206,3759.489334,107.3067451,53.37968267,15.35784166,Benign
172.30.6.255,57544,103.243.220.231,80,35,19782,15,9545,20,10237,3188.843581,30.183849,2529.829778,2713.239123,Benign
172.30.6.255,55617,157.240.189.81,443,17,4928,10,1157,7,3771,2.707268,11.679772,792.4812231,2582.927132,Benign
10.0.2.15,53954,119.254.87.201,80,11,1513,6,705,5,808,2020.285212,1.830794,3080.63059,3530.708534,Malicious
192.168.137.97,49446,157.240.16.52,443,31,8385,15,1989,16,6396,6794.725306,66.07939761,240.8012266,774.3411994,Benign
192.168.137.97,36294,52.84.103.186,443,18,7210,10,1311,8,5899,3708.941816,12.2521943,856.0099311,3851.718218,Benign
192.168.43.224,49960,34.196.177.243,443,269,28975,152,14196,117,14779,2085.467602,309.5559495,366.8739049,381.9406481,Benign
172.30.6.255,58379,103.243.221.51,80,6,348,4,228,2,120,5485.110311,4.10909,443.8939035,233.6283703,Benign
10.0.2.15,49568,119.254.87.201,80,12,1653,7,779,5,874,2440.95468,4.520122,1378.723849,1546.860903,Malicious
192.168.43.224,58306,23.23.105.113,443,6,412,4,272,2,140,93.88281447,12.87822299,168.9674112,86.96852048,Benign
172.30.6.255,57951,172.217.166.206,443,41,6372,22,3902,19,2470,4580.422438,99.780672,312.8461592,198.0343448,Benign
10.0.2.15,43611,119.254.87.201,80,11,1513,6,705,5,808,20041.48831,1.018664,5536.663709,6345.56635,Malicious
192.168.43.224,51490,157.240.16.20,443,111,84925,43,3853,68,81072,302.8558704,65.76144482,468.7244948,9862.557032,Benign
192.168.137.97,60136,172.217.161.4,443,427,265785,211,19215,216,246570,3799.343704,405.7693075,378.8359474,4861.284389,Benign
10.0.2.15,55573,119.254.87.201,80,11,1582,6,705,5,877,18570.01252,4.468686,1262.115978,1570.036472,Malicious
172.30.6.255,58581,157.240.16.17,443,1,66,1,66,0,0,5881.352933,0,0,0,Benign
192.168.43.233,51279,13.107.42.254,443,10,826,6,578,4,248,2720.181767,181.641154,25.45678608,10.92263486,Benign
172.30.15.2130,51442,52.84.110.163,443,11,1405,7,958,4,447,4178.438866,8.911444,860.017748,401.2817676,Benign
172.30.15.1948,51260,151.101.130.2,443,19,3004,10,1905,9,1099,4028.431982,8.825552,1726.80417,996.1983114,Benign
172.30.16.59,62078,172.30.6.255,56628,3,198,0,0,3,198,1007.37647,9.005058,0,175.9011436,Benign
10.0.2.15,49704,119.254.87.201,80,11,1579,6,705,5,874,10971.80355,4.932645,1143.402779,1417.495076,Malicious
10.0.2.15,39950,119.254.87.201,80,11,1513,6,705,5,808,6919.899068,1.352815,4169.084465,4778.184748,Malicious
172.30.15.1563,50872,52.84.108.98,443,17,6849,8,1087,9,5762,3557.050667,0.169107,51423.0635,272584.8132,Benign
192.168.43.233,51482,104.131.222.33,80,11,655,6,349,5,306,3816.688434,74.768802,37.34177792,32.7409285,Benign
10.0.2.15,33732,119.254.87.201,80,11,1582,6,705,5,877,22862.1044,1.885549,2991.171272,3720.932206,Malicious
172.30.6.255,56785,157.240.16.16,443,831,221798,479,97193,352,124605,1251.125239,4605.583866,168.8263687,216.4416128,Benign
172.30.15.2212,51527,13.107.21.200,443,31,14854,15,1504,16,13350,4438.805747,8.682353,1385.799449,12300.81292,Benign
10.0.2.15,44759,119.254.87.201,80,11,1579,6,705,5,874,5566.381844,1.897879,2971.738451,3684.112633,Malicious
192.168.42.240,50981,172.217.163.67,443,17,5693,7,1165,10,4528,296.179534,0.805617,11568.77275,44964.29445,Benign
10.0.2.15,37202,119.254.87.201,80,11,1582,6,705,5,877,9527.801534,2.044404,2758.750227,3431.807021,Malicious
172.30.1.136,50231,104.237.191.1,443,3,198,3,198,0,0,428.95403,9.001291,175.9747574,0,Benign
192.168.43.233,51358,139.59.72.43,443,55,18986,27,8049,28,10937,3137.070361,134.944219,477.1749429,648.386427,Benign
172.30.15.883,50189,180.149.59.145,80,10,1522,6,769,4,753,3437.357996,9.625148,639.1590031,625.8605062,Benign
10.0.2.15,54964,119.254.87.201,80,13,1661,8,853,5,808,18690.05789,10.409302,655.5674915,620.98304,Malicious
10.0.2.15,32979,119.254.87.201,80,12,1587,7,779,5,808,9200.180076,5.066329,1230.081978,1275.874504,Malicious
172.30.6.255,58341,173.241.248.220,80,10,2495,6,1300,4,1195,5419.842282,9.321976,1115.643293,1025.533642,Benign
192.168.215.49,60642,52.204.146.6,443,36,8526,18,3642,18,4884,556.430563,60.93636335,478.1381494,641.1934985,Benign
172.30.6.255,57001,54.194.27.245,443,19,6444,10,1207,9,5237,1484.685709,13.960125,691.684351,3001.119259,Benign
172.30.6.255,56477,52.114.76.35,443,20,9779,12,3370,8,6409,782.704855,1.394494,19333.17748,36767.4583,Benign
192.168.43.233,51652,35.241.16.233,443,7,402,4,228,3,174,855.899279,14.152745,128.8795919,98.35547804,Benign
10.0.2.15,40122,119.254.87.201,80,11,1513,6,705,5,808,18630.01148,2.289056,2463.897781,2823.8715,Malicious
192.168.137.97,39786,192.168.125.6,80,64,42318,33,2794,31,39524,8368.179272,12.91951752,1730.095568,24473.97896,Benign
10.0.2.15,60593,119.254.87.201,80,11,1582,6,705,5,877,10671.53517,2.961139,1904.672493,2369.358548,Malicious
172.30.1.136,50143,172.217.161.14,443,78,18200,38,8064,40,10136,117.293916,248.132072,259.9905747,326.7937085,Benign
10.0.2.15,46833,119.254.87.201,80,12,1656,7,779,5,877,10251.13509,3.813607,1634.148458,1839.72811,Malicious
172.30.6.255,55821,103.243.221.75,80,12,3361,7,2168,5,1193,91.141897,10.925794,1587.436117,873.5291916,Benign
192.168.43.233,50912,83.231.173.69,443,125,87198,47,3692,78,83506,371.956183,314.079228,94.03996625,2127.004719,Benign
10.0.2.15,41174,119.254.87.201,80,11,1513,6,705,5,808,5898.800706,0.89064,6332.524926,7257.702326,Malicious
172.30.15.1806,51118,157.240.16.39,443,6,348,4,228,2,120,3701.095865,6.282487,290.3308833,152.8057281,Benign
172.30.6.255,57391,54.194.27.245,443,21,6576,11,1273,10,5303,2665.783577,45.185998,225.3795523,938.8749143,Benign
172.30.15.1599,50908,52.84.110.44,443,21,7817,12,1738,9,6079,3572.944506,4.054541,3429.241436,11994.45264,Benign
192.168.43.233,51260,163.53.79.200,443,28,8401,14,1951,14,6450,1946.821973,68.425136,228.1033099,754.1088409,Benign
172.30.15.369,49637,195.154.150.142,80,14,3848,7,924,7,2924,1442.716201,7.837672,943.1371969,2984.559701,Benign
172.30.15.2184,51496,180.149.59.77,443,22,7678,11,1922,11,5756,4274.141378,3.43725,4473.343516,13396.75613,Benign
10.0.2.15,34225,119.254.87.201,80,11,1579,6,705,5,874,16467.40761,1.719122,3280.744473,4067.192439,Malicious
192.168.43.224,36026,52.206.154.207,443,28,6840,15,2138,13,4702,50.30682029,13.37766431,1278.54905,2811.851092,Benign
192.168.43.233,51470,54.81.94.76,80,11,655,6,349,5,306,3816.109748,76.354135,36.56645446,32.06113199,Benign
192.168.215.49,34610,52.84.110.12,443,68,46693,31,3268,37,43425,2093.877001,2.919557815,8954.780709,118990.6219,Benign
172.30.6.255,56815,157.240.16.39,443,25,5255,14,3256,11,1999,1277.146152,61.013761,426.9200845,262.1048062,Benign
172.30.6.255,57636,172.30.13.95,7680,3,198,3,198,0,0,3488.797569,9.002521,175.9507142,0,Benign
192.168.43.224,59342,140.98.193.112,443,31,14994,16,4582,15,10412,51.73858145,5.978456267,6131.34869,13932.69371,Benign
172.30.1.136,51776,172.217.160.243,443,36,7410,16,2621,20,4789,2974.075184,42.207824,496.7799335,907.6990086,Benign
172.30.15.664,49951,172.217.166.193,443,6,348,4,228,2,120,2397.031542,9.178098,198.7339861,104.5968348,Benign
172.30.6.255,56229,104.122.118.96,80,33,6314,19,3728,14,2586,470.599544,385.506032,77.36325122,53.66452995,Benign
172.30.1.136,50210,52.84.109.5,443,162,124224,67,5432,95,118792,369.455128,13.916993,3122.513606,68286.01552,Benign
172.30.6.255,55607,172.217.166.197,443,41,14779,15,2860,26,11919,27.267276,31.347316,729.88705,3041.791521,Benign
10.0.2.15,50442,119.254.87.201,80,11,1582,6,705,5,877,4186.933975,1.508911,3737.795006,4649.71095,Malicious
10.0.2.15,58712,119.254.87.201,80,11,1579,6,705,5,874,26499.23491,0.947784,5950.72295,7377.208309,Malicious
192.168.137.97,39464,172.217.161.4,443,46,6389,24,2749,22,3640,325.0769096,256.185767,85.84395713,113.6675169,Benign
10.0.2.15,46653,119.254.87.201,80,11,1582,6,705,5,877,10491.40161,0.824501,6840.501103,8509.389315,Malicious
172.30.6.255,57150,157.240.16.39,443,19,1933,10,1125,9,808,1887.102572,61.005469,147.5277569,105.9577134,Benign
172.30.6.255,56458,103.243.220.231,80,6,340,4,228,2,112,710.666404,36.404188,50.10412538,24.61255282,Benign
172.30.15.299,49562,162.125.248.4,443,6,348,4,228,2,120,633.044044,0.315403,5783.077523,3043.725012,Benign
172.30.6.255,58186,157.240.16.39,443,5,330,1,66,4,264,5059.089482,15.066961,35.0435632,140.1742528,Benign
172.30.6.255,56516,23.198.119.247,443,13,3675,7,1177,6,2498,831.967988,41.616158,226.2582721,480.1981,Benign
172.30.6.255,56863,103.243.220.231,80,27,15384,15,8687,12,6697,1375.854359,8.655154,8029.435409,6190.068946,Benign
10.0.2.15,52489,119.254.87.201,80,12,1656,7,779,5,877,8059.022102,252.707735,24.66089928,27.76329739,Malicious
172.30.6.255,57190,172.217.166.206,443,33,5831,19,3753,14,2078,2051.406808,98.786441,303.9283498,168.2822038,Benign
192.168.215.49,54472,18.210.21.97,443,28,6715,14,2157,14,4558,1841.592586,60.93440136,283.1897847,598.4140188,Benign
192.168.43.224,34632,172.217.166.206,443,28,7793,14,2728,14,5065,3249.449157,91.51478574,238.4751253,442.7699816,Benign
10.0.2.15,38258,119.254.87.201,80,11,1579,6,705,5,874,23255.35675,0.898253,6278.854621,7783.998495,Malicious
192.168.43.224,50182,49.44.90.17,443,32,11058,15,2120,17,8938,37.94632436,6.193575809,2738.321209,11544.86555,Benign
10.0.2.15,47068,119.254.87.201,80,11,1582,6,705,5,877,4633.231855,2.255399,2500.666179,3110.757786,Malicious
10.0.2.15,46374,119.254.87.201,80,11,1582,6,705,5,877,14513.1827,0.89914,6272.660542,7803.011767,Malicious
172.30.6.255,56647,103.243.221.109,80,46,29183,26,24866,20,4317,1071.838187,19.228963,10345.22767,1796.040691,Benign
10.0.2.15,57586,119.254.87.201,80,11,1582,6,705,5,877,17551.74716,1.476497,3819.851988,4751.787508,Malicious
192.168.215.49,40820,67.205.1.42,80,11,1987,6,774,5,1213,1268.584521,7.119718579,869.6972965,1362.97522,Benign
172.30.6.255,58009,157.240.16.39,443,19,1945,10,1137,9,808,4754.090649,61.065063,148.9558768,105.8543082,Benign
192.168.43.233,51338,172.217.194.154,443,23,5808,12,1976,11,3832,3374.881605,12.016811,1315.490441,2551.092798,Benign
10.0.2.15,34813,119.254.87.201,80,11,1579,6,705,5,874,1361.893663,0.827263,6817.662581,8451.967512,Malicious
172.30.6.255,55667,172.217.161.2,80,16,9497,7,734,9,8763,38.983946,19.62936,299.1437316,3571.384905,Benign
192.168.43.224,51996,172.217.167.42,443,20,6739,11,1779,9,4960,3015.579139,13.175087,1080.220571,3011.744817,Benign
10.0.2.15,46248,119.254.87.201,80,11,1582,6,705,5,877,17608.81541,1.424499,3959.286739,4925.240383,Malicious
192.168.215.49,42250,111.119.15.1,443,19,5514,10,1311,9,4203,509.9587785,11.20517243,935.9963057,3000.757035,Benign
192.168.43.233,51101,106.10.193.30,443,5,294,3,174,2,120,918.486364,20.719622,67.18269281,46.33289159,Benign
172.30.1.136,50501,172.217.163.133,443,18,1020,11,618,7,402,964.454146,26.146512,189.0883189,122.9991978,Benign
10.0.2.15,42212,119.254.87.201,80,13,1661,8,853,5,808,12325.55879,10.01777,681.1895262,645.2533847,Malicious
172.30.15.477,49752,172.217.166.196,443,22,5840,11,1374,11,4466,1730.054792,1.4899,7377.676354,23980.13289,Benign
192.168.43.224,49330,104.198.143.177,80,10,911,5,425,5,486,1589.540775,1.792318228,1896.984557,2169.257635,Benign
192.168.215.49,35186,52.44.134.29,443,33,11305,16,2572,17,8733,479.7950329,5.920256608,3475.525026,11800.83983,Benign
172.30.15.1369,50677,8.41.222.241,443,7,402,4,228,3,174,3493.439159,3.912451,466.2039218,355.7872035,Benign
10.0.2.15,55567,119.254.87.201,80,11,1513,6,705,5,808,17726.55663,1.480001,3810.808236,4367.564617,Malicious
10.0.2.15,43738,119.254.87.201,80,11,1579,6,705,5,874,4965.761543,4.967358,1135.412426,1407.589306,Malicious
172.30.6.255,56419,52.212.134.173,80,7,402,4,228,3,174,678.978791,19.059632,95.69964415,73.03393896,Benign
172.30.15.1071,50377,147.135.222.139,80,12,1398,7,927,5,471,3452.735733,1.345485,5511.767132,2800.477151,Benign
172.30.6.255,57922,103.243.220.231,80,26,17302,11,4616,15,12686,4465.838034,12.212001,3023.91066,8310.513568,Benign
172.30.6.255,57583,103.243.221.17,80,24,10551,14,8316,10,2235,3315.861027,44.208063,1504.883849,404.4511066,Benign
172.30.6.255,58011,157.240.16.16,443,234,18765,122,11147,112,7618,4759.136948,1116.137106,79.8969943,54.6026108,Benign
10.0.2.15,60637,119.254.87.201,80,13,1727,8,853,5,874,15329.01829,10.807339,631.4227767,646.9677688,Malicious
192.168.43.233,50922,83.212.248.207,80,5,294,3,174,2,120,398.423137,33.157615,41.98130656,28.95262521,Benign
10.0.2.15,59853,119.254.87.201,80,11,1582,6,705,5,877,23257.90516,3.850052,1464.915279,1822.313049,Malicious
172.30.15.1849,51161,52.6.46.142,443,22,4349,12,2884,10,1465,3887.222347,10.190451,2264.080363,1150.096301,Benign
10.0.2.15,46213,119.254.87.201,80,11,1513,6,705,5,808,6349.261061,2.085618,2704.234428,3099.32116,Malicious
10.0.2.15,34510,119.254.87.201,80,11,1582,6,705,5,877,3884.604092,4.539001,1242.564168,1545.714575,Malicious
192.168.43.233,50939,54.239.35.198,443,39,12232,18,1801,21,10431,452.147825,21.785223,661.365734,3830.486381,Benign
172.30.6.255,57525,103.243.220.231,80,17,5581,9,4299,8,1282,3122.855776,10.743196,3201.282002,954.6507389,Benign
192.168.43.224,42240,172.217.160.226,443,53,8878,28,3382,25,5496,2808.53744,249.5386631,108.4240801,176.197145,Benign
172.30.6.255,56384,103.243.220.231,80,6,340,4,228,2,112,650.180678,26.88753,67.83813909,33.32399815,Benign
192.168.215.49,59174,223.31.160.61,443,512,472538,174,22123,338,450415,279.7385357,13.12906981,13480.31526,274453.564,Benign
192.168.137.97,35754,140.234.252.142,80,11,730,6,404,5,326,8277.360248,17.49910266,184.6951848,149.0362135,Benign
10.0.2.15,36280,119.254.87.201,80,11,1587,6,705,5,882,10729.08567,1.035893,5444.57777,6811.514317,Malicious
172.30.6.255,58289,192.0.73.2,443,44,13101,27,3213,17,9888,5320.913863,3.073666,8362.652286,25736.04289,Benign
172.30.6.255,57308,103.243.221.17,80,40,24223,23,20067,17,4156,2439.842239,14.045301,11429.87252,2367.197399,Benign
10.0.2.15,55782,119.254.87.201,80,11,1582,6,705,5,877,4753.31824,0.819747,6880.171565,8558.738245,Malicious
172.30.1.136,51830,52.84.110.227,443,50,13747,27,9814,23,3933,3304.976313,16.34893,4802.271464,1924.529618,Benign
10.0.2.15,55417,119.254.87.201,80,11,1582,6,705,5,877,6469.345718,1.348781,4181.553566,5201.73401,Malicious
192.168.43.224,33128,172.217.166.195,443,9,618,5,338,4,280,70.65944975,16.87437482,160.2429737,132.7456587,Benign
192.168.215.49,42790,35.237.145.81,443,101,31741,49,4287,52,27454,787.2255575,1336.287661,25.6651326,164.3598205,Benign
172.30.15.1037,50343,103.15.158.128,443,28,11053,14,3392,14,7661,3447.533519,10.251747,2646.963488,5978.298138,Benign
172.30.6.255,58257,172.217.167.2,80,9,1555,6,939,3,616,5264.57085,4.402625,1706.254791,1119.332217,Benign
172.30.6.255,56931,54.169.196.206,80,14,3239,8,2184,6,1055,1387.444561,65.473133,266.8575521,128.9078377,Benign
172.30.6.255,56947,54.169.163.209,443,40,10711,19,4507,21,6204,1388.869405,61.164529,589.4919913,811.4507021,Benign
172.30.1.136,51848,13.107.4.52,80,10,1519,5,436,5,1083,3829.352026,0.2528,13797.46835,34272.1519,Benign
172.30.6.255,57903,103.243.221.75,80,19,9662,9,4226,10,5436,4417.838817,16.244696,2081.171602,2677.058407,Benign
192.168.43.224,54244,23.60.211.179,443,27,3874,15,2614,12,1260,690.0076136,272.6011701,76.71280353,36.97709734,Benign
10.0.2.15,50653,119.254.87.201,80,11,1582,6,705,5,877,18780.18569,2.293224,2459.419577,3059.448183,Malicious
172.30.1.136,50443,157.240.16.17,443,27,6482,7,983,20,5499,855.434705,157.914537,49.79908848,278.5810657,Benign
172.30.6.255,57028,172.217.194.189,443,7,402,4,228,3,174,1550.518373,43.430401,41.99823069,32.05128131,Benign
192.168.137.97,40100,216.58.192.131,443,11,738,7,470,4,268,3808.924478,24.44884936,153.7904686,87.69328848,Benign
172.30.6.255,56954,23.198.141.211,443,6,348,4,228,2,120,1389.830731,14.650337,124.5022555,65.52750288,Benign
172.30.1.136,51923,23.57.218.72,443,21,8944,10,1008,11,7936,6219.56149,61.92192,130.22852,1025.291205,Benign
172.30.6.255,55626,157.240.16.16,443,802,61599,406,30374,396,31225,7.517553,5867.769455,41.41130661,42.57154306,Benign
172.30.15.2268,51586,52.220.171.90,443,16,4298,9,2989,7,1309,4508.423066,9.203564,2598.123944,1137.820088,Benign
172.30.6.255,55643,122.15.34.40,80,316,341288,74,8912,242,332376,36.774897,21.801824,3270.1851,121962.6395,Benign
172.30.6.255,57594,157.240.16.39,443,19,1933,10,1125,9,808,3351.45208,60.675074,148.3310923,106.5346867,Benign
192.168.43.224,59954,23.213.72.244,443,30,7324,16,2137,14,5187,52.65634358,70.79306738,241.4925731,586.1590906,Benign
172.30.15.2499,51833,14.139.45.128,80,10,1404,5,674,5,730,5475.720178,0.182957,29471.40585,31920.06865,Benign
172.30.1.136,50641,157.240.16.20,443,11,1634,6,917,5,717,1746.176267,0.706676,10380.99497,8116.873928,Benign
192.168.137.97,41918,172.217.161.5,443,43,8248,21,2804,22,5444,64.49275995,240.359336,93.32693448,181.1953749,Benign
192.168.137.97,57548,169.60.79.147,443,25,5876,14,1575,11,4301,6779.519991,25.84601443,487.5026297,1331.269086,Benign
172.30.6.255,56837,122.15.34.105,443,8,480,5,294,3,186,1319.894002,18.796385,125.130444,79.16415843,Benign
192.168.137.97,42470,52.84.110.205,443,49,18896,28,4573,21,14323,382.0662012,162.8661408,224.6261857,703.5470934,Benign
172.30.6.255,55931,202.58.9.200,80,11,1722,6,955,5,767,152.439445,6.539618,1168.263957,938.2811045,Benign
172.30.6.255,56076,37.157.6.251,80,6,344,4,228,2,116,286.669369,17.427278,104.6635051,53.24985348,Benign
192.168.43.224,37496,157.240.16.20,443,14,1469,6,937,8,532,39.04671813,5.117415832,1464.801815,831.6697606,Benign
172.30.1.136,51893,184.29.24.103,443,24,4299,12,1503,12,2796,4603.038728,102.762611,117.0075369,217.6667154,Benign
172.30.15.1451,50759,103.231.98.244,443,14,1196,8,860,6,336,3502.044832,0.758692,9068.238495,3542.939691,Benign
192.168.137.97,50136,169.237.6.105,80,3,214,2,140,1,74,1957.058143,0.412079422,2717.922663,1436.616265,Benign
10.0.2.15,58319,119.254.87.201,80,11,1579,6,705,5,874,18987.79109,1.458678,3866.514748,4793.381404,Malicious
172.30.6.255,58298,157.240.16.20,443,219,144178,107,11338,112,132840,5326.347453,7.655796,11847.75561,138812.4762,Benign
172.30.15.762,50053,209.197.3.15,443,28,13149,13,1791,15,11358,2617.478088,8.898241,1610.205882,10211.4564,Benign
192.168.137.97,60680,172.217.161.4,443,46,5770,23,3265,23,2505,10925.45742,241.4717385,108.1700085,82.99107846,Benign
172.30.6.255,58383,157.240.16.39,443,19,1933,10,1125,9,808,5486.087127,61.070617,147.3703794,105.8446814,Benign
172.30.15.2395,51729,14.139.45.128,80,46,40859,15,1174,31,39685,5340.43953,0.146068,64298.81973,2173508.229,Benign
10.0.2.15,48530,119.254.87.201,80,11,1582,6,705,5,877,638.818029,0.83723,6736.500125,8380.01505,Malicious
172.30.6.255,58066,103.243.221.51,80,30,20677,13,5455,17,15222,4826.858088,1.539956,28338.47201,79077.58403,Benign
172.30.6.255,57527,103.231.98.53,80,159,80988,80,73406,79,7582,3122.882639,308.077851,1906.167542,196.8852996,Benign
172.30.6.255,57483,52.229.174.172,443,27,10013,14,2164,13,7849,3019.7049,123.863187,139.7671126,506.9464263,Benign
172.30.15.614,49901,178.237.36.10,80,12,2783,7,728,5,2055,2390.17775,1.664435,3499.085275,9877.225605,Benign
10.0.2.15,43559,119.254.87.201,80,11,1582,6,705,5,877,19320.72732,2.217116,2543.845248,3164.471322,Malicious
172.30.6.255,57517,157.240.16.16,443,317,63433,139,18178,178,45255,3079.972018,1819.265164,79.93557117,199.0034258,Benign
172.30.6.255,57303,157.240.16.39,443,27,5292,13,2282,14,3010,2423.843067,65.191089,280.0382733,369.3756366,Benign
172.30.6.255,55618,157.240.16.20,443,4051,3950747,1218,84495,2833,3866252,3.121596,120.474842,5610.797979,256734.2317,Benign
10.0.2.15,41782,119.254.87.201,80,11,1582,6,705,5,877,20849.71781,1.38679,4066.945969,5059.165411,Malicious
10.0.2.15,55683,119.254.87.201,80,11,1513,6,705,5,808,7996.269335,1.024886,5503.051071,6307.04293,Malicious
10.0.2.15,42457,119.254.87.201,80,11,1593,6,705,5,888,25865.48472,0.905343,6229.683115,7846.749795,Malicious
192.168.43.233,51214,13.107.3.128,443,66,16471,34,5510,32,10961,1246.483261,128.023667,344.3113374,684.9358564,Benign
192.168.43.233,51410,23.100.69.251,443,21,8378,10,1601,11,6777,3647.787027,129.718332,98.73700812,417.9517202,Benign
192.168.43.233,50905,128.135.53.136,80,183,167591,65,3906,118,163685,334.917825,5.574371,5605.65488,234910.8088,Benign
10.0.2.15,40908,119.254.87.201,80,11,1579,6,705,5,874,24128.84132,1.482777,3803.673782,4715.476434,Malicious
192.168.43.224,42258,192.229.237.25,443,36,14566,20,3045,16,11521,1301.192802,191.9797479,126.8883841,480.0923066,Benign
172.30.1.136,50398,74.125.128.94,443,9,534,5,294,4,240,769.409808,14.692324,160.0835919,130.6804832,Benign
172.30.6.255,56526,23.198.119.247,443,18,9248,9,1170,9,8078,831.96855,41.617002,224.9080796,1552.826895,Benign
192.168.43.233,51200,172.217.166.197,443,1611,1024449,687,84830,924,939619,1215.324121,481.59344,1409.155407,15608.50164,Benign
192.168.137.97,57592,72.247.219.151,443,16,1787,9,1134,7,653,376.7303823,14.28374521,635.1275432,365.7304107,Benign
10.0.2.15,36146,119.254.87.201,80,12,1656,7,779,5,877,15236.16092,4.538485,1373.145444,1545.890314,Malicious
192.168.43.224,35038,34.232.42.95,443,514,412671,232,31912,282,380759,3015.332866,25.78098013,9902.493959,118151.9083,Benign
172.30.6.255,58521,157.240.16.17,443,378,323347,148,9972,230,313375,5771.323289,7.878451,10125.84834,318209.7598,Benign
192.168.43.233,51134,34.231.96.113,443,7,402,4,228,3,174,923.87922,16.792344,108.6209287,82.89491926,Benign
172.30.15.630,49917,23.198.105.137,443,507,423244,211,15554,296,407690,2392.575744,3.721244,33438.28032,876459.5925,Benign
192.168.215.49,36802,52.221.126.200,443,26,9045,15,2661,11,6384,479.015129,63.15283436,337.0870083,808.7047955,Benign
172.30.6.255,55641,122.15.34.40,80,8,480,5,294,3,186,36.774876,14.554396,161.60066,102.2371523,Benign
192.168.215.49,54226,157.240.16.20,443,18,5378,10,1261,8,4117,118.594616,23.71945174,425.3049401,1388.564979,Benign
172.30.6.255,58138,157.240.16.20,443,499,365192,223,22587,276,342605,4918.729985,10.203712,17708.84949,268612.0502,Benign
172.30.15.1066,50372,199.115.115.133,80,15,2776,9,1576,6,1200,3452.687079,6.581674,1915.622074,1458.595488,Benign
172.30.6.255,58233,35.190.43.164,80,14,2928,8,2140,6,788,5201.840204,57.17862,299.4126126,110.2509994,Benign
10.0.2.15,40846,119.254.87.201,80,11,1582,6,705,5,877,12623.49175,2.151382,2621.570693,3261.159571,Malicious
192.168.43.224,41956,23.251.156.28,443,338,263271,145,14524,193,248747,1054.010111,117.178117,991.5844614,16982.4883,Benign
10.0.2.15,40647,119.254.87.201,80,11,1579,6,705,5,874,4277.176716,1.794316,3143.259047,3896.749513,Malicious
192.168.137.97,34516,172.217.161.19,443,9,622,5,350,4,272,346.631507,17.11463846,163.6026379,127.1426215,Benign
10.0.2.15,45635,119.254.87.201,80,11,1582,6,705,5,877,8746.96191,2.489168,2265.817333,2818.612484,Malicious
172.30.1.136,50448,157.240.16.39,443,3,198,3,198,0,0,857.214471,9.000508,175.9900663,0,Benign
172.30.6.255,58582,54.194.27.245,443,3,186,2,120,1,66,5881.510541,0.215402,4456.783131,2451.230722,Benign
10.0.2.15,55393,119.254.87.201,80,11,1579,6,705,5,874,25450.25841,1.206495,4674.698196,5795.299608,Malicious
172.30.15.1123,50431,184.29.26.86,80,6,348,4,228,2,120,3458.283483,8.865702,205.7366692,108.2824575,Benign
172.30.6.255,57133,103.231.98.53,80,39,17419,20,15673,19,1746,1861.855013,60.077918,2087.023056,232.4980703,Benign
192.168.43.224,39142,169.55.74.49,443,29,7938,15,3052,14,4886,1768.485107,1.804638699,13529.57798,21659.73722,Benign
192.168.137.97,47802,151.101.193.176,443,223,117674,110,9469,113,108205,380.0818146,606.2097076,124.9600576,1427.954698,Benign
172.30.15.2535,51869,139.59.61.230,443,15,6717,7,1000,8,5717,5499.980861,0.424621,18840.33055,107710.1698,Benign
10.0.2.15,58187,119.254.87.201,80,11,1582,6,705,5,877,10854.32359,123.779692,45.56482496,56.68134964,Malicious
172.30.15.547,49831,52.84.110.92,443,26,13064,13,1771,13,11293,2251.942827,4.102915,3453.154647,22019.46665,Benign
172.30.1.136,51856,104.16.92.188,80,11,1337,6,569,5,768,3977.861091,46.221291,98.48275333,132.9257549,Benign
172.30.6.255,56549,172.217.166.195,443,7,402,4,228,3,174,833.252031,11.665387,156.3600076,119.3273742,Benign
10.0.2.15,46193,119.254.87.201,80,11,1513,6,705,5,808,160.756695,1.733021,3254.432578,3729.902869,Malicious
10.0.2.15,48643,119.254.87.201,80,11,1561,6,705,5,856,10038.38677,1.688875,3339.501147,4054.770187,Malicious
172.30.15.201,49449,131.253.61.64,443,1,54,0,0,1,54,0.482912,0,0,0,Benign
192.168.43.224,58284,162.213.83.13,443,27,7190,15,3578,12,3612,252.9011874,88.26006664,324.3142804,327.3960818,Benign
192.168.137.97,34424,172.217.161.3,443,17,2111,11,1547,6,564,325.1853313,30.74323915,402.5600536,146.7639756,Benign
192.168.137.97,40176,157.240.16.20,443,349,266628,150,12926,199,253702,22.89451492,68.501643,1509.569632,29628.72,Benign
172.30.15.2484,51818,14.139.45.128,80,293,278440,100,5939,193,272501,5427.480994,7.549724,6293.210189,288753.3372,Benign
172.30.6.255,58496,23.8.190.108,80,13,5510,6,549,7,4961,5714.128902,60.232293,72.9176955,658.9156418,Benign
172.30.15.1185,50493,172.217.160.226,443,30,6867,14,2224,16,4643,3464.72287,2.499296,7118.804655,14861.78508,Benign
192.168.43.224,49644,52.218.204.96,443,7,417,4,236,3,181,2280.32097,16.507569,114.371777,87.71733744,Benign
172.30.6.255,56570,103.243.221.109,80,66,50598,28,17270,38,33328,887.914021,61.582696,2243.487359,4329.527892,Benign
172.30.6.255,58395,157.240.16.20,443,34,16983,15,1851,19,15132,5533.526836,5.532837,2676.384647,21879.55293,Benign
172.30.6.255,58580,54.194.27.245,443,13,3550,7,2813,6,737,5881.326672,0.86489,26019.49381,6817.051879,Benign
10.0.2.15,54792,119.254.87.201,80,11,1582,6,705,5,877,15864.60874,1.281083,4402.525051,5476.616269,Malicious
172.30.15.718,50005,52.19.169.14,443,6,340,4,228,2,112,2408.171051,8.146576,223.8977455,109.9848574,Benign
192.168.43.224,42682,107.21.25.13,443,20,5278,11,1397,9,3881,39.68503906,47.75068169,234.0490147,650.2106127,Benign
192.168.43.224,42680,107.21.25.13,443,39,8410,22,2782,17,5628,39.12200589,77.85189417,285.8761529,578.3288959,Benign
192.168.137.97,58512,119.81.119.5,443,14,980,8,552,6,428,57.12969062,19.23676832,229.5603881,177.9924748,Benign
172.30.6.255,58551,35.190.43.164,80,10,1629,6,1175,4,454,5813.989399,5.106414,1840.82215,711.2623457,Benign
172.30.15.428,49702,52.84.103.186,443,17,6932,9,1141,8,5791,1622.998571,0.080207,113805.5282,577605.4459,Benign
192.168.215.49,44166,172.217.161.5,443,3823,2528274,1472,226432,2351,2301842,1528.495424,578.1430624,3133.231406,31851.52118,Benign
192.168.215.28,62391,192.12.31.113,5228,9,594,0,0,9,594,1048.645606,94.51113293,0,50.27979088,Benign
10.0.2.15,60203,219.234.85.243,80,7,428,4,236,3,192,190.276769,0.657132,2873.090947,2337.429923,Malicious
10.0.2.15,37958,119.254.87.201,80,11,1582,6,705,5,877,2292.948786,2.196588,2567.618507,3194.044582,Malicious
10.0.2.15,57695,119.254.87.201,80,11,1582,6,705,5,877,21002.43907,1.189052,4743.274474,5900.498885,Malicious
172.30.6.255,58215,54.194.27.245,443,24,10309,13,4820,11,5489,5157.21345,6.885437,5600.225519,6377.518232,Benign
172.30.15.736,50023,172.25.10.63,7680,3,198,3,198,0,0,2493.152756,9.002767,175.9459064,0,Benign
192.168.43.224,51610,157.240.16.20,443,6,412,4,272,2,140,730.5027538,10.91068395,199.4375431,102.6516766,Benign
172.30.15.1494,50802,52.84.110.244,443,15,2564,8,1577,7,987,3520.983323,5.996338,2103.950778,1316.803689,Benign
172.30.1.136,50804,74.125.68.188,5228,3,198,3,198,0,0,1938.859277,9.010632,175.7923307,0,Benign
172.30.6.255,57416,176.34.147.227,443,12,1416,6,904,6,512,2770.643907,23.02066,314.1525916,177.9271315,Benign
192.168.137.97,37776,117.18.237.70,443,27,7870,15,1677,12,6193,285.3539127,28.93615113,463.6414822,1712.183482,Benign
192.168.43.224,45922,104.31.92.239,80,42,13443,22,3357,20,10086,803.76227,77.18525561,347.942101,1045.381004,Benign
172.30.1.136,51891,184.29.24.103,443,34,21199,14,1409,20,19790,4599.469044,3.20926,3512.336177,49332.24482,Benign
172.30.15.2462,51796,14.139.45.128,80,47,39133,17,1296,30,37837,5421.734505,0.317624,32642.36959,953001.0327,Benign
192.168.43.224,59100,54.171.46.4,443,9,610,5,338,4,272,113.1816958,61.70730275,43.81977301,35.26324929,Benign
10.0.2.15,41830,219.234.85.243,80,8,944,4,688,4,256,185.532714,0.62306,8833.820178,3287.002857,Malicious
172.30.15.334,49602,104.25.218.21,443,43,16048,22,2811,21,13237,961.281712,8.942906,2514.61885,11841.34106,Benign
172.30.15.1170,50478,173.241.248.220,80,6,535,4,228,2,307,3460.752883,6.724486,271.2474976,365.2323761,Benign
172.30.15.1524,50832,172.217.166.212,443,29,6969,14,2390,15,4579,3526.49481,0.543449,35182.69424,67406.50917,Benign
192.168.137.97,33634,117.18.237.70,443,201,161698,77,6360,124,155338,305.5175177,92.3415432,550.9979391,13457.69149,Benign
10.0.2.15,51324,119.254.87.201,80,11,1582,6,705,5,877,2413.127862,1.444172,3905.351994,4858.147091,Malicious
10.0.2.15,45149,219.234.85.243,80,8,940,4,684,4,256,177.226358,64.318694,85.07635432,31.84144255,Malicious
192.168.43.233,51662,107.22.42.44,443,15,1836,8,1024,7,812,870.184109,23.76282,344.7402286,273.3682282,Benign
192.168.137.97,48516,172.217.194.189,443,162,33689,82,15492,80,18197,3803.123198,400.8016414,309.2202905,363.2120854,Benign
172.30.6.255,56146,172.217.161.1,80,6,348,4,228,2,120,370.438575,23.401311,77.94435107,41.02334267,Benign
192.168.43.233,51145,172.217.24.234,443,9,534,5,294,4,240,475.299634,11.38606,206.5683827,168.6272512,Benign
192.168.137.97,34526,172.217.161.19,443,11,742,6,416,5,326,346.8177754,17.52652137,189.8836585,148.8030593,Benign
10.0.2.15,59845,119.254.87.201,80,11,1513,6,705,5,808,19258.08928,2.14864,2624.916226,3008.414625,Malicious
192.168.43.233,51043,74.125.24.188,5228,31,1941,15,867,16,1074,34.728427,840.855134,8.248745497,10.21816916,Benign
10.0.2.15,44528,119.254.87.201,80,11,1593,6,705,5,888,4787.600934,1.346836,4187.592253,5274.584285,Malicious
172.30.15.1744,51055,184.29.25.7,443,55,42144,22,4109,33,38035,3633.816594,3.210485,10238.95144,94776.95738,Benign
10.0.2.15,47548,119.254.87.201,80,11,1534,6,705,5,829,6494.82135,2.020774,2791.009781,3281.910793,Malicious
192.168.43.233,50856,172.217.194.189,443,2,108,1,54,1,54,3.007445,0.172924,2498.207305,2498.207305,Benign
172.30.15.705,49992,34.239.20.30,443,6,348,4,228,2,120,2403.406413,2.985062,611.0425847,321.6013604,Benign
10.0.2.15,39827,119.254.87.201,80,11,1513,6,705,5,808,24008.70206,2.053275,2746.831282,3148.141384,Malicious
192.168.43.224,57968,174.129.238.218,443,19,1978,11,1254,8,724,55.33472398,14.49211973,692.2382776,399.6654809,Benign
172.30.6.255,55877,147.75.111.32,443,5,294,3,174,2,120,108.316142,12.812206,108.6463955,74.9285486,Benign
172.30.6.255,56826,103.243.221.51,80,32,16658,19,13183,13,3475,1312.100519,16.374829,6440.616876,1697.727653,Benign
10.0.2.15,56631,119.254.87.201,80,11,1579,6,705,5,874,13674.55559,1.41486,3986.260125,4941.831701,Malicious
172.30.6.255,56206,54.149.221.157,80,7,402,4,228,3,174,467.495472,23.6609,77.08920624,58.83123634,Benign
172.30.15.1500,50808,52.84.110.238,443,15,2925,8,1649,7,1276,3520.989511,5.993418,2201.081253,1703.201746,Benign
192.168.43.233,51414,23.100.69.251,443,21,8349,10,1579,11,6770,3647.78798,127.14388,99.35200971,425.9741012,Benign
10.0.2.15,33983,119.254.87.201,80,11,1579,6,705,5,874,24036.23679,2.071202,2723.056467,3375.81752,Malicious
172.30.15.501,49781,162.247.242.19,443,26,8071,13,4187,13,3884,1909.173826,6.843644,4894.468502,4540.271236,Benign
192.168.43.224,50162,52.207.90.113,443,40,8052,22,2694,18,5358,368.7242448,66.03580367,326.3684063,649.1024205,Benign
172.30.6.255,55925,103.231.98.48,80,31,14952,16,11764,15,3188,122.182588,105.296351,893.7821596,242.2116223,Benign
172.30.6.255,55726,202.241.208.55,80,6,348,4,228,2,120,57.822842,0.904144,2017.377763,1061.77777,Benign
172.30.6.255,56962,172.30.16.59,7680,3,198,3,198,0,0,1396.390541,9.003926,175.9232584,0,Benign
192.168.43.233,51303,104.16.88.20,443,8,456,4,228,4,228,2531.958874,12.222013,149.2389183,149.2389183,Benign
192.168.215.49,36980,157.240.16.52,443,205,172623,75,6125,130,166498,1582.698557,71.18363901,688.360425,18711.94025,Benign
10.0.2.15,59569,119.254.87.201,80,11,1579,6,705,5,874,22894.87083,1.056902,5336.350958,6615.561329,Malicious
172.30.6.255,57194,103.243.221.75,80,25,13235,11,5329,14,7906,2072.849096,15.176527,2809.07483,4167.488385,Benign
172.30.6.255,57556,157.240.16.39,443,28,5608,14,3365,14,2243,3229.098282,61.031133,441.0863551,294.0138765,Benign
10.0.2.15,48556,119.254.87.201,80,12,1659,7,779,5,880,19408.27168,5.213725,1195.306619,1350.282188,Malicious
10.0.2.15,50667,119.254.87.201,80,11,1582,6,705,5,877,26379.0918,0.894083,6308.139177,7847.146182,Malicious
10.0.2.15,42996,119.254.87.201,80,11,1582,6,705,5,877,16227.17816,1.691945,3333.44169,4146.706896,Malicious
192.168.43.224,54210,18.233.7.102,443,9,626,6,412,3,214,90.06765401,16.70439179,197.3133798,102.4880176,Benign
172.30.6.255,57896,103.243.221.75,80,33,20831,15,5555,18,15276,4368.84134,1.460211,30433.95783,83692.01437,Benign
10.0.2.15,58781,119.254.87.201,80,11,1582,6,705,5,877,20705.27525,2.222052,2538.194426,3157.44186,Malicious
10.0.2.15,55987,119.254.87.201,80,11,1582,6,705,5,877,2595.043115,2.217112,2543.849837,3164.477031,Malicious
172.30.15.2038,51350,52.52.93.212,443,6,348,4,228,2,120,4090.767233,6.826761,267.183808,140.6230568,Benign
192.168.43.224,58624,174.129.238.218,443,25,8799,14,1607,11,7192,2449.351046,18.95079076,678.3885781,3036.073836,Benign
172.30.6.255,56043,52.76.32.254,80,19,5210,11,2186,8,3024,254.482382,69.432396,251.870899,348.4252509,Benign
192.168.43.224,59526,49.44.150.71,443,53,13019,29,7120,24,5899,53.65345858,463.9648482,122.7679214,101.7146023,Benign
172.30.15.886,50192,50.23.131.235,80,6,348,4,228,2,120,3438.005845,9.258247,197.0135383,103.691336,Benign
172.30.6.255,56082,103.243.221.87,80,6,348,4,228,2,120,304.112093,19.912285,91.60174234,48.21144334,Benign
192.168.43.224,37552,172.217.166.202,443,8,552,5,346,3,206,3026.61621,13.43387089,206.0463452,122.6749917,Benign
172.30.1.136,50339,172.217.161.3,443,62,8715,31,4600,31,4115,597.927188,32.976191,1115.956661,998.296013,Benign
192.168.42.240,50893,74.125.68.188,5228,27,1614,14,768,13,846,44.861524,563.508857,10.90311168,12.01045896,Benign
172.30.6.255,55735,205.180.87.172,80,6,344,4,228,2,116,58.29439,0.542291,3363.507785,1711.258347,Benign
172.30.1.136,50234,54.194.87.27,443,141,54166,66,40593,75,13573,431.675436,260.661772,1245.844366,416.570482,Benign
10.0.2.15,35120,119.254.87.201,80,11,1579,6,705,5,874,15749.46387,2.085323,2704.616983,3352.957791,Malicious
172.30.15.2095,51407,54.236.156.42,443,22,3707,12,2673,10,1034,4141.758391,5.940158,3599.904245,1392.555552,Benign
10.0.2.15,57954,119.254.87.201,80,11,1582,6,705,5,877,13071.42864,2.235866,2522.51253,3137.934026,Malicious
172.30.15.1944,51256,172.217.166.206,443,16,5627,7,1165,9,4462,4027.434768,0.3844,24245.57752,92861.6025,Benign
172.30.6.255,56796,103.231.98.53,80,7,402,4,228,3,174,1254.101837,10.942986,166.6821103,127.2047684,Benign
172.30.1.136,50158,52.109.124.21,443,22,11030,11,2598,11,8432,147.403928,1.775098,11708.64933,38001.28218,Benign
192.168.137.97,59348,157.240.16.20,443,24,5812,13,1459,11,4353,466.7412612,101.6013957,114.8803116,342.751197,Benign
172.30.1.136,50449,172.217.161.14,443,3,198,3,198,0,0,857.228583,9.002391,175.9532551,0,Benign
192.168.215.49,59402,35.241.16.233,443,156,58788,70,7671,86,51117,478.8941337,381.0540509,161.0480189,1073.170588,Benign
172.30.6.255,58154,173.241.248.220,80,10,2494,6,1300,4,1194,4957.841213,1.203193,8643.667309,7938.875974,Benign
172.30.1.136,51491,66.117.26.67,443,2,108,2,108,0,0,8.948644,0.000123,0,0,Benign
172.30.6.255,58490,157.240.16.17,443,473,401373,195,13121,278,388252,5690.998462,8.043506,13050.03067,386152.0088,Benign
172.30.1.136,51796,107.22.42.44,443,23,6679,11,1904,12,4775,2977.332616,7.552641,2016.777972,5057.833412,Benign
192.168.137.97,48514,172.217.194.189,443,26,6116,14,1687,12,4429,3803.122926,7.380697357,1828.553502,4800.630386,Benign
172.30.1.136,50400,157.240.16.20,443,24,5681,8,1025,16,4656,777.387296,118.303544,69.31322362,314.8510919,Benign
10.0.2.15,42491,119.254.87.201,80,13,1727,8,853,5,874,10578.93777,11.398526,598.6738987,613.4126465,Malicious
172.30.6.255,56282,157.240.16.20,443,29,8368,15,1769,14,6599,567.158235,65.306782,216.7003115,808.369336,Benign
192.168.215.49,53922,18.210.21.97,443,50,9323,27,3357,23,5966,52.18407975,159.3749294,168.50831,299.4699366,Benign
172.30.15.2524,51858,104.19.199.151,443,30,11732,13,1805,17,9927,5489.291763,8.594356,1680.172429,9240.48294,Benign
172.30.15.1630,50940,202.79.210.118,443,11,630,6,348,5,282,3574.656737,12.859683,216.490562,175.4320071,Benign
172.30.15.1425,50733,52.9.96.194,443,6,348,4,228,2,120,3500.40683,6.858222,265.9581448,139.977971,Benign
172.30.6.255,56867,103.231.98.53,80,23,17385,16,16711,7,674,1375.864919,5.580546,23956.07885,966.2137002,Benign
172.30.6.255,58504,103.243.221.51,80,45,29247,26,24983,19,4264,5747.847053,11.371175,17576.37183,2999.865889,Benign
172.30.6.255,57677,103.243.221.75,80,39,24257,23,20155,16,4102,3617.858815,24.170308,6670.994842,1357.698876,Benign
10.0.2.15,46155,119.254.87.201,80,11,1582,6,705,5,877,18633.00588,5.208719,1082.799821,1346.972259,Malicious
192.168.42.240,50961,104.237.191.1,443,76,13073,33,6061,43,7012,227.927194,380.478467,127.4395379,147.4354132,Benign
192.168.43.224,35630,151.101.153.177,443,23,9368,13,1488,10,7880,728.6138484,11.05392101,1076.902937,5702.953724,Benign
192.168.137.97,35422,172.217.161.10,443,11,738,7,470,4,268,148.8499868,148.3322685,25.34849657,14.45403634,Benign
172.30.1.136,50397,74.125.128.94,443,19,5631,11,1252,8,4379,769.159088,14.266898,702.0446911,2455.474203,Benign
10.0.2.15,59687,119.254.87.201,80,12,1653,7,779,5,874,24999.89418,14.466284,430.7948054,483.3307572,Malicious
192.168.137.97,50508,104.17.161.9,443,18,5993,10,1153,8,4840,6.395304729,10.25376965,899.5716032,3776.172211,Benign
172.30.15.784,50076,34.200.202.18,443,134,99065,60,12603,74,86462,2674.669865,11.797732,8546.049359,58629.57389,Benign
10.0.2.15,52075,119.254.87.201,80,11,1582,6,705,5,877,22954.9883,0.959796,5876.248703,7309.886684,Malicious
10.0.2.15,44968,119.254.87.201,80,11,1582,6,705,5,877,24729.6365,2.142382,2632.583732,3274.859479,Malicious
172.30.15.772,50063,157.240.16.20,443,70,39799,32,3107,38,36692,2627.684659,8.554893,2905.471758,34312.05978,Benign
10.0.2.15,41916,119.254.87.201,80,13,1661,8,853,5,808,17426.356,10.1559,671.924694,636.4773186,Malicious
172.30.15.2496,51830,205.185.208.52,80,6,348,4,228,2,120,5475.187457,2.814484,648.076166,341.0927189,Benign
172.30.6.255,55875,147.75.111.32,443,34,15388,15,5087,19,10301,108.154495,38.250527,1063.933054,2154.427833,Benign
172.30.1.136,50538,172.217.160.238,443,31,11237,16,1970,15,9267,1247.168886,78.01841,202.003604,950.2372581,Benign
172.30.1.136,50661,193.32.65.35,443,8,456,4,228,4,228,1784.093902,14.371708,126.9160214,126.9160214,Benign
192.168.43.233,51210,172.217.160.229,443,44,5876,23,3188,21,2688,1216.416402,245.426141,103.9172107,87.61902833,Benign
10.0.2.15,35454,119.254.87.201,80,11,1582,6,705,5,877,18359.70763,1.386638,4067.391778,5059.719985,Malicious
172.30.15.1188,50496,50.116.239.135,80,12,2694,7,994,5,1700,3465.128256,2.137511,3720.214773,6362.540357,Benign
172.30.15.278,49541,180.149.59.81,443,15,5008,8,1219,7,3789,252.155111,2.55493,3816.934319,11864.12152,Benign
192.168.43.224,34182,54.191.37.172,443,7,478,4,272,3,206,197.9382954,14.0057319,155.3649617,117.6661107,Benign
192.168.43.224,38574,34.236.23.199,443,18,2469,11,1803,7,666,940.7916308,34.17802492,422.0255569,155.88964,Benign
192.168.137.97,56476,172.217.161.14,443,56,17476,28,3159,28,14317,1382.260431,240.8637944,104.9223693,475.5218619,Benign
172.30.15.2082,51394,64.74.232.52,443,13,2764,8,2024,5,740,4123.334783,4.313092,3754.151314,1372.565204,Benign
10.0.2.15,60028,119.254.87.201,80,11,1560,6,705,5,855,15989.76075,2.218972,2541.717516,3082.508477,Malicious
172.30.15.659,49946,157.240.16.39,443,35,6565,20,4491,15,2074,2396.744407,9.44108,3805.496829,1757.426057,Benign
172.30.15.1034,50340,173.241.248.143,80,6,535,4,228,2,307,3447.162618,10.097676,180.6356235,243.2242825,Benign
172.30.15.406,49678,162.125.82.3,443,37,21520,15,1798,22,19722,1533.686213,61.246828,234.8529788,2576.068103,Benign
172.30.6.255,56448,54.251.174.92,80,6,348,4,228,2,120,700.569092,10.29271,177.212804,93.26989685,Benign
172.30.6.255,58260,157.240.16.39,443,40,8841,20,3826,20,5015,5268.516064,55.694872,549.5658559,720.3535722,Benign
172.30.1.136,50367,52.94.220.16,443,17,958,10,564,7,394,653.463201,38.966332,115.7922691,80.890344,Benign
172.30.15.1398,50706,182.161.72.94,443,19,6378,10,2494,9,3884,3499.767146,7.3332,2720.776741,4237.167949,Benign
192.168.43.233,51064,49.44.170.52,443,29,10392,14,2054,15,8338,896.250189,19.479191,843.5668607,3424.372193,Benign
172.30.6.255,56875,103.15.158.129,80,6,372,4,252,2,120,1383.679911,10.263729,196.4198392,93.53325677,Benign
172.30.6.255,58544,103.243.221.51,80,16,5907,9,4317,7,1590,5813.893253,5.335359,6473.041458,2384.094491,Benign
10.0.2.15,35252,119.254.87.201,80,11,1582,6,705,5,877,162.514334,3.188007,1769.130369,2200.747991,Malicious
10.0.2.15,49803,119.254.87.201,80,11,1582,6,705,5,877,14903.52611,1.223501,4609.722428,5734.363928,Malicious
172.30.15.249,49517,23.57.219.27,80,16,5496,9,982,7,4514,58.186874,61.52242,127.6932864,586.9730092,Benign
192.168.215.49,49870,104.122.98.112,443,93,50102,46,5671,47,44431,1250.199277,591.392129,76.71390567,601.0360682,Benign
10.0.2.15,43995,119.254.87.201,80,13,1717,8,853,5,864,16765.62019,13.158647,518.5943509,525.2819686,Malicious
172.30.15.1655,50966,184.29.25.7,443,73,27787,33,5501,40,22286,3582.673709,4.825524,9119.838592,36946.86836,Benign
172.30.6.255,56635,103.243.221.109,80,33,23273,20,20934,13,2339,1012.096099,12.975341,12906.94403,1442.120095,Benign
10.0.2.15,51858,119.254.87.201,80,11,1582,6,705,5,877,23345.50293,2.106246,2677.749892,3331.044902,Malicious
192.168.43.233,51319,151.101.154.109,443,110,52159,51,4432,59,47727,3365.086663,604.547911,58.64878425,631.5727721,Benign
192.168.43.224,51470,54.197.248.134,443,291,242881,116,16028,175,226853,347.0278822,125.5709658,1021.127768,14452.57658,Benign
172.30.15.2157,51469,34.234.132.222,443,6,348,4,228,2,120,4188.982059,8.604398,211.9846153,111.5708502,Benign
192.168.137.97,37070,104.17.38.113,443,27,8026,15,2016,12,6010,1767.49049,4.619943758,3490.951588,10407.0531,Benign
192.168.137.97,40108,172.217.161.14,443,45,7158,23,4325,22,2833,8015.847456,242.8822178,142.4558797,93.31271842,Benign
172.30.6.255,55659,35.190.43.164,80,23,6319,11,4529,12,1790,37.639297,20.972303,1727.611889,682.8053171,Benign
172.30.6.255,58328,157.240.16.17,443,6,348,4,228,2,120,5385.668545,3.358458,543.1063899,285.8454684,Benign
192.168.137.97,35144,104.198.143.177,80,10,911,5,425,5,486,6623.812577,1.584982285,2145.134386,2453.024262,Benign
192.168.43.224,43492,18.206.249.150,443,24,8568,12,2586,12,5982,738.9316969,2.301413493,8989.258151,20794.17721,Benign
192.168.43.233,51308,52.84.110.71,443,29,2557,15,1445,14,1112,3031.202534,255.886834,45.17622036,34.76536819,Benign
10.0.2.15,61000,119.254.87.201,80,11,1582,6,705,5,877,8116.436476,1.490963,3782.790049,4705.683508,Malicious
192.168.43.233,51243,157.240.16.20,443,42,13013,20,2362,22,10651,1593.383316,66.110724,285.8235224,1288.868051,Benign
192.168.137.97,57562,169.60.79.147,443,32,9362,18,4476,14,4886,6798.08496,3.714662887,9639.636513,10522.62377,Benign
172.30.1.136,50175,172.217.161.3,443,30,9472,15,2444,15,7028,346.748532,19.088676,1024.272192,2945.411196,Benign
172.30.1.136,50649,157.240.16.20,443,24,6140,12,1898,12,4242,1746.400864,28.077834,540.7824549,1208.640239,Benign
172.30.1.136,50765,74.125.68.188,5228,13,3235,8,2512,5,723,1911.346152,52.724471,381.1512874,109.7023809,Benign
172.30.1.136,50496,74.125.68.188,5228,18,1021,10,565,8,456,964.125238,62.56422,72.24576603,58.30808727,Benign
10.0.2.15,41573,119.254.87.201,80,11,1582,6,705,5,877,7187.976998,1.025991,5497.124244,6838.266612,Malicious
192.168.43.233,51250,151.101.153.170,443,13,1479,7,958,6,521,1931.071412,14.401366,532.1717398,289.41699,Benign
172.30.6.255,57252,151.101.65.69,443,541,416577,212,16158,329,400419,2252.12834,631.268206,204.7687477,5074.470676,Benign
172.30.15.1739,51050,54.201.247.66,443,25,4500,14,3442,11,1058,3632.589959,4.71414,5841.150242,1795.449435,Benign
172.30.6.255,56659,103.243.221.17,80,17,5869,9,4225,8,1644,1091.120064,31.030329,1089.256901,423.8433953,Benign
172.30.15.1975,51287,151.101.194.2,443,20,9062,11,1240,9,7822,4076.620192,0.628154,15792.30571,99618.88327,Benign
172.30.6.255,57697,172.217.166.202,443,38,6680,21,4144,17,2536,3671.450286,128.758478,257.4743078,157.5663235,Benign
172.30.15.365,49633,62.210.213.13,80,18,9471,8,798,10,8673,1402.328604,2.077181,3073.396108,33402.96296,Benign
10.0.2.15,36251,219.234.85.243,80,9,994,5,738,4,256,180.203043,1.801442,3277.374459,1136.867021,Malicious
192.168.43.224,45970,54.173.101.22,443,11,1531,7,1044,4,487,1003.044313,22.05441321,378.6997151,176.6539859,Benign
10.0.2.15,48802,119.254.87.201,80,11,1579,6,705,5,874,17281.39284,1.317723,4280.110463,5306.122759,Malicious
172.30.1.136,51544,172.217.161.14,443,16,888,9,498,7,390,713.178647,27.915647,142.7156605,111.7652763,Benign
172.30.6.255,56969,103.231.98.53,80,34,15245,20,13497,14,1748,1417.850954,22.30028,4841.912299,627.0773282,Benign
10.0.2.15,45340,119.254.87.201,80,11,1579,6,705,5,874,12741.02661,2.096275,2690.486697,3335.440245,Malicious
172.30.6.255,57761,103.243.220.231,80,41,27647,21,12632,20,15015,3910.874729,65.171472,1550.617117,1843.137746,Benign
172.30.15.360,49628,172.217.166.197,443,34,9175,17,3782,17,5393,1393.805083,6.582256,4596.600315,6554.591617,Benign
10.0.2.15,36383,119.254.87.201,80,11,1582,6,705,5,877,20344.86132,1.743649,3234.595954,4023.745605,Malicious
192.168.43.233,51148,74.125.158.121,443,24,8950,11,2619,13,6331,476.027616,5.440545,3851.084772,9309.36147,Benign
192.168.137.97,42562,104.16.103.29,443,18,1092,10,600,8,492,8288.56279,31.49510817,152.4046202,124.9717886,Benign
192.168.43.233,50932,52.84.108.164,80,16,1695,9,922,7,773,440.59223,126.058858,58.51234984,49.05644949,Benign
172.30.6.255,56009,54.183.78.192,443,25,8548,14,2043,11,6505,228.028891,76.577746,213.4301524,679.5707985,Benign
10.0.2.15,53246,119.254.87.201,80,11,1558,6,705,5,853,1569.70963,1.223095,4611.252601,5579.288608,Malicious
10.0.2.15,38745,119.254.87.201,80,11,1593,6,705,5,888,26291.34182,5.088085,1108.472048,1396.20309,Malicious
192.168.137.97,55690,52.84.100.149,443,264,200153,121,9828,143,190325,127.7458372,157.5524422,499.0338384,9664.08377,Benign
172.30.15.461,49735,23.9.250.106,443,252,202684,94,9981,158,192703,1652.976911,7.533132,10599.57532,204645.8233,Benign
192.168.215.49,59858,54.148.63.115,443,48,14642,27,5002,21,9640,513.9792127,311.8925353,128.3006019,247.2646546,Benign
172.30.6.255,56848,172.217.194.189,443,5,330,1,66,4,264,1352.422251,14.46971,36.4900195,145.960078,Benign
172.30.15.1935,51247,34.201.201.2,443,19,5522,11,1790,8,3732,3991.669727,5.531351,2588.879281,5397.596356,Benign
10.0.2.15,45761,119.254.87.201,80,11,1579,6,705,5,874,16345.07765,1.52023,3709.96494,4599.304053,Malicious
192.168.215.249,38950,178.79.238.165,443,3,275,0,0,3,275,1660.095413,2.43E-05,0,0,Benign
172.30.6.255,58179,103.243.221.51,80,16,5545,9,4317,7,1228,5023.86147,17.669224,1954.584989,555.9949888,Benign
172.30.6.255,56322,205.251.72.175,80,9,1005,5,705,4,300,590.942671,0.749181,7528.220817,3203.49822,Benign
192.168.43.233,50850,172.217.166.195,443,2,108,2,108,0,0,3.006908,5.90E-05,0,0,Benign
172.30.6.255,56533,23.198.119.247,443,25,9890,14,1692,11,8198,832.133408,41.453063,326.5379931,1582.126754,Benign
172.30.15.1886,51198,52.26.114.97,443,7,402,4,228,3,174,3967.776649,3.835538,475.5525822,362.9217075,Benign
192.168.137.97,57562,104.198.143.177,80,10,911,5,425,5,486,1362.832314,0.781187678,4352.347196,4977.037029,Benign
192.168.43.224,35094,34.232.42.95,443,29,10413,16,3225,13,7188,3244.621071,71.16613508,362.531982,808.024771,Benign
172.30.1.136,51528,52.84.110.12,443,119,68780,53,4634,66,64146,200.394822,183.214526,202.3420348,2800.913286,Benign
192.168.43.224,49568,151.139.237.11,443,37,9504,19,2114,18,7390,804.344061,182.8864196,92.47269446,323.2607436,Benign
192.168.43.224,41934,23.251.156.28,443,71,48094,34,4349,37,43745,944.760696,73.44625741,473.7069148,4764.844559,Benign
172.30.15.2276,51595,104.19.199.151,443,17,7057,9,1091,8,5966,4537.941557,9.566407,912.3592588,4989.124966,Benign
10.0.2.15,50723,219.234.85.243,80,8,940,4,684,4,256,182.006744,0.59523,9193.085026,3440.686793,Malicious
172.30.15.1075,50381,212.32.225.97,80,12,1396,7,925,5,471,3452.764616,1.317104,5618.387007,2860.821924,Benign
192.168.42.240,50946,172.217.24.68,443,42,9011,19,4199,23,4812,179.054204,242.034939,138.7898794,159.051417,Benign
10.0.2.15,37428,119.254.87.201,80,11,1551,6,705,5,846,10551.43139,0.924076,6103.394093,7324.072912,Malicious
192.168.43.224,45468,104.237.191.1,443,27,7499,15,2338,12,5161,110.372447,47.53009592,393.519088,868.6706644,Benign
172.30.15.2409,51743,14.139.45.128,80,309,261787,129,8065,180,253722,5344.465197,6.556426,9840.72725,309585.7408,Benign
192.168.43.233,51186,49.44.170.52,443,12,720,6,360,6,360,1076.335789,27.427216,105.005189,105.005189,Benign
192.168.43.224,51608,157.240.16.20,443,126,79598,61,5017,65,74581,730.3328363,68.62844599,584.8303779,8693.887665,Benign
10.0.2.15,51954,119.254.87.201,80,11,1579,6,705,5,874,3946.5639,1.708528,3301.087252,4092.411713,Malicious
10.0.2.15,43978,119.254.87.201,80,11,1582,6,705,5,877,4425.228003,1.759369,3205.694769,3987.793351,Malicious
172.30.6.255,58326,172.217.167.2,80,14,2843,8,1623,6,1220,5379.112466,10.146062,1279.708324,961.9495722,Benign
10.0.2.15,35275,119.254.87.201,80,11,1593,6,705,5,888,14275.22606,4.071281,1385.313369,1744.90535,Malicious
192.168.137.97,48500,172.217.161.8,443,7,478,4,272,3,206,121.2353431,11.97441067,181.720843,137.6268149,Benign
10.0.2.15,58197,119.254.87.201,80,11,1579,6,705,5,874,18479.79799,3.490039,1616.027787,2003.416008,Malicious
172.30.1.136,51769,52.84.110.227,443,897,530316,422,97909,475,432407,2965.858183,61.988564,12635.75004,55804.74489,Benign
192.168.137.97,35454,104.198.143.177,80,11,977,6,491,5,486,9624.812254,2.360365679,1664.148922,1647.202395,Benign
172.30.15.1569,50878,172.217.166.198,443,32,8728,15,3073,17,5655,3557.764189,9.25363,2656.68716,4888.892251,Benign
172.30.15.1418,50726,103.243.220.231,443,15,4203,9,2829,6,1374,3500.225739,6.94041,3260.902454,1583.768106,Benign
192.168.43.224,35156,35.171.73.174,443,91,23797,48,12176,43,11621,1252.11311,63.84386779,1525.722099,1456.177441,Benign
192.168.137.97,50276,104.244.42.8,443,32,8745,17,3178,15,5567,31.1056249,148.3078384,171.427217,300.29431,Benign
192.168.43.233,51298,23.9.140.60,80,22,10534,13,9436,9,1098,2831.241763,65.70882,1148.825987,133.680684,Benign
172.30.15.491,49769,172.217.166.195,443,30,10202,14,1779,16,8423,1834.347384,1.428019,9966.25395,47187.04723,Benign
172.30.1.136,50456,157.240.16.20,443,3,198,3,198,0,0,857.488028,9.001868,175.9634778,0,Benign
192.168.43.233,51180,151.101.153.170,443,9,534,5,294,4,240,1050.893968,26.36118,89.22210614,72.83437236,Benign
192.168.137.97,43424,209.132.180.180,443,821,753665,297,20215,524,733450,3470.771247,7.3739894,21931.14083,795715.817,Benign
172.30.6.255,57079,161.69.226.28,443,19,5264,10,2321,9,2943,1683.687341,159.061724,116.7345577,148.0180109,Benign
172.30.15.1059,50365,52.220.73.112,80,12,1910,7,958,5,952,3449.342848,7.876307,973.0448547,966.950628,Benign
172.30.6.255,55660,35.190.43.164,80,23,6237,11,4447,12,1790,37.639334,20.975518,1696.072536,682.7006608,Benign
10.0.2.15,53182,119.254.87.201,80,3,222,3,222,0,0,9830.800108,9.087798,195.426879,0,Malicious
172.30.15.1942,51254,52.204.146.6,443,6,348,4,228,2,120,4027.380124,10.087504,180.8177722,95.16724851,Benign
192.168.43.233,50969,49.44.170.2,443,145,111594,57,6056,88,105538,489.890122,328.828906,147.3349791,2567.608822,Benign
192.168.43.233,51692,111.221.29.253,443,27,7572,14,2547,13,5025,1365.93644,1.735848,11738.35497,23158.70975,Benign
192.168.43.224,36186,52.20.114.147,443,31,7171,16,2207,15,4964,55.89028807,61.57365876,286.7459942,644.9511171,Benign
172.30.15.1057,50363,104.121.243.213,80,10,2019,5,864,5,1155,3448.984476,0.592767,11660.56815,15587.91228,Benign
192.168.43.233,50714,172.217.166.206,443,22,7148,11,1663,11,5485,1843.413401,11.574211,1149.452002,3791.187149,Benign
192.168.43.224,48134,104.244.42.200,443,10,692,6,412,4,280,303.7891692,43.19738668,76.30091201,51.85498874,Benign
10.0.2.15,42774,119.254.87.201,80,11,1582,6,705,5,877,2923.713674,1.72418,3271.120185,4069.180712,Malicious
172.30.6.255,55351,157.240.16.16,443,928,68290,477,37465,451,30825,26.281069,4731.20153,63.34965824,52.12206634,Benign
172.30.15.1843,51155,34.234.132.222,443,84,32290,46,17670,38,14620,3869.67324,7.674258,18420.02184,15240.56137,Benign
10.0.2.15,44339,119.254.87.201,80,11,1568,6,705,5,863,8569.484847,2.470059,2283.346268,2795.074935,Malicious
10.0.2.15,56245,119.254.87.201,80,13,1727,8,853,5,874,24459.30954,9.86134,691.9952055,709.0314298,Malicious
172.30.6.255,57689,157.240.16.39,443,29,5612,15,3411,14,2201,3656.088364,61.033649,447.097633,288.4965964,Benign
172.30.6.255,58234,172.217.166.197,443,34,6954,18,4018,16,2936,5211.879056,47.141001,681.8692713,498.2499205,Benign
10.0.2.15,56254,115.182.31.2,80,8,719,4,463,4,256,54.168283,0.594311,6232.42713,3446.007225,Malicious
172.30.1.136,50545,172.217.194.188,5228,23,2519,12,1447,11,1072,1406.116222,167.471728,69.12211475,51.20864341,Benign
192.168.43.224,59344,140.98.193.112,443,26,11765,14,4256,12,7509,51.74647314,5.970608112,5702.601705,10061.2867,Benign
192.168.137.97,46436,74.50.21.249,80,10,1591,5,693,5,898,568.8704477,1.814729268,3055.00115,3958.717218,Benign
172.30.15.1727,51038,184.29.25.7,443,12,1423,6,904,6,519,3620.235033,6.801259,1063.332539,610.4752076,Benign
192.168.137.97,37094,140.98.193.112,443,9,888,4,276,5,612,1.744531018,3.247642305,679.8778291,1507.555186,Benign
192.168.43.224,43240,185.199.109.153,80,6,412,4,272,2,140,3058.385764,10.7815618,201.8260471,103.8810536,Benign
172.30.6.255,57248,103.243.220.231,80,33,22514,16,8594,17,13920,2225.858541,26.368814,2607.322423,4223.170598,Benign
172.30.6.255,57781,103.243.221.51,80,16,5815,9,4234,7,1581,3981.843925,13.206759,2564.747339,957.6914366,Benign
192.168.43.233,51246,172.217.160.229,443,40,9507,23,6324,17,3183,1949.966753,249.871173,202.4723356,101.9085143,Benign
172.30.6.255,56465,103.243.220.231,80,63,42568,36,37043,27,5525,762.846888,55.206953,5367.874586,800.623791,Benign
10.0.2.15,40230,119.254.87.201,80,11,1579,6,705,5,874,17005.923,1.655124,3407.599672,4224.456899,Malicious
10.0.2.15,38511,119.254.87.201,80,11,1582,6,705,5,877,2981.453015,1.829205,3083.306682,3835.546043,Malicious
192.168.43.224,49798,52.207.90.113,443,1,66,1,66,0,0,9.425445791,0,0,0,Benign
172.30.1.136,50590,52.30.87.88,443,20,7493,11,1285,9,6208,1597.243964,13.817873,743.963995,3594.185588,Benign
192.168.42.240,51012,172.217.161.14,443,9,534,5,294,4,240,395.40611,21.958086,107.113161,87.43931507,Benign
192.168.137.97,56166,172.217.161.14,443,20,6927,11,1521,9,5406,342.0285411,13.68253361,889.3089791,3160.818107,Benign
172.30.1.136,51904,52.84.110.71,443,781,307380,358,135979,423,171401,5129.745556,649.609311,1674.594224,2110.819498,Benign
10.0.2.15,38888,119.254.87.201,80,11,1579,6,705,5,874,9290.268055,1.814357,3108.539279,3853.70685,Malicious
172.30.6.255,57795,103.243.221.46,80,21,15122,11,5824,10,9298,4041.914233,23.152383,2012.406239,3212.801032,Benign
192.168.42.240,50999,216.58.221.46,443,41,11838,21,4343,20,7495,337.033483,41.857134,830.0616091,1432.491771,Benign
172.30.6.255,56299,95.142.20.29,80,10,1236,6,780,4,456,569.021769,20.005451,311.9149876,182.3503004,Benign
10.0.2.15,48715,119.254.87.201,80,11,1579,6,705,5,874,6374.678256,2.355106,2394.796667,2968.868493,Malicious
192.168.137.97,60256,172.217.161.4,443,50,7014,25,3036,25,3978,5227.497279,240.888666,100.8266616,132.1108234,Benign
192.168.43.224,42044,23.251.156.28,443,249,176357,122,13408,127,162949,1490.465065,268.1184669,400.0619623,4862.000052,Benign
172.30.15.929,50235,50.23.131.235,443,6,348,4,228,2,120,3440.898657,6.365244,286.5561792,150.8190417,Benign
192.168.43.224,59518,49.44.150.71,443,78,22625,42,13924,36,8701,53.61358189,464.0065083,240.0655982,150.0151372,Benign
172.30.1.136,50787,157.240.16.16,443,19,1050,12,660,7,390,1925.391378,29.433503,179.3874144,106.001654,Benign
172.30.6.255,58476,35.190.41.40,443,85,19387,39,6675,46,12712,5681.09952,17.958307,2973.554244,5662.894615,Benign
172.30.6.255,58333,172.217.167.2,80,9,1555,6,939,3,616,5419.166361,9.849805,762.6546921,500.3144732,Benign
172.30.1.136,50469,157.240.16.16,443,35,8256,21,5500,14,2756,880.150198,43.738949,1005.968388,504.0816138,Benign
172.30.6.255,57924,103.243.221.46,80,78,57434,47,49304,31,8130,4488.837212,38.227569,10317.99851,1701.389905,Benign
172.30.6.255,57965,157.240.16.39,443,29,5622,16,3477,13,2145,4632.090578,61.053511,455.6003339,281.064917,Benign
192.168.43.233,50721,172.217.166.202,443,9,534,5,294,4,240,1844.438595,12.860585,182.8843711,149.2933642,Benign
192.168.137.97,55856,52.84.108.195,443,11,762,7,470,4,292,19.48173143,16.4047595,229.2017753,142.3976987,Benign
172.30.15.2142,51454,205.185.216.10,443,21,6415,10,1195,11,5220,4178.63728,8.992297,1063.132145,4643.974726,Benign
172.30.6.255,56236,103.243.221.75,80,35,19697,21,15711,14,3986,500.850502,21.540314,5835.012433,1480.386962,Benign
192.168.43.233,51228,23.213.64.243,443,45,8603,22,1923,23,6680,1305.501577,502.238945,30.63083847,106.4035367,Benign
172.30.6.255,57895,103.243.221.75,80,17,5590,9,4309,8,1281,4368.840157,37.220043,926.1676565,275.3355229,Benign
192.168.137.97,42526,54.172.89.157,443,24,8183,13,2283,11,5900,348.9614525,1.832971523,9964.148254,25750.53644,Benign
10.0.2.15,39173,219.234.85.216,80,8,940,4,684,4,256,61.343034,64.308922,85.08928201,31.84628099,Malicious
192.168.43.224,33728,34.207.29.244,443,102,64393,60,52335,42,12058,304.7252105,167.8735601,2494.019903,574.6229482,Benign
192.168.137.97,33312,172.217.161.5,443,9,618,5,338,4,280,334.793045,14.22574077,190.0779751,157.4610445,Benign
192.168.137.97,57760,104.197.3.80,80,11,977,6,491,5,486,9923.813046,1.470881882,2670.506754,2643.312184,Benign
172.30.15.1547,50856,162.125.34.137,443,24,9166,13,4716,11,4450,3545.852607,1093.574277,34.49971419,32.55380156,Benign
172.30.15.340,49608,104.25.219.21,443,18,6497,10,1157,8,5340,990.309579,9.831183,941.4940196,4345.357013,Benign
172.30.15.1116,50424,104.18.255.119,80,6,348,4,228,2,120,3458.275271,8.925845,204.3504004,107.5528423,Benign
10.0.2.15,54783,119.254.87.201,80,11,1579,6,705,5,874,5476.283012,1.778637,3170.967432,3931.10005,Malicious
172.30.6.255,57579,157.240.16.39,443,28,5557,15,3411,13,2146,3290.100274,61.065031,446.8678645,281.1429016,Benign
172.30.1.136,50241,104.17.162.9,443,7,426,4,240,3,186,433.874661,17.934748,107.054752,82.96743283,Benign
172.30.6.255,55876,54.207.34.156,443,21,5576,10,2093,11,3483,108.267821,1.735121,9650.047461,16058.82241,Benign
192.168.137.97,40936,119.81.21.130,443,50,17228,27,3501,23,13727,30.58026429,50.24191492,557.4628285,2185.744715,Benign
192.168.43.233,51242,157.240.16.16,443,20,5233,9,1081,11,4152,1593.010864,110.437435,78.30678067,300.7675794,Benign
10.0.2.15,49642,119.254.87.201,80,11,1579,6,705,5,874,17251.33504,1.171697,4813.531143,5967.413077,Malicious
10.0.2.15,44333,119.254.87.201,80,11,1579,6,705,5,874,9497.740497,1.489733,3785.913315,4693.458492,Malicious
172.30.6.255,56744,184.29.25.174,443,28,18259,12,1527,16,16732,1242.655419,4.125115,2961.371986,32449.03475,Benign
192.168.43.224,35056,34.232.42.95,443,17,1874,10,1220,7,654,3042.773568,15.91677451,613.1895625,328.7098147,Benign
172.30.6.255,56455,103.243.221.75,80,16,5482,9,4254,7,1228,708.851955,38.217997,890.4705288,257.0516712,Benign
172.30.6.255,57373,157.240.16.39,443,19,1933,10,1125,9,808,2619.091994,61.046751,147.4279933,105.886061,Benign
10.0.2.15,43158,119.254.87.201,80,11,1579,6,705,5,874,14485.42478,1.353292,4167.614971,5166.660263,Malicious
172.30.6.255,56795,35.190.43.164,80,104,30141,54,22587,50,7554,1254.089788,667.760158,270.6001516,90.49955927,Benign
172.30.15.267,49530,172.217.166.197,443,37,9548,19,3953,18,5595,111.943984,2.628266,12032.26766,17030.23971,Benign
192.168.43.224,42050,157.240.16.20,443,137,86642,70,5702,67,80940,934.3030997,81.07667236,562.6279258,7986.514261,Benign
172.30.6.255,55909,13.250.69.79,80,13,2491,7,1303,6,1188,121.805939,61.115603,170.5620085,155.5085696,Benign
192.168.43.233,51254,52.84.108.242,443,36,11954,18,3784,18,8170,2295.288619,217.351965,139.2764036,300.7104169,Benign
10.0.2.15,38667,119.254.87.201,80,11,1579,6,705,5,874,11512.44664,1.702916,3311.966063,4105.898353,Malicious
172.30.6.255,56690,103.243.220.231,80,15,5837,9,4309,6,1528,1155.904776,13.714889,2513.472767,891.2941257,Benign
192.168.43.233,51458,49.44.178.216,80,7,402,4,228,3,174,3812.556174,16.622452,109.7311034,83.7421579,Benign
10.0.2.15,50165,119.254.87.201,80,11,1582,6,705,5,877,19921.42164,2.055605,2743.717786,3413.10709,Malicious
172.30.15.2476,51810,14.139.45.128,80,41,31805,16,1247,25,30558,5424.24044,0.614419,16236.47706,397878.3208,Benign
192.168.43.233,50913,151.139.105.8,80,7,402,4,228,3,174,371.986204,26.578922,68.62580807,52.37232721,Benign
172.30.15.795,50087,34.200.202.18,443,27,10862,14,3871,13,6991,2677.500042,10.394924,2979.14636,5380.318317,Benign
172.30.15.850,50153,34.195.182.87,443,100,79990,61,73818,39,6172,3336.084574,88.040885,6707.610901,560.830346,Benign
172.30.15.2088,51400,35.171.73.174,443,18,2492,10,1560,8,932,4129.968009,7.579487,1646.54943,983.7077364,Benign
192.168.43.233,51367,52.216.18.144,443,7,409,4,228,3,181,3465.080095,12.301432,148.2754203,117.7098731,Benign
172.30.15.1736,51047,13.66.56.243,443,25,12316,15,7165,10,5151,3628.966506,2.402528,23858.20269,17151.9333,Benign
172.30.15.333,49601,192.0.73.2,443,43,15296,23,2608,20,12688,958.438075,1.72587,12088.97542,58813.23622,Benign
192.168.137.97,40938,119.81.21.130,443,8,552,5,346,3,206,30.83508606,21.97773684,125.945634,74.98497282,Benign
172.30.6.255,57958,103.243.221.75,80,49,36217,31,31202,18,5015,4629.841009,17.190465,14520.60779,2333.851935,Benign
10.0.2.15,51785,119.254.87.201,80,11,1582,6,705,5,877,19294.52672,2.02603,2783.769243,3462.929966,Malicious
172.30.6.255,55842,210.176.156.41,80,223,122802,88,45504,135,77298,101.909957,223.059821,1631.992702,2772.278742,Benign
172.30.15.2328,51661,52.55.184.84,443,12,1416,6,904,6,512,5081.447177,6.786722,1065.610172,603.531425,Benign
192.168.215.49,42126,52.205.114.175,443,16,3000,10,2011,6,989,620.0191338,10.5903797,1519.114561,747.0931381,Benign
172.30.6.255,57370,52.213.19.114,443,14,1537,7,959,7,578,2599.538502,50.090667,153.1622647,92.31260586,Benign
192.168.43.224,50184,49.44.90.17,443,35,11763,16,2703,19,9060,37.94648722,6.263197922,3452.549364,11572.36302,Benign
172.30.1.136,50228,74.125.68.188,5228,3,198,3,198,0,0,385.838386,9.000414,175.9919044,0,Benign
172.30.6.255,56576,180.149.59.210,80,85,56383,55,41848,30,14535,888.14807,261.932177,1278.132392,443.9317129,Benign
10.0.2.15,40625,119.254.87.201,80,11,1560,6,705,5,855,22477.32229,0.981683,5745.235478,6967.626006,Malicious
192.168.137.97,34512,172.217.161.19,443,21,5256,11,1308,10,3948,346.6313609,0.712796671,14680.20324,44309.97125,Benign
172.30.15.2087,51399,52.229.168.53,443,29,10122,16,2272,13,7850,4127.908271,82.440898,220.4730958,761.7578353,Benign
172.30.6.255,56805,172.217.166.197,443,17,1779,10,1150,7,629,1266.453487,86.042661,106.9237038,58.48261713,Benign
192.168.43.224,50054,34.227.238.173,443,32,7881,16,2786,16,5095,370.8502333,63.70670609,349.8532787,639.8070549,Benign
172.30.6.255,56030,157.240.16.39,443,27,5478,15,3422,12,2056,240.100349,61.029443,448.5703728,269.5092597,Benign
192.168.137.97,41244,184.29.25.22,443,15,5722,9,1245,6,4477,128.4148885,10.91713026,912.327669,3280.715642,Benign
192.168.137.97,55884,172.217.161.14,443,15,1054,8,552,7,502,32.45099271,20.37574657,216.7282551,197.0970725,Benign
192.168.43.233,51267,52.84.108.85,443,200,172351,73,5025,127,167326,2310.606059,212.429831,189.2389586,6301.412536,Benign
172.30.1.136,50531,13.107.4.52,80,10,1519,5,436,5,1083,1124.330271,0.207067,16844.78937,41841.52955,Benign
10.0.2.15,47836,119.254.87.201,80,11,1579,6,705,5,874,20527.01784,4.747393,1188.020457,1472.808339,Malicious
192.168.43.224,39436,103.102.166.240,443,67,17979,35,3788,32,14191,730.109992,225.3907838,134.4509278,503.6940645,Benign
10.0.2.15,53477,119.254.87.201,80,11,1513,6,705,5,808,8536.722841,1.429261,3946.09522,4522.616933,Malicious
192.168.43.233,50858,172.217.166.196,443,2,108,1,54,1,54,3.007688,0.12382,3488.935552,3488.935552,Benign
172.30.1.136,50238,104.17.161.9,443,17,954,11,618,6,336,433.621602,41.183183,120.0490016,65.26936007,Benign
192.168.43.233,51026,52.114.75.78,443,25,9572,12,4305,13,5267,803.790098,8.358819,4120.199277,5040.903506,Benign
192.168.43.233,50891,49.44.169.252,443,21,2901,11,1726,10,1175,125.551524,107.513018,128.4309589,87.43127274,Benign
172.30.15.270,49533,52.114.74.45,443,21,8500,13,3860,8,4640,125.047998,1.576646,19585.88041,23543.64899,Benign
10.0.2.15,36613,119.254.87.201,80,11,1582,6,705,5,877,2200.516985,1.95729,2881.535184,3584.548023,Malicious
10.0.2.15,36896,119.254.87.201,80,12,1653,7,779,5,874,1932.502456,3.908649,1594.412801,1788.853386,Malicious
192.168.137.97,35752,140.234.252.142,80,50,17903,26,2280,24,15623,8277.145781,15.74436983,1158.509372,7938.329789,Benign
10.0.2.15,54155,119.254.87.201,80,11,1579,6,705,5,874,24874.28835,2.02886,2779.886242,3446.270319,Malicious
192.168.137.97,55276,13.228.141.18,443,10,700,7,486,3,214,72.97638071,15.98136376,243.2833679,107.1247752,Benign
172.30.6.255,55983,157.240.16.39,443,18,1879,9,1071,9,808,179.108748,61.015204,140.4240163,105.9408078,Benign
172.30.6.255,57902,103.243.221.75,80,27,17130,11,4616,16,12514,4405.846284,12.216094,3022.897499,8195.090837,Benign
10.0.2.15,53372,119.254.87.201,80,11,1582,6,705,5,877,22771.98857,1.121285,5029.943324,6257.106802,Malicious
172.30.1.136,50536,157.240.16.39,443,94,18162,47,10909,47,7253,1151.101027,252.234959,345.9948627,230.0394847,Benign
172.30.1.136,50633,157.240.16.17,443,12,696,6,348,6,348,1724.736299,21.045535,132.2845915,132.2845915,Benign
172.30.15.1428,50736,74.217.250.126,443,6,348,4,228,2,120,3500.664206,6.542324,278.8000105,146.7368476,Benign
172.30.6.255,55764,195.201.82.80,80,84,90712,19,3137,65,87575,62.195231,1.733119,14480.25208,404242.2938,Benign
172.30.15.2041,51353,64.74.232.52,443,20,7146,11,2275,9,4871,4090.890069,6.704645,2714.535967,5812.089976,Benign
10.0.2.15,32913,119.254.87.201,80,11,1582,6,705,5,877,2891.368472,1.884665,2992.574277,3722.677505,Malicious
172.30.1.136,51484,172.217.161.3,443,16,979,7,382,9,597,31.336793,150.780079,20.26792943,31.6752719,Benign
172.30.6.255,57002,54.194.27.245,443,18,6378,9,1141,9,5237,1485.001959,13.648975,668.7681676,3069.534525,Benign
172.30.15.2486,51820,14.139.45.128,80,162,153568,54,3336,108,150232,5432.328986,2.017228,13230.03647,595795.8149,Benign
10.0.2.15,48984,119.254.87.201,80,11,1582,6,705,5,877,17221.38541,2.194593,2569.952606,3196.948136,Malicious
192.168.137.97,46540,172.217.161.14,443,22,6230,12,1583,10,4647,314.290226,20.00151542,633.1520254,1858.659167,Benign
10.0.2.15,40068,119.254.87.201,80,13,1727,8,853,5,874,10791.6378,9.782406,697.5788983,714.7525875,Malicious
192.168.215.49,36826,169.60.79.3,443,9,604,5,338,4,266,689.3830128,122.332543,22.10368503,17.39520774,Benign
172.30.15.2400,51734,14.139.45.128,80,35,27479,13,1064,22,26415,5343.481855,0.092863,91661.91056,2275610.308,Benign
10.0.2.15,50863,119.254.87.201,80,11,1534,6,705,5,829,19383.84796,4.537934,1242.856331,1461.458012,Malicious
172.30.6.255,57271,103.243.221.87,80,39,24162,23,20059,16,4103,2285.844517,13.194226,12162.28978,2487.754871,Benign
10.0.2.15,48808,119.254.87.201,80,11,1579,6,705,5,874,13614.49975,1.386269,4068.474445,5043.754134,Malicious
172.30.15.475,49750,162.247.242.19,443,23,6229,11,2439,12,3790,1729.213252,6.601441,2955.718305,4592.936603,Benign
10.0.2.15,57925,119.254.87.201,80,11,1513,6,705,5,808,8811.77831,1.821237,3096.796298,3549.236041,Malicious
192.168.43.233,51496,35.177.33.121,443,9,503,5,283,4,220,3828.575207,62.841964,36.02688166,28.00676312,Benign
172.30.6.255,57615,52.229.174.29,443,29,10110,16,2260,13,7850,3408.575135,107.875619,167.6004288,582.1519318,Benign
10.0.2.15,44280,119.254.87.201,80,11,1579,6,705,5,874,10248.60903,1.02947,5478.547214,6791.844347,Malicious
192.168.43.233,51501,172.217.161.5,443,10,590,6,350,4,240,3892.600144,103.556479,27.0383855,18.5406072,Benign
192.168.43.224,51876,54.197.248.134,443,16,1855,9,1197,7,658,2411.980641,11.70262284,818.2781017,449.8136933,Benign
192.168.137.97,51408,157.240.16.17,443,95,40489,50,5139,45,35350,134.5667177,66.53378728,617.9116157,4250.472001,Benign
10.0.2.15,37012,119.254.87.201,80,11,1582,6,705,5,877,25300.13092,1.085141,5197.481249,6465.519227,Malicious
192.168.43.224,60172,151.101.153.2,443,1806,1431469,759,58949,1047,1372520,912.8369337,857.4802406,549.9741891,12805.14638,Benign
10.0.2.15,55102,119.254.87.201,80,11,1559,6,705,5,854,3702.188145,1.775677,3176.253339,3847.546598,Malicious
10.0.2.15,51161,119.254.87.201,80,12,1587,7,779,5,808,7876.144655,3.886305,1603.57975,1663.276557,Malicious
172.30.6.255,58273,35.190.43.164,80,6,348,4,228,2,120,5287.876605,27.847083,65.50057685,34.47398781,Benign
10.0.2.15,54703,119.254.87.201,80,11,1579,6,705,5,874,25119.9455,1.187414,4749.817671,5888.426446,Malicious
172.30.6.255,58059,35.230.55.83,443,28,8996,15,2632,13,6364,4820.905426,51.836249,406.2022312,982.1698325,Benign
172.30.6.255,56968,103.243.220.231,80,16,5527,9,4299,7,1228,1417.849529,18.379498,1871.215416,534.5086139,Benign
192.168.137.97,36364,172.217.161.8,443,42,7509,23,3028,19,4481,9504.262124,71.63453807,338.1609019,500.4289965,Benign
172.30.15.690,49977,23.56.25.39,443,22,8388,11,1679,11,6709,2401.83559,4.489428,2991.917901,11955.19786,Benign
172.30.6.255,55881,52.89.235.78,80,6,348,4,228,2,120,109.070591,12.069692,151.1223319,79.53806941,Benign
172.30.6.255,55904,52.69.18.116,80,6,348,4,228,2,120,121.805396,30.19328,60.4107934,31.79515442,Benign
192.168.137.97,35486,104.198.143.177,80,10,911,5,425,5,486,11423.81638,1.692333178,2009.060653,2297.419947,Benign
192.168.137.97,46812,151.101.193.170,443,32,2177,16,1032,16,1145,7.040020746,554.2629887,14.89545607,16.52645078,Benign
172.30.15.1779,51091,161.202.1.35,443,19,5903,11,4186,8,1717,3641.863774,5.312952,6303.087248,2585.38003,Benign
172.30.6.255,55694,103.231.98.53,80,19,6578,10,5844,9,734,53.102912,5.556256,8414.299125,1056.826755,Benign
172.30.1.136,51556,172.217.161.14,443,2,132,2,132,0,0,736.356862,3.000441,351.9482636,0,Benign
172.30.6.255,58084,210.176.156.41,80,13,747,12,685,1,62,4857.440444,66.837565,81.98982114,7.420976512,Benign
10.0.2.15,35297,119.254.87.201,80,11,1582,6,705,5,877,7758.636769,2.193418,2571.329313,3198.66072,Malicious
192.168.137.97,50680,192.168.121.7,443,17,2932,9,1758,8,1174,3055.537058,23.31325777,603.2618924,402.8608997,Benign
192.168.43.233,50917,65.222.231.19,80,249,229469,87,5123,162,224346,398.081907,33.666608,1217.348656,53310.03349,Benign
10.0.2.15,35061,219.234.85.243,80,8,944,4,688,4,256,61.048489,58.057214,94.80303344,35.27554732,Malicious
10.0.2.15,44362,119.254.87.201,80,12,1656,7,779,5,877,3556.21064,315.630055,19.74463427,22.22855488,Malicious
172.30.6.255,58400,35.190.43.164,80,10,1573,6,1119,4,454,5550.837111,8.208181,1090.619225,442.4853692,Benign
192.168.43.224,34398,52.84.108.195,443,8,552,5,338,3,214,1465.232,27.90969953,96.88388072,61.34068187,Benign
172.30.15.2197,51509,52.84.108.186,443,6,348,4,228,2,120,4287.129241,0.511187,3568.165857,1877.98203,Benign
192.168.43.224,51394,18.210.21.97,443,31,6681,16,2086,15,4595,1473.327323,62.3967697,267.4497427,589.1330621,Benign
192.168.43.233,50893,54.239.25.120,443,110,88604,75,78130,35,10474,144.978395,8.365606,74715.44799,10016.24987,Benign
192.168.215.49,43452,54.85.227.48,443,31,7799,15,2645,16,5154,553.5201078,60.95589727,347.1362239,676.4234774,Benign
192.168.43.224,58782,104.197.3.80,80,10,911,5,425,5,486,1221.422759,1.023413482,3322.21537,3799.050988,Benign
172.30.1.136,50617,52.94.220.15,443,6,384,3,198,3,186,1618.617092,34.35165,46.11132216,43.31669658,Benign
172.30.15.1173,50481,67.202.94.86,80,6,535,4,228,2,307,3461.778226,5.888479,309.7574093,417.0856345,Benign
172.30.15.1132,50440,184.29.26.86,443,13,1477,6,904,7,573,3458.302715,8.967451,806.4722071,511.1820516,Benign
10.0.2.15,45617,119.254.87.201,80,11,1582,6,705,5,877,14332.98152,1.157967,4870.605121,6058.894597,Malicious
172.30.1.136,50667,157.240.16.39,443,44,17630,26,13789,18,3841,1798.136014,121.009015,911.6015034,253.9314943,Benign
172.30.15.2077,51389,52.7.89.176,443,6,348,4,228,2,120,4122.682342,4.916749,370.9768386,195.2509677,Benign
10.0.2.15,60575,119.254.87.201,80,11,1579,6,705,5,874,17246.17944,1.155085,4882.757546,6053.234178,Malicious
172.30.6.255,58439,103.243.221.51,80,16,5545,9,4317,7,1228,5616.848758,2.377664,14525.18102,4131.786493,Benign
192.168.42.240,50998,216.58.221.46,443,42,11916,22,4409,20,7507,336.354383,42.536087,829.2253117,1411.883514,Benign
192.168.43.233,51312,117.18.232.102,443,9,524,5,284,4,240,2591.717264,106.634082,21.30650874,18.00550034,Benign
192.168.137.97,50818,172.217.161.3,80,21,1795,11,1056,10,739,337.5996341,285.4791656,29.59235215,20.70904189,Benign
172.30.6.255,56033,172.217.166.206,443,17,1779,10,1150,7,629,250.410195,116.042894,79.28102862,43.36327565,Benign
192.168.43.224,37416,34.201.177.231,443,6,412,4,272,2,140,55.67917289,16.67768277,130.4737613,67.15561241,Benign
192.168.215.49,42794,35.237.145.81,443,7,478,4,272,3,206,787.4251564,38.44007523,56.60758952,42.87192442,Benign
10.0.2.15,54382,119.254.87.201,80,11,1579,6,705,5,874,16257.23086,1.163921,4845.689699,6007.280563,Malicious
172.30.15.484,49759,172.217.166.196,443,22,5567,11,1374,11,4193,1732.173058,0.5568,19741.37931,60244.25287,Benign
172.30.6.255,55849,172.217.166.193,80,47,26801,20,2099,27,24702,103.204425,242.67022,69.19678896,814.3397241,Benign
10.0.2.15,34745,119.254.87.201,80,11,1513,6,705,5,808,24038.75059,2.21248,2549.175586,2921.608331,Malicious
172.30.15.1128,50436,157.240.16.63,80,9,510,5,282,4,228,3458.298726,9.379619,240.5214967,194.4641888,Benign
172.30.15.2447,51781,14.139.45.128,80,10,1392,5,663,5,729,5420.423932,0.212793,24925.63195,27406.91658,Benign
10.0.2.15,38794,119.254.87.201,80,11,1582,6,705,5,877,9740.736055,1.88278,2995.57038,3726.404572,Malicious
172.30.15.2112,51424,157.240.16.39,443,12,1688,7,971,5,717,4178.00307,9.351637,830.6567075,613.3685471,Benign
192.168.137.97,47698,157.240.16.39,443,27,5194,14,2498,13,2696,769.4665388,65.51340733,305.036798,329.215055,Benign
192.168.137.97,35066,104.17.107.77,443,24240,22372959,8929,501763,15311,21871196,1719.918052,186.4435214,21529.86583,938458.8249,Benign
192.168.215.49,52212,52.84.110.101,443,174,138459,65,6213,109,132246,551.0549119,184.7493691,269.0347482,5726.503993,Benign
172.30.15.367,49635,62.210.213.13,80,6,348,4,228,2,120,1402.484849,8.006096,227.8263963,119.9086296,Benign
172.30.6.255,58286,151.101.1.69,443,76,49717,28,3452,48,46265,5320.813231,3.169239,8713.763777,116785.1336,Benign
192.168.137.97,39686,192.168.125.6,80,15,5050,8,1113,7,3937,8274.174049,4.744904846,1876.539212,6637.857032,Benign
172.30.1.136,51900,13.107.4.52,80,10,1519,5,436,5,1083,4744.122767,0.219788,15869.83821,39419.80454,Benign
172.30.6.255,58003,52.229.175.79,443,30,10146,17,2297,13,7849,4737.772653,98.674072,186.229266,636.3576442,Benign
172.30.15.1688,50999,184.29.25.7,443,174,141511,73,33067,101,108444,3608.83206,8.297216,31882.50131,104559.4088,Benign
172.30.6.255,58282,157.240.16.39,443,4,264,1,66,3,198,5303.100166,15.066847,35.04382835,105.131485,Benign
192.168.137.97,52234,172.217.161.3,443,7,466,4,272,3,194,9008.988578,56.08410765,38.79886996,27.67272343,Benign
10.0.2.15,43607,119.254.87.201,80,11,1582,6,705,5,877,15899.61223,1.554337,3628.556742,4513.821649,Malicious
192.168.43.233,51473,31.13.79.26,443,20,5232,10,1134,10,4098,3816.132724,74.956231,121.0306319,437.3752464,Benign
192.168.137.97,45406,78.46.27.186,443,10,696,6,404,4,292,77.79212623,20.23407928,159.7305197,115.4487915,Benign
172.30.15.1133,50441,67.202.94.86,80,10,1903,6,1112,4,791,3458.303509,3.371185,2638.834712,1877.084764,Benign
172.30.15.2254,51571,104.121.244.70,443,96,81021,37,6668,59,74353,4486.371457,1.206104,44228.35842,493178.0344,Benign
192.168.43.233,51359,172.217.160.238,443,19,5812,9,1285,10,4527,3436.291949,28.590513,359.5598302,1266.713892,Benign
192.168.43.224,41518,172.217.166.193,443,17,5893,9,1212,8,4681,29.04048074,11.53593354,840.5041486,3246.204554,Benign
192.168.43.224,58834,174.129.238.218,443,6,412,4,272,2,140,3245.092962,19.59744861,111.0348619,57.15029657,Benign
172.30.1.136,50320,104.244.46.103,443,809,633650,349,22983,460,610667,568.128394,257.518436,713.983833,18970.8204,Benign
10.0.2.15,39761,119.254.87.201,80,11,1579,6,705,5,874,17428.51515,1.216773,4635.211334,5746.3471,Malicious
172.30.6.255,57111,115.114.126.194,443,18,6903,10,1163,8,5740,1814.050996,48.535676,191.6940438,946.1081782,Benign
192.168.137.97,57546,104.197.3.80,80,10,911,5,425,5,486,7523.813644,2.306004739,1474.411541,1686.032962,Benign
192.168.43.233,50933,52.84.108.164,80,9,534,5,294,4,240,440.844663,13.329745,176.4474864,144.0387644,Benign
10.0.2.15,40255,119.254.87.201,80,11,1579,6,705,5,874,11121.97238,1.71022,3297.821333,4088.362901,Malicious
172.30.6.255,56063,103.243.221.46,80,24,13830,14,11673,10,2157,286.033446,18.082193,5164.417834,954.3090266,Benign
172.30.6.255,56363,139.162.146.37,80,7,402,4,228,3,174,607.82858,24.215033,75.32510899,57.4849516,Benign
192.168.43.233,50898,50.16.219.101,443,32,8435,17,2136,15,6299,216.655343,175.716746,97.24741887,286.7797245,Benign
192.168.137.97,46490,172.217.161.14,443,11,766,7,478,4,288,210.0985284,15.18985928,251.7469009,151.6801412,Benign
192.168.43.233,51270,172.217.161.5,443,1663,1218859,801,61507,862,1157352,2564.443292,610.638099,805.8062555,15162.52591,Benign
172.30.6.255,56128,103.243.221.87,80,14,4069,8,2896,6,1173,345.848861,23.177219,999.6022387,404.8803267,Benign
192.168.43.233,50980,49.44.170.2,443,907,716867,367,67246,540,649621,502.15515,658.743479,816.6577995,7889.21358,Benign
10.0.2.15,34416,119.254.87.201,80,11,1579,6,705,5,874,5714.064778,1.676442,3364.267896,4170.737789,Malicious
172.30.6.255,57432,103.243.221.17,80,6,348,4,228,2,120,2797.017162,33.057399,55.17675483,29.04039728,Benign
172.30.6.255,57149,157.240.16.39,443,31,6109,17,3525,14,2584,1887.10257,61.00531,462.2548431,338.8557488,Benign
172.30.6.255,56269,103.243.223.145,443,7,402,5,282,2,120,530.338126,36.61118,61.62052138,26.22149846,Benign
172.30.6.255,55794,172.217.166.206,443,16,5626,8,1219,8,4407,80.059178,10.564053,923.1305447,3337.355464,Benign
172.30.6.255,55985,207.244.121.27,80,11,1949,6,955,5,994,183.342557,30.720556,248.6934156,258.8494818,Benign
192.168.43.224,58552,52.24.249.177,443,18,1948,10,1220,8,728,97.21262726,13.58685409,718.3414155,428.6496315,Benign
172.30.6.255,56028,52.213.19.114,443,18,6378,9,1141,9,5237,238.761771,14.827201,615.6252957,2825.617593,Benign
172.30.6.255,56957,184.29.26.182,443,42,11720,24,6665,18,5055,1390.044023,350.227933,152.2437104,115.4676603,Benign
172.30.6.255,58055,151.139.104.15,80,23,16166,8,1870,15,14296,4819.999388,5.994347,2495.684684,19079.30922,Benign
172.30.6.255,57623,103.243.221.87,80,28,15615,14,8485,14,7130,3430.845818,20.222569,3356.645736,2820.610972,Benign
172.30.6.255,57270,172.30.10.168,7680,3,198,3,198,0,0,2279.156463,9.01222,175.7613551,0,Benign
10.0.2.15,43252,119.254.87.201,80,11,1587,6,705,5,882,13732.27528,1.711481,3295.391535,4122.745155,Malicious
172.30.15.1237,50545,52.198.219.213,8088,6,348,4,228,2,120,3468.705361,8.918627,204.5157848,107.6398867,Benign
10.0.2.15,60946,119.254.87.201,80,11,1582,6,705,5,877,19684.14032,2.221462,2538.868547,3158.280448,Malicious
172.30.1.136,50492,157.240.16.17,443,15,4922,8,1025,7,3897,955.158479,10.458509,784.0505755,2980.922042,Benign
172.30.6.255,57323,103.243.221.51,80,16,5787,9,4551,7,1236,2467.882373,43.145139,843.8494079,229.1799315,Benign
10.0.2.15,55680,119.254.87.201,80,11,1579,6,705,5,874,20224.70957,1.764653,3196.095776,3962.252069,Malicious
172.30.6.255,55814,52.9.25.50,80,13,2662,7,992,6,1670,91.141824,61.763209,128.4907331,216.3100042,Benign
172.30.6.255,56174,52.213.19.114,443,175,71227,106,57698,69,13529,435.653653,420.595164,1097.454368,257.330586,Benign
172.30.15.1131,50439,157.240.16.63,443,12,1688,7,971,5,717,3458.301777,8.644698,898.5854682,663.5280955,Benign
172.30.15.1412,50720,72.251.245.179,443,8,480,5,294,3,186,3500.108331,7.02031,335.0279404,211.9564521,Benign
172.30.15.1508,50816,184.29.24.49,443,79,63143,31,4881,48,58262,3524.107265,2.9301,13326.50763,159071.704,Benign
172.30.1.136,50513,52.84.103.186,443,11,654,6,348,5,306,990.621156,36.353772,76.58077407,67.33826685,Benign
172.30.6.255,57222,103.243.221.17,80,78,53068,46,44884,32,8184,2157.838208,41.496741,8653.016872,1577.762456,Benign
10.0.2.15,51952,119.254.87.201,80,11,1582,6,705,5,877,3614.409003,1.826794,3087.376026,3840.608191,Malicious
172.30.6.255,56521,23.198.119.247,443,12,3827,6,1125,6,2702,831.968216,41.617062,216.2574571,519.4023547,Benign
10.0.2.15,37857,119.254.87.201,80,12,1653,7,779,5,874,12205.42313,3.801443,1639.377468,1839.301549,Malicious
172.30.1.136,50799,52.18.200.60,443,15,834,10,552,5,282,1932.169052,38.800069,113.8142306,58.1442265,Benign
172.30.6.255,57249,103.243.221.87,80,6,340,4,228,2,112,2230.04818,22.179885,82.23667526,40.39696328,Benign
172.30.6.255,57852,103.243.221.51,80,17,6609,9,5354,8,1255,4224.098137,13.958926,3068.430909,719.2530428,Benign
172.30.15.1064,50370,23.23.178.66,80,6,348,4,228,2,120,3452.489684,4.829629,377.6687609,198.773032,Benign
192.168.43.233,51479,54.81.94.76,80,11,655,6,349,5,306,3816.619478,75.838179,36.81522996,32.27925607,Benign
10.0.2.15,58682,119.254.87.201,80,11,1513,6,705,5,808,22351.60903,0.945171,5967.174194,6838.974112,Malicious
192.168.137.97,40098,216.58.192.131,443,18,5746,10,1278,8,4468,3808.67393,20.36057773,502.1468515,1755.549399,Benign
172.30.1.136,51802,103.243.221.46,443,22,8428,10,3908,12,4520,2977.652895,14.1627,2207.488685,2553.18548,Benign
192.168.215.49,56290,52.206.174.32,443,186,24263,103,10112,83,14151,81.67455692,40.6030609,1992.362108,2788.16418,Benign
192.168.215.49,54310,52.20.114.147,443,31,7193,15,2134,16,5059,555.8708788,60.93517739,280.1665759,664.1812124,Benign
192.168.43.233,51298,104.16.88.20,80,13,1540,7,815,6,725,2530.59849,60.931319,107.0057256,95.18914239,Benign
172.30.15.875,50181,184.29.26.86,80,38,30747,14,1287,24,29460,3436.047511,1.005721,10237.43165,234339.3446,Benign
172.30.15.2498,51832,14.139.45.128,80,10,1402,5,673,5,729,5475.719346,0.201927,26663.10102,28881.72458,Benign
10.0.2.15,45875,119.254.87.201,80,11,1554,6,705,5,849,19473.90016,2.146774,2627.197833,3163.816964,Malicious
192.168.137.97,53274,52.222.190.164,443,23,9681,13,1548,10,8133,306.3168244,11.21885522,1103.855942,5799.522208,Benign
10.0.2.15,46605,119.254.87.201,80,11,1579,6,705,5,874,21876.48511,2.255173,2500.916781,3100.427329,Malicious
172.30.6.255,57335,103.243.221.17,80,23,12383,13,10226,10,2157,2469.067476,41.961367,1949.602833,411.2354109,Benign
192.168.43.224,55722,18.208.55.232,443,11,730,6,404,5,326,1914.961364,143.4294489,22.53372669,18.1831557,Benign
192.168.43.224,34200,172.217.166.206,443,19,6017,11,1517,8,4500,941.6887344,32.08330126,378.2653132,1122.079044,Benign
192.168.137.97,39752,172.217.161.14,443,92,15296,49,6827,43,8469,3758.119969,616.2494977,88.62644141,109.9424831,Benign
172.30.6.255,55765,195.201.82.80,80,66,66029,19,3314,47,62715,62.195494,1.586329,16712.80043,316277.3926,Benign
172.30.6.255,58434,157.240.16.39,443,19,1933,10,1125,9,808,5608.085966,61.055815,147.406107,105.8703418,Benign
10.0.2.15,55239,119.254.87.201,80,11,1579,6,705,5,874,18539.90791,123.818284,45.5506232,56.46985061,Malicious
172.30.1.136,50221,52.84.103.186,443,1654,1169925,705,59047,949,1110878,385.107043,105.736367,4467.488466,84048.88736,Benign
172.30.15.1486,50794,104.244.42.195,443,20,3293,11,1909,9,1384,3520.941033,6.177813,2472.072237,1792.219998,Benign
172.30.15.288,49551,192.0.78.13,443,31,9846,16,2036,15,7810,392.625559,2.275482,7158.043878,27457.91881,Benign
192.168.43.233,51329,209.197.3.15,443,7,403,4,229,3,174,3075.219943,55.372491,33.0850205,25.13883654,Benign
192.168.43.224,53964,104.244.42.136,443,188,38857,101,25615,87,13242,947.709387,1635.436516,125.2998805,64.77536669,Benign
172.30.6.255,57890,103.243.221.75,80,31,15783,15,8559,16,7224,4344.842401,17.227553,3974.563306,3354.626162,Benign
10.0.2.15,44197,119.254.87.201,80,11,1579,6,705,5,874,21543.11156,2.162015,2608.677553,3234.020115,Malicious
172.30.6.255,58223,157.240.16.17,443,5410,4902962,2038,124827,3372,4778135,5174.822812,84.182239,11862.54977,454075.3543,Benign
192.168.43.224,45936,104.31.92.239,80,27,5572,14,1840,13,3732,804.2798476,76.62840067,192.0958792,389.620555,Benign
172.30.6.255,57021,103.243.221.51,80,52,38698,20,9814,32,28884,1548.855568,45.236126,1735.603973,5108.129728,Benign
172.30.6.255,56563,13.107.6.158,443,23,5461,11,1027,12,4434,876.566047,122.436168,67.10435433,289.7183126,Benign
172.30.6.255,58226,35.190.41.40,443,173,45344,71,11241,102,34103,5175.004178,84.014279,1070.389475,3247.352751,Benign
172.30.15.1287,50595,151.101.66.202,80,10,1987,6,944,4,1043,3470.768206,6.855747,1101.557569,1217.081085,Benign
192.168.43.224,51874,54.197.248.134,443,16,1855,9,1197,7,658,2411.973881,11.70783857,817.9135666,449.6133056,Benign
172.30.6.255,55870,210.176.156.55,443,36,10982,19,5104,17,5878,105.410071,302.482876,134.9894597,155.46004,Benign
172.30.15.506,49788,23.9.250.106,443,20,4239,10,2349,10,1890,2006.739056,9.194805,2043.762755,1644.406815,Benign
10.0.2.15,60842,119.254.87.201,80,11,1579,6,705,5,874,14062.68518,1.218143,4629.998284,5739.884398,Malicious
172.30.1.136,50815,157.240.16.16,443,28,4045,14,2327,14,1718,1955.211377,5.242768,3550.796068,2621.515963,Benign
172.30.15.1787,51099,52.37.171.77,443,16,5071,9,1153,7,3918,3643.052,3.935245,2343.945548,7964.942462,Benign
192.168.137.97,34432,172.217.161.3,443,17,2111,11,1547,6,564,325.4868744,30.4417399,406.5470646,148.2175465,Benign
172.30.6.255,56144,103.243.221.87,80,20,11995,8,3868,12,8127,368.851379,25.173993,1229.205077,2582.665372,Benign
192.168.43.224,35886,172.217.166.206,443,21,6472,11,1861,10,4611,9.399400758,5.971468006,2493.189277,6177.375473,Benign
172.30.6.255,56835,122.15.34.105,443,2577,1726686,1208,100896,1369,1625790,1319.893884,614.47651,1313.586422,21166.5048,Benign
172.30.15.1835,51147,104.16.118.145,443,14,5500,7,1000,7,4500,3864.721154,0.131249,60952.84536,274287.8041,Benign
10.0.2.15,47748,119.254.87.201,80,11,1579,6,705,5,874,22744.65659,1.01463,5558.676562,6891.182007,Malicious
172.30.6.255,56486,13.107.6.158,443,36,8001,18,2743,18,5258,814.683541,61.872056,354.6673801,679.8545696,Benign
10.0.2.15,33262,119.254.87.201,80,11,1585,6,705,5,880,16951.00197,1.389887,4057.883842,5065.159973,Malicious
192.168.137.97,47200,157.240.16.20,443,15,4856,9,1183,6,3673,225.2779046,1.149851518,8230.627913,25554.60382,Benign
192.168.137.97,46552,151.101.193.170,443,21,9399,12,1458,9,7941,382.7904208,17.0240824,685.1470597,3731.65487,Benign
172.30.6.255,57545,103.243.221.17,80,69,48087,42,40174,27,7913,3188.843866,30.1839,10647.79568,2097.277025,Benign
172.30.15.1167,50475,210.176.156.62,80,21,11286,10,3699,11,7587,3460.541087,6.731178,4396.258723,9017.143805,Benign
192.168.137.97,33332,172.217.194.157,443,23,5580,13,1661,10,3919,39.27915117,15.84589013,838.5770626,1978.5572,Benign
172.30.1.136,50213,52.84.103.186,443,24,8420,13,1531,11,6889,370.497478,11.077071,1105.707456,4975.322448,Benign
192.168.137.97,41914,23.57.214.252,443,25,8722,13,2989,12,5733,30.94922846,25.56490311,935.3448319,1794.022055,Benign
172.30.6.255,56991,157.240.16.39,443,27,5329,15,3275,12,2054,1460.088443,61.04228,429.2107044,269.1904693,Benign
10.0.2.15,38747,119.254.87.201,80,11,1582,6,705,5,877,22113.69376,2.113894,2668.06188,3318.993289,Malicious
192.168.137.97,56066,52.205.114.175,443,20,6580,12,2178,8,4402,347.6144184,8.096387034,2152.071032,4349.594437,Benign
172.30.1.136,50326,157.240.16.20,443,759,587133,330,26429,429,560704,568.726045,156.030632,1355.067254,28748.40627,Benign
192.168.215.249,49166,17.242.12.89,5223,10,1190,0,0,10,1190,1224.253512,431.5739113,0,22.05879399,Benign
172.30.6.255,56249,202.241.208.52,80,11,1966,6,831,5,1135,529.831116,36.532429,181.9753075,248.5462984,Benign
10.0.2.15,44061,119.254.87.201,80,11,1513,6,705,5,808,462.892191,1.277923,4413.41145,5058.207732,Malicious
172.30.1.136,50333,172.217.161.3,443,139,79473,65,8230,74,71243,595.794499,36.455316,1806.046613,15634.04361,Benign
10.0.2.15,45493,119.254.87.201,80,11,1579,6,705,5,874,23823.09962,1.351429,4173.360199,5173.782714,Malicious
172.30.6.255,57918,157.240.16.39,443,29,5600,16,3453,13,2147,4449.089182,61.056137,452.4360917,281.3148824,Benign
172.30.15.794,50086,52.4.148.116,443,90,16964,40,5203,50,11761,2677.095517,602.584049,69.07584107,156.1408739,Benign
172.30.1.136,50643,157.240.16.20,443,19,5722,9,1155,10,4567,1746.333573,3.459891,2670.604363,10559.87024,Benign
192.168.43.233,50956,163.53.78.128,80,12,1902,7,1261,5,641,473.508111,35.549159,283.7760522,144.2509512,Benign
172.30.15.405,49677,162.125.248.4,443,6,348,4,228,2,120,1533.676116,0.229106,7961.380322,4190.200169,Benign
192.168.43.224,59096,54.171.46.4,443,37,10001,19,2808,18,7193,113.0474243,61.55262208,364.9560204,934.8748771,Benign
10.0.2.15,42458,119.254.87.201,80,11,1579,6,705,5,874,5686.456909,4.674568,1206.528603,1495.75319,Malicious
172.30.1.136,50313,117.18.237.29,80,12,1698,7,628,5,1070,563.395569,66.189833,75.90289584,129.3249977,Benign
172.30.6.255,57725,103.243.221.87,80,23,12391,13,10234,10,2157,3740.873429,21.241754,3854.295648,812.3622936,Benign
192.168.137.97,37766,117.18.237.70,443,11849,10680709,4426,319645,7423,10361064,285.2985508,287.3877751,8897.942853,288420.452,Benign
172.30.6.255,56039,151.101.153.108,80,32,20876,13,2494,19,18382,253.723338,157.906389,126.3533422,931.2859406,Benign
192.168.43.224,60178,151.101.153.2,443,11,766,7,478,4,288,913.0872393,13.62950251,280.5678341,169.0450549,Benign
192.168.137.97,39102,157.240.16.16,443,559,125726,314,64933,245,60793,390.084538,2690.626016,193.0643638,180.7549608,Benign
172.30.6.255,56676,13.107.4.52,80,10,1519,5,436,5,1083,1146.981618,0.228365,15273.79415,37939.2639,Benign
172.30.6.255,56079,103.243.221.87,80,35,21330,14,7964,21,13366,303.860234,20.163755,3159.728929,5302.980521,Benign
192.168.43.233,51212,52.114.128.10,443,28,13540,16,8227,12,5313,1245.046275,126.690621,519.5017554,335.4944483,Benign
192.168.43.233,51511,13.107.21.200,443,48,16705,25,2855,23,13850,3898.543261,127.191878,179.5712144,871.1248056,Benign
192.168.215.49,59824,52.84.110.136,443,145,89510,73,5849,72,83661,279.5300193,180.2182771,259.6407021,3713.76317,Benign
172.30.15.412,49684,192.168.121.7,443,16,2935,8,1691,8,1244,1575.4726,4.992181,2709.837644,1993.517463,Benign
172.30.15.1878,51190,54.86.233.56,443,16,4806,9,1153,7,3653,3965.376495,1.819419,5069.750288,16062.27043,Benign
10.0.2.15,55070,119.254.87.201,80,11,1582,6,705,5,877,3732.23927,1.745331,3231.478728,4019.867865,Malicious
10.0.2.15,45976,119.254.87.201,80,11,1582,6,705,5,877,19503.9613,1.618324,3485.087041,4335.349411,Malicious
172.30.6.255,56446,34.246.69.20,80,6,348,4,228,2,120,700.569589,10.776358,169.2594103,89.08390015,Benign
172.30.6.255,58202,157.240.16.39,443,19,1933,10,1125,9,808,5120.09246,61.056029,147.4055904,105.8699707,Benign
172.30.6.255,56657,103.243.221.17,80,22,10418,10,4291,12,6127,1090.870337,31.280055,1097.440526,1567.004917,Benign
172.30.6.255,55887,184.84.52.113,80,24,14072,10,2405,14,11667,111.140505,1.343688,14318.8002,69462.55381,Benign
192.168.137.97,57158,104.113.214.101,443,13,1625,7,1038,6,587,145.6233511,61.18264427,135.7247647,76.75379278,Benign
172.30.1.136,50294,172.217.161.4,443,11,618,6,336,5,282,496.658428,15.340728,175.2198462,147.0595137,Benign
192.168.43.224,46272,45.33.67.183,443,19,8414,11,1377,8,7037,2468.082127,10.91257992,1009.477143,5158.816745,Benign
172.30.6.255,57345,104.16.2.35,443,16,5726,9,1120,7,4606,2476.438302,34.980276,256.1443483,1053.393632,Benign
172.30.15.1509,50817,184.29.24.49,443,54,38678,23,2560,31,36118,3524.110163,2.92709,6996.710043,98713.73958,Benign
172.30.6.255,56351,35.186.236.204,80,20,2052,11,997,9,1055,607.828397,248.282203,32.12473509,33.99357625,Benign
192.168.137.97,57062,104.113.214.101,443,64,14845,34,7806,30,7039,24.63197739,655.4903331,95.26913952,85.90820818,Benign
10.0.2.15,52725,119.254.87.201,80,11,1582,6,705,5,877,26436.17692,2.017362,2795.730266,3477.809139,Malicious
10.0.2.15,39073,119.254.87.201,80,11,1582,6,705,5,877,10341.22694,1.441797,3911.785085,4866.149673,Malicious
172.30.15.1093,50399,144.217.79.15,80,9,1226,5,811,4,415,3453.346839,0.58285,11131.50896,5696.148237,Benign
172.30.6.255,56759,23.198.126.238,443,17,6644,8,1322,9,5322,1244.684221,0.773336,13675.81491,55054.98257,Benign
192.168.43.233,51371,204.79.197.229,443,175,78258,90,64841,85,13417,3207.089094,1.840273,281875.5695,58326.12879,Benign
172.30.15.320,49586,52.114.128.8,443,37,23194,22,17816,15,5378,806.163162,3.945846,36121.02449,10903.61864,Benign
172.30.6.255,58126,216.58.196.194,80,42,11502,22,6432,20,5070,4899.836254,9.116973,5643.978544,4448.845028,Benign
10.0.2.15,37074,119.254.87.201,80,13,1730,8,853,5,877,22651.86684,10.426378,654.4938233,672.9086553,Malicious
10.0.2.15,42876,119.254.87.201,80,11,1552,6,705,5,847,23768.5212,2.284572,2468.73375,2965.98225,Malicious
172.30.6.255,57802,35.190.43.164,80,163,49307,83,36351,80,12956,4041.972227,731.924438,397.3197026,141.6102464,Benign
10.0.2.15,60185,119.254.87.201,80,12,1656,7,779,5,877,1544.029453,4.473658,1393.043456,1568.291541,Malicious
172.30.6.255,56693,103.231.98.53,80,50,23679,27,21245,23,2434,1155.906066,85.858344,1979.539694,226.7921683,Benign
192.168.137.97,39776,192.168.125.6,80,812,705792,359,25726,453,680066,8327.373552,79.24663319,2597.056704,68653.1122,Benign
192.168.215.49,45676,130.211.21.54,443,82,17746,38,4968,44,12778,479.7830229,380.5739647,104.4317365,268.6048166,Benign
192.168.137.97,32928,52.216.133.213,443,116,65390,60,4408,56,60982,382.5436149,14.20432106,2482.62482,34345.60498,Benign
192.168.43.224,34176,54.191.37.172,443,22,5978,13,4684,9,1294,176.6923959,21.33161693,1756.641333,485.2890445,Benign
192.168.215.49,54670,157.240.16.20,443,347,338421,95,7915,252,330506,1253.036697,65.57942561,965.5467308,40318.25493,Benign
10.0.2.15,38609,119.254.87.201,80,11,1513,6,705,5,808,21332.8518,1.383927,4075.359466,4670.766594,Malicious
172.30.1.136,50465,52.84.103.186,443,1984,1588863,751,47633,1233,1541230,878.133462,181.312759,2101.694344,68003.15691,Benign
172.30.15.1206,50514,103.243.220.231,443,6,340,4,228,2,112,3466.400439,1.238811,1472.379564,723.2741718,Benign
172.30.6.255,55846,54.194.27.245,443,22,4865,13,3915,9,950,102.899395,125.378082,249.8044275,60.61665547,Benign
10.0.2.15,44139,119.254.87.201,80,11,1579,6,705,5,874,913.423929,1.879592,3000.651205,3719.956246,Malicious
10.0.2.15,50269,119.254.87.201,80,11,1585,6,705,5,880,10401.28168,1.285342,4387.937218,5477.141492,Malicious
10.0.2.15,41853,119.254.87.201,80,11,1579,6,705,5,874,1003.497012,1.238635,4553.399508,5644.923646,Malicious
10.0.2.15,53961,119.254.87.201,80,12,1653,7,779,5,874,11935.16692,4.275388,1457.645482,1635.407126,Malicious
192.168.43.233,51185,74.125.68.188,5228,6,384,1,66,5,318,635.165285,12.685359,41.62278734,200.5461572,Benign
10.0.2.15,59674,119.254.87.201,80,11,1579,6,705,5,874,14878.57112,1.020088,5528.934759,6854.310609,Malicious
10.0.2.15,40499,119.254.87.201,80,11,1582,6,705,5,877,3285.886865,1.751253,3220.551228,4006.274365,Malicious
172.30.15.2464,51798,14.139.45.128,80,45,31338,21,1654,24,29684,5422.524891,1.74617,7577.727255,135995.9225,Benign
172.30.1.136,50191,172.217.161.3,443,29,7794,16,2252,13,5542,353.357199,22.09107,815.5331543,2006.964805,Benign
172.30.1.136,50251,172.217.161.14,443,3,198,3,198,0,0,451.916761,8.999288,176.0139247,0,Benign
192.168.43.224,50102,104.198.143.177,80,12,1051,7,565,5,486,514.5616017,2.546106854,1775.259351,1527.037247,Benign
172.30.1.136,50623,52.213.11.166,443,30,12154,17,1670,13,10484,1650.585796,62.168196,214.9008795,1349.114264,Benign
192.168.137.97,46926,157.240.16.16,443,280,29024,142,13724,138,15300,143.5100514,1687.10315,65.07723017,72.55039505,Benign
172.30.15.486,49763,180.149.59.233,80,8,877,5,468,3,409,1789.470891,14.33401,261.1969714,228.2682934,Benign
172.30.6.255,57558,172.30.16.59,7680,3,198,3,198,0,0,3242.15245,9.001721,175.9663513,0,Benign
172.30.6.255,56722,103.243.220.231,80,31,23026,11,4616,20,18410,1193.835437,28.627061,1289.968258,5144.782414,Benign
10.0.2.15,55876,119.254.87.201,80,11,1582,6,705,5,877,11660.10403,1.530003,3686.267282,4585.611924,Malicious
172.30.15.1431,50739,103.231.98.244,443,8,664,5,490,3,174,3500.808371,0.356397,10998.97025,3905.756782,Benign
192.168.43.233,51032,13.228.138.206,443,16,4676,8,1087,8,3589,819.707711,18.621316,466.9916992,1541.888876,Benign
192.168.43.224,38254,140.98.193.112,443,23,8453,13,4103,10,4350,2297.348855,5.797875285,5661.384281,6002.198787,Benign
192.168.215.49,49196,104.237.191.1,443,65,10714,32,3958,33,6756,71.61942498,314.9878868,100.5245005,171.5875507,Benign
192.168.43.224,42416,172.217.194.154,443,16,5014,9,1377,7,3637,45.46549554,11.18279254,985.0848939,2601.854582,Benign
172.30.6.255,58436,103.243.221.109,80,38,24224,23,20177,15,4047,5616.83908,2.387721,67602.53815,13559.37314,Benign
172.30.15.1506,50814,52.114.158.52,443,18,7787,10,3147,8,4640,3521.445415,1.555988,16180.07337,23856.22511,Benign
172.30.1.136,50331,157.240.16.20,443,24,7019,14,2924,10,4095,569.036183,45.242042,517.0412069,724.1052471,Benign
192.168.137.97,47190,157.240.16.20,443,11,722,7,462,4,260,220.1025506,52.09675921,70.94491205,39.92570808,Benign
192.168.137.97,40016,172.217.161.14,443,11,738,6,404,5,334,6778.812059,14.74363327,219.2132659,181.2307693,Benign
10.0.2.15,54736,119.254.87.201,80,11,1579,6,705,5,874,11064.41064,1.891594,2981.612333,3696.353446,Malicious
172.30.15.2443,51777,14.139.45.128,80,44,22542,16,1744,28,20798,5418.965522,1.216812,11466.02762,136737.639,Benign
172.30.15.1144,50452,172.217.167.2,80,55,36952,23,6024,32,30928,3458.318387,19.189634,2511.355871,12893.62788,Benign
172.30.6.255,56531,23.198.119.247,443,22,9500,12,1368,10,8132,832.121744,41.464797,263.93473,1568.945339,Benign
10.0.2.15,42509,119.254.87.201,80,11,1579,6,705,5,874,14097.61019,1.954885,2885.080197,3576.680981,Malicious
192.168.43.224,57714,172.217.166.197,443,3284,2766475,1258,193787,2026,2572688,1431.835923,450.7120299,3439.659688,45664.42126,Benign
172.30.15.1247,50555,151.101.130.2,443,41,13466,20,2633,21,10833,3469.515321,7.993139,2635.260065,10842.29863,Benign
192.168.43.224,51816,54.173.101.22,443,11,742,6,404,5,338,34.18301637,13.39507843,241.2826485,201.8651861,Benign
192.168.43.233,50924,52.84.103.186,443,16,6825,8,1087,8,5738,431.420984,0.222905,39012.13521,205935.2639,Benign
172.30.15.1681,50992,184.29.25.7,443,12,1423,6,904,6,519,3597.194595,9.843206,734.7199683,421.8137871,Benign
172.30.1.136,51825,172.217.160.227,443,41,11210,19,3101,22,8109,3085.103798,8.582142,2890.653639,7558.952066,Benign
192.168.137.97,39778,172.217.167.10,443,40,7515,21,2681,19,4834,149.3212237,233.9233801,91.68814159,165.3190886,Benign
172.30.15.2534,51868,139.59.61.230,443,15,6717,7,1000,8,5717,5499.971617,0.404104,19796.88397,113178.7857,Benign
172.30.15.1616,50926,161.202.1.35,443,19,7305,10,3217,9,4088,3573.953672,3.22506,7980.006574,10140.58653,Benign
172.30.6.255,56715,210.176.156.41,80,30,15789,16,11385,14,4404,1170.844851,70.993737,1282.93007,496.2691286,Benign
192.168.43.233,51169,104.237.191.1,443,13,750,6,348,7,402,486.936681,14.566657,191.1214083,220.7781785,Benign
10.0.2.15,44821,119.254.87.201,80,11,1579,6,705,5,874,20879.77243,1.291867,4365.774495,5412.321857,Malicious
172.30.6.255,55782,195.201.82.80,80,580,650443,125,14929,455,635514,63.792255,38.259179,3121.656113,132886.0716,Benign
192.168.137.97,51938,172.217.161.3,443,48,5784,25,3061,23,2723,5409.239518,241.5090303,101.3957945,90.19952577,Benign
10.0.2.15,40819,119.254.87.201,80,11,1582,6,705,5,877,2054.633417,2.093387,2694.198445,3351.506434,Malicious
192.168.43.224,33118,54.243.243.77,443,136,92396,69,7017,67,85379,728.4535254,6.785840126,8272.520271,100655.4807,Benign
10.0.2.15,47215,119.254.87.201,80,11,1579,6,705,5,874,26135.83386,1.496485,3768.831629,4672.282048,Malicious
172.30.6.255,58340,103.243.221.51,80,25,13892,12,5401,13,8491,5419.841455,9.977221,4330.664821,6808.308646,Benign
192.168.137.97,39416,172.217.161.4,443,438,244879,193,23748,245,221131,280.7606298,102.4839609,1853.792518,17261.70597,Benign
10.0.2.15,34407,119.254.87.201,80,11,1582,6,705,5,877,8511.500944,1.946562,2897.41606,3604.303382,Malicious
172.30.6.255,57543,157.240.16.39,443,19,1933,10,1125,9,808,3168.091662,61.031358,147.4651768,105.912767,Benign
172.30.6.255,56463,103.243.221.75,80,20,9645,10,4279,10,5366,746.871678,15.629895,2190.161866,2746.531567,Benign
172.30.15.1210,50518,52.221.149.164,443,6,348,4,228,2,120,3466.616816,0.606601,3006.918881,1582.588885,Benign
172.30.1.136,50682,151.101.0.188,443,37,20011,25,8109,12,11902,1805.416489,26.644913,2434.686126,3573.51514,Benign
172.30.15.561,49845,151.101.0.84,443,23,8453,12,1837,11,6616,2253.725194,2.472556,5943.646979,21406.18858,Benign
192.168.43.224,49162,157.240.16.39,443,35,11689,19,9015,16,2674,162.700159,65.67296893,1098.168717,325.7352355,Benign
10.0.2.15,58900,119.254.87.201,80,11,1582,6,705,5,877,5778.712489,1.893143,2979.17273,3706.006361,Malicious
172.30.15.1238,50546,202.131.200.84,80,6,348,4,228,2,120,3468.730414,8.893716,205.0886266,107.9413824,Benign
192.168.43.224,50980,18.210.21.97,443,33,7084,18,2460,15,4624,112.572724,61.46271028,320.1941455,601.8608654,Benign
192.168.43.233,51446,151.101.154.2,80,54,41350,22,2444,32,38906,3803.721438,25.23051,774.9347913,12336.17553,Benign
192.168.43.224,38252,140.98.193.112,443,21,8320,11,3970,10,4350,2297.347058,4.885482306,6500.893466,7123.145233,Benign
192.168.137.97,33546,35.171.73.174,443,28,6531,14,2002,14,4529,1828.348367,61.32286682,261.1750042,590.8399571,Benign
10.0.2.15,55937,119.254.87.201,80,11,1513,6,705,5,808,5984.304989,1.22534,4602.80412,5275.270537,Malicious
172.30.1.136,51504,13.107.21.200,443,1,54,0,0,1,54,106.186603,0,0,0,Benign
192.168.43.224,49690,198.252.206.25,443,94,12568,48,5451,46,7117,60.87969756,1446.538881,30.14644168,39.36015876,Benign
192.168.43.233,50713,172.217.166.206,443,293,219116,129,10936,164,208180,1843.413238,5.911778,14798.93189,281715.5854,Benign
192.168.43.224,57462,172.217.166.197,443,113,26228,57,11747,56,14481,743.6870021,380.1591252,247.2017473,304.7355498,Benign
192.168.43.224,54576,54.85.227.48,443,16,1203,8,552,8,651,16.11141849,17.28654341,255.4588212,301.2748054,Benign
172.30.1.136,51545,52.84.110.227,443,193,137318,98,28216,95,109102,713.950664,27.143629,8316.058254,32155.46455,Benign
172.30.15.544,49828,104.122.118.96,443,23,6450,12,2038,11,4412,2251.38277,4.710127,3461.47779,7493.64083,Benign
10.0.2.15,59589,119.254.87.201,80,13,1730,8,853,5,877,6945.31571,9.871937,691.2523854,710.7014561,Malicious
172.30.15.337,49605,104.25.218.21,443,44,13376,21,2791,23,10585,982.642234,7.586083,2943.284433,11162.54594,Benign
10.0.2.15,46521,119.254.87.201,80,11,1593,6,705,5,888,8927.187276,1.028815,5482.035157,6905.031517,Malicious
192.168.43.233,50737,151.139.105.14,443,3,186,2,120,1,66,1861.866388,0.636942,1507.201598,828.9608787,Benign
10.0.2.15,46019,119.254.87.201,80,11,1582,6,705,5,877,4847.625596,0.821599,6864.662688,8539.445642,Malicious
172.30.1.136,50127,74.125.24.188,443,9,535,5,295,4,240,104.090819,57.905658,40.75594824,33.15738162,Benign
192.168.137.97,48920,52.84.108.120,443,4793,4543104,1691,112848,3102,4430256,2250.282647,186.482481,4841.119634,190055.6439,Benign
172.30.6.255,55954,54.82.135.50,443,6,348,4,228,2,120,161.171257,11.874286,153.609236,80.84696629,Benign
192.168.215.49,60588,103.231.98.244,443,7,995,4,789,3,206,612.6037496,0.253647969,24884.88287,6497.193754,Benign
172.30.6.255,56450,213.155.156.183,443,6,348,4,228,2,120,700.569339,11.009421,165.6762876,87.19804611,Benign
172.30.1.136,50262,104.17.38.113,443,229,108660,111,10375,118,98285,461.903362,169.279271,490.3140208,4644.868774,Benign
10.0.2.15,38564,119.254.87.201,80,11,1582,6,705,5,877,20129.04309,1.555853,3625.02113,4509.423448,Malicious
10.0.2.15,38715,119.254.87.201,80,11,1579,6,705,5,874,20074.48552,1.613162,3496.239063,4334.344598,Malicious
192.168.43.233,51658,18.185.199.142,443,32,9138,17,2799,15,6339,865.487398,155.325917,144.1613894,326.487691,Benign
172.30.15.1716,51027,184.29.25.7,443,115,96279,43,16284,72,79995,3618.882982,8.197943,15890.81554,78063.48495,Benign
172.30.6.255,58317,52.213.19.114,443,15,2985,8,2287,7,698,5354.574283,4.564184,4008.602633,1223.438845,Benign
172.30.15.1957,51269,172.217.166.193,443,16,5642,8,1054,8,4588,4038.651111,3.5689,2362.632744,10284.40136,Benign
172.30.6.255,57283,103.243.221.46,80,25,13696,15,11538,10,2158,2336.866019,33.185324,2781.470508,520.2299667,Benign
172.30.15.2204,51516,77.88.21.119,443,11,1342,6,904,5,438,4311.912659,6.604711,1094.975995,530.5304047,Benign
172.30.15.452,49726,23.9.250.106,443,342,250370,143,12333,199,238037,1632.676235,7.915296,12464.9792,240584.3066,Benign
192.168.137.97,36048,172.217.160.234,443,96,19274,46,6884,50,12390,16.93460493,161.8279822,340.3119736,612.5022302,Benign
172.30.6.255,56619,157.240.16.39,443,19,1933,10,1125,9,808,972.086254,61.071382,147.3685334,105.8433556,Benign
10.0.2.15,45703,119.254.87.201,80,11,1582,6,705,5,877,8601.579979,2.017569,2795.443427,3477.45232,Malicious
172.30.6.255,57897,157.240.16.39,443,27,5329,15,3275,12,2054,4388.092528,61.047614,429.1732024,269.1669489,Benign
192.168.43.224,56838,18.233.7.102,443,30,9852,16,3499,14,6353,2429.231814,2.913222281,9608.604253,17445.97394,Benign
192.168.215.49,42792,35.237.145.81,443,15,6252,9,1200,6,5052,787.2256194,0.890000262,10786.51368,45411.22259,Benign
10.0.2.15,33950,119.254.87.201,80,11,1544,6,705,5,839,19528.38505,1.302122,4331.391375,5154.662927,Malicious
192.168.137.97,47198,157.240.16.20,443,19,5322,11,1279,8,4043,225.2776685,1.149966769,8897.648415,28126.03014,Benign
10.0.2.15,40049,219.234.85.243,80,8,943,4,687,4,256,247.412897,83.070008,66.16106261,24.65390397,Malicious
10.0.2.15,51917,119.254.87.201,80,12,1653,7,779,5,874,9557.802004,5.663614,1100.357475,1234.547411,Malicious
192.168.43.224,50060,34.227.238.173,443,6,412,4,272,2,140,371.1014477,34.85423337,62.4314406,32.13382972,Benign
172.30.1.136,51823,157.240.16.39,443,11,666,6,360,5,306,3057.238219,43.751444,65.82639878,55.95243896,Benign
192.168.43.224,49412,104.198.143.177,80,10,911,5,425,5,486,2489.539962,1.504106207,2260.478671,2584.923845,Benign
172.30.6.255,55989,34.226.161.213,80,6,348,4,228,2,120,183.520646,30.547469,59.71034785,31.42649887,Benign
10.0.2.15,48122,119.254.87.201,80,11,1582,6,705,5,877,4727.513708,0.881705,6396.697308,7957.309985,Malicious
10.0.2.15,50970,119.254.87.201,80,11,1513,6,705,5,808,10193.30261,1.826567,3087.759715,3538.87922,Malicious
192.168.43.224,51810,172.217.166.208,80,27,7314,14,1280,13,6034,232.4255785,285.4952056,35.86750249,169.0816485,Benign
172.30.6.255,57471,157.240.16.39,443,28,5559,15,3411,13,2148,2985.090318,61.035925,447.0809609,281.53911,Benign
172.30.1.136,50515,157.240.16.39,443,83,27364,39,22370,44,4994,999.128117,94.25044,1898.770977,423.8919203,Benign
172.30.6.255,58053,151.139.104.15,80,14,5536,7,1818,7,3718,4819.99902,5.993623,2426.579049,4962.607758,Benign
172.30.6.255,56050,52.76.32.254,80,6,348,4,228,2,120,254.48326,27.442489,66.46627425,34.98224961,Benign
172.30.15.1121,50429,52.84.101.238,443,22,3088,13,1827,9,1261,3458.281568,8.750876,1670.232786,1152.798874,Benign
172.30.15.1437,50745,103.231.98.244,443,8,664,5,490,3,174,3501.23138,0.337795,11604.67147,4120.842523,Benign
10.0.2.15,60274,119.254.87.201,80,12,1656,7,779,5,877,18392.8729,14.108447,441.7211901,497.2907365,Malicious
172.30.15.1003,50309,188.125.88.204,443,20,7318,11,1261,9,6057,3443.316114,3.629505,2779.442376,13350.58086,Benign
192.168.43.233,51007,117.18.232.102,443,2426,1857711,960,63057,1466,1794654,537.727088,449.76188,1121.606838,31921.85163,Benign
172.30.1.136,50468,157.240.16.20,443,26,6352,7,983,19,5369,878.423307,140.433549,55.99801512,305.8528415,Benign
172.30.15.1097,50403,54.37.85.234,443,30,13483,16,2197,14,11286,3453.692897,5.298025,3317.462639,17041.82219,Benign
172.30.6.255,55634,117.18.232.131,80,197,216803,41,8526,156,208277,34.667074,23.913772,2852.24765,69676.00093,Benign
172.30.6.255,57089,103.243.221.17,80,52,35935,25,13851,27,22084,1734.842102,12.437489,8909.193809,14204.79648,Benign
172.30.6.255,58526,172.217.166.226,80,32,7930,17,4444,15,3486,5781.829202,7.561131,4701.942077,3688.337102,Benign
192.168.137.97,47626,52.84.108.11,443,8,552,5,338,3,214,1821.051108,18.37912313,147.1234498,93.14916645,Benign
172.30.15.1293,50601,210.176.156.62,80,14,5311,7,3729,7,1582,3471.134462,1.181888,25240.97038,10708.29046,Benign
192.168.137.97,34180,192.229.237.96,443,21,7397,12,1479,9,5918,144.4487415,10.87352228,1088.14786,4354.062905,Benign
192.168.215.49,46388,223.31.160.67,443,603,548043,202,20116,401,527927,282.7218246,27.5669605,5837.712868,153205.7189,Benign
172.30.15.277,49540,180.149.59.81,443,15,5008,8,1219,7,3789,252.154328,2.556898,3813.996491,11854.98991,Benign
10.0.2.15,45279,119.254.87.201,80,11,1582,6,705,5,877,3972.442377,1.09462,5152.473004,6409.530248,Malicious
172.30.15.2137,51449,54.250.131.33,443,19,6682,9,1141,10,5541,4178.578816,9.050908,1008.517598,4897.63016,Benign
192.168.43.233,51373,192.28.144.75,443,4,236,2,120,2,116,3473.642202,10.899782,88.075156,85.13931747,Benign
10.0.2.15,51088,119.254.87.201,80,11,1579,6,705,5,874,2473.21704,1.221437,4617.511996,5724.404943,Malicious
192.168.137.97,39764,172.217.167.10,443,17,1158,9,638,8,520,98.46022852,42.09759846,121.2420705,98.81798849,Benign
10.0.2.15,55042,119.254.87.201,80,13,1661,8,853,5,808,4245.131737,10.849768,628.9535408,595.7731078,Malicious
192.168.137.97,49484,157.240.16.52,443,10,672,6,412,4,260,7086.832392,33.66234163,97.91356872,61.79011618,Benign
172.30.1.136,50360,104.244.42.8,443,21,1242,13,762,8,480,650.353881,41.11987,148.2494959,93.38550924,Benign
192.168.43.224,36190,52.20.114.147,443,6,412,4,272,2,140,56.06666614,16.28713524,133.6023781,68.7659299,Benign
192.168.42.240,50920,13.107.54.254,443,1,54,0,0,1,54,108.655607,0,0,0,Benign
192.168.42.240,50996,216.58.221.46,443,458,145136,198,77138,260,67998,336.020358,271.100821,2276.289676,2006.574521,Benign
172.30.6.255,55862,209.15.36.33,443,7,402,4,228,3,174,105.1536,6.340664,287.667033,219.5353673,Benign
192.168.215.49,43584,151.101.0.84,443,51,12054,27,4202,24,7852,1253.65989,588.1001774,57.16032964,106.8117345,Benign
192.168.43.224,44596,151.101.66.217,443,23,8947,13,1662,10,7285,2433.566198,24.40912492,544.7143249,2387.631683,Benign
10.0.2.15,47419,119.254.87.201,80,11,1579,6,705,5,874,15025.89143,246.243727,22.90413676,28.39463196,Malicious
10.0.2.15,60220,119.254.87.201,80,11,1582,6,705,5,877,13043.9542,0.92767,6079.748186,7563.034269,Malicious
192.168.43.224,48722,104.25.219.21,443,2040,1719235,846,47102,1194,1672133,215.1047343,402.7253022,935.6650748,33216.34853,Benign
192.168.43.233,51285,23.9.140.60,80,18,4154,9,3344,9,810,2775.001407,5.676616,4712.666842,1141.525162,Benign
192.168.215.49,48560,54.209.180.26,443,14,1660,8,1080,6,580,481.0684385,27.96619695,308.9444023,165.9145864,Benign
10.0.2.15,41818,119.254.87.201,80,11,1568,6,705,5,863,612.975176,1.752409,3218.426749,3939.719552,Malicious
10.0.2.15,58030,119.254.87.201,80,11,1582,6,705,5,877,8659.624784,2.007631,2809.281188,3494.666101,Malicious
10.0.2.15,39746,119.254.87.201,80,11,1582,6,705,5,877,10071.002,1.086456,5191.190439,6457.693639,Malicious
172.30.15.1315,50623,157.240.16.20,443,74,41715,33,3274,41,38441,3487.830369,9.18861,2850.485547,33468.39185,Benign
172.30.15.1978,51290,35.200.76.2,443,19,7814,10,1219,9,6595,4076.766243,5.650814,1725.769066,9336.70795,Benign
192.168.42.240,50952,172.217.166.206,443,115,33272,55,16999,60,16273,207.877764,88.337467,1539.460035,1473.712168,Benign
172.30.6.255,56125,172.64.128.2,443,6,348,4,228,2,120,333.229161,12.750213,143.0564336,75.29285981,Benign
10.0.2.15,48727,119.254.87.201,80,11,1582,6,705,5,877,17756.55691,1.4194,3973.509934,4942.933634,Malicious
172.30.15.635,49922,23.198.105.137,443,21,6379,12,1453,9,4926,2392.890324,3.20973,3621.488412,12277.66822,Benign
192.168.43.233,51024,163.53.78.128,443,43,24004,19,3011,24,20993,779.219319,39.558081,608.9274149,4245.504225,Benign
10.0.2.15,55501,119.254.87.201,80,11,1582,6,705,5,877,8599.514659,2.044365,2758.802856,3431.872489,Malicious
192.168.215.49,52454,35.187.209.206,443,25,9622,14,2367,11,7255,480.181488,28.63395505,661.3127655,2026.964138,Benign
172.30.15.966,50272,13.250.77.177,80,10,1571,6,848,4,723,3442.416125,4.645125,1460.455854,1245.176395,Benign
10.0.2.15,43418,119.254.87.201,80,11,1513,6,705,5,808,13792.37363,13.357697,422.2284725,483.9157528,Malicious
172.30.15.810,50102,52.229.175.79,443,28,10096,15,2246,13,7850,2765.344672,125.224878,143.4858655,501.4977934,Benign
10.0.2.15,58426,119.254.87.201,80,11,1579,6,705,5,874,22414.16694,1.220675,4620.394454,5727.978373,Malicious
172.30.15.2422,51756,14.139.45.128,80,10,1399,5,675,5,724,5355.91887,0.099894,54057.30074,57981.46035,Benign
172.30.6.255,56227,103.243.221.51,80,6,340,4,228,2,112,470.32594,20.711457,88.06719875,43.26108009,Benign
10.0.2.15,42933,119.254.87.201,80,11,1582,6,705,5,877,19678.56047,2.228126,2531.275161,3148.834491,Malicious
172.30.15.1151,50459,50.23.131.235,443,6,348,4,228,2,120,3458.561236,9.105616,200.3159369,105.4294405,Benign
172.30.15.1517,50825,180.179.41.214,443,20,8134,10,1667,10,6467,3525.462928,0.334588,39857.97458,154625.9878,Benign
192.168.137.97,45528,54.82.135.50,443,8,544,6,404,2,140,4017.662038,32.09756689,100.6929906,34.8936106,Benign
10.0.2.15,56705,119.254.87.201,80,12,1653,7,779,5,874,21756.40389,3.983631,1564.401924,1755.182646,Malicious
192.168.43.233,51332,104.19.196.151,443,128,91067,54,3960,74,87107,3076.958421,196.085988,161.5617736,3553.82864,Benign
192.168.42.240,50997,216.58.221.46,443,42,11918,22,4409,20,7509,336.021026,42.869261,822.7806866,1401.283778,Benign
172.30.15.2193,51505,31.24.224.56,443,6,348,4,228,2,120,4282.642711,5.198313,350.8830653,184.6752975,Benign
192.168.43.233,51247,172.217.166.195,443,7,403,4,229,3,174,1728.837496,55.466051,33.02921277,25.09643241,Benign
10.0.2.15,51605,119.254.87.201,80,11,1587,6,705,5,882,20822.24523,1.423734,3961.414141,4955.981946,Malicious
172.30.6.255,58334,35.190.43.164,80,10,1573,6,1119,4,454,5419.829315,9.222968,970.6203036,393.7994797,Benign
192.168.215.49,47576,13.228.37.108,443,21,7913,12,1419,9,6494,1293.03751,12.71198928,893.0152279,4086.850522,Benign
172.30.6.255,57854,103.243.221.51,80,34,21844,19,19418,15,2426,4225.132073,12.924993,12018.88465,1501.586887,Benign
172.30.6.255,58272,173.241.248.220,80,10,2493,6,1300,4,1193,5287.842983,36.265495,286.7739707,263.1702669,Benign
172.30.6.255,58083,103.243.221.51,80,22,10393,14,8266,8,2127,4857.242388,15.466518,4275.558338,1100.182989,Benign
192.168.43.224,38582,34.236.23.199,443,17,1874,10,1220,7,654,943.9464402,31.02206017,314.614824,168.6541761,Benign
10.0.2.15,58691,119.254.87.201,80,11,1582,6,705,5,877,9230.212693,1.410368,3998.956301,4974.588193,Malicious
10.0.2.15,52260,119.254.87.201,80,11,1513,6,705,5,808,6705.044644,0.831283,6784.693059,7775.931903,Malicious
192.168.43.233,51202,104.237.191.1,443,7,426,4,240,3,186,1236.149789,42.404177,45.27855829,35.09088267,Benign
10.0.2.15,48009,119.254.87.201,80,11,1579,6,705,5,874,16557.58708,1.245692,4527.603934,5612.944452,Malicious
192.168.215.49,54222,157.240.16.20,443,18,5378,10,1261,8,4117,118.2560214,24.05807086,419.3187417,1369.020824,Benign
172.30.6.255,56500,13.107.3.128,443,20,8862,9,1372,11,7490,822.498451,51.084719,214.8587722,1172.953501,Benign
172.30.6.255,56006,34.234.151.4,443,8,480,5,294,3,186,227.651273,11.221532,209.5970497,132.6022151,Benign
172.30.1.136,50377,172.217.167.2,443,9,534,5,294,4,240,689.696792,11.392545,206.4507974,168.5312632,Benign
10.0.2.15,58408,119.254.87.201,80,11,1582,6,705,5,877,24429.25814,1.111894,5072.425969,6309.954006,Malicious
10.0.2.15,54662,119.254.87.201,80,11,1582,6,705,5,877,5596.398704,1.417607,3978.535659,4949.185494,Malicious
10.0.2.15,44937,119.254.87.201,80,11,1513,6,705,5,808,1333.827156,0.8201,6877.210096,7881.965614,Malicious
172.30.15.226,49495,52.114.76.37,443,19,8523,10,3829,9,4694,43.194648,2.700261,11344.08859,13906.80382,Benign
10.0.2.15,32803,119.254.87.201,80,11,1593,6,705,5,888,10699.05138,1.223424,4610.012555,5806.654112,Malicious
172.30.15.2177,51489,172.217.166.202,443,19,4908,10,1351,9,3557,4255.380926,2.769904,3901.940284,10273.28023,Benign
172.30.1.136,50599,157.240.16.20,443,17,942,9,498,8,444,1600.646407,52.32257,76.14304878,67.88657361,Benign
192.168.43.224,36872,169.55.74.36,443,27,7891,14,3071,13,4820,1459.911439,1.116660169,22001.32205,34531.54422,Benign
172.30.6.255,55969,207.244.121.27,443,7,402,4,228,3,174,166.158028,6.907834,264.0480359,201.5103432,Benign
172.30.6.255,57198,192.168.56.1,7680,3,198,3,198,0,0,2078.536888,9.003561,175.9303902,0,Benign
172.30.6.255,56752,35.190.43.164,80,9,1573,5,1119,4,454,1244.369646,0.513735,17425.32629,7069.792792,Benign
192.168.215.49,52638,52.84.108.99,443,63,28395,29,3149,34,25246,1250.209633,224.6172674,112.1552243,899.1650659,Benign
192.168.137.97,37872,172.217.160.227,443,28,3480,15,2038,13,1442,1768.464666,45.94630465,354.8489944,251.0756869,Benign
192.168.43.233,51347,104.16.2.213,443,114,38476,53,6378,61,32098,3416.93381,432.820529,117.8871994,593.2805465,Benign
10.0.2.15,48327,119.254.87.201,80,11,1579,6,705,5,874,6857.567549,2.146873,2627.076683,3256.829817,Malicious
172.30.6.255,58137,157.240.16.17,443,1650,1502670,607,37889,1043,1464781,4915.998931,12.935201,23433.11094,905919.2818,Benign
172.30.6.255,57211,103.243.221.75,80,21,10671,10,4552,11,6119,2103.851656,27.172818,1340.162805,1801.506196,Benign
192.168.43.233,51632,52.230.7.59,443,60,17498,34,9715,26,7783,842.078536,1202.531972,64.63029825,51.77741752,Benign
172.30.6.255,57617,52.229.173.178,443,33,10999,19,2675,14,8324,3408.588191,101.888037,210.0344715,653.5801647,Benign
172.30.15.321,49587,180.149.59.76,443,17,5140,10,1351,7,3789,806.508623,3.669456,2945.395721,8260.625008,Benign
192.168.43.233,51293,117.18.237.70,443,5970,4579742,2677,171872,3293,4407870,2521.370636,404.411624,3399.941837,87195.71325,Benign
172.30.1.136,51788,54.88.180.215,443,34,12122,17,3537,17,8585,2977.301743,13.462734,2101.801907,5101.489787,Benign
192.168.137.97,60962,206.189.157.46,443,303,255008,124,10020,179,244988,418.663956,149.6786213,535.5474236,13094.08106,Benign
192.168.43.233,51167,74.125.103.103,443,9,534,5,294,4,240,484.076672,17.49881,134.4091398,109.7217468,Benign
172.30.6.255,58356,65.52.162.217,443,24,10205,14,2122,10,8083,5462.502522,1.534836,11060.46509,42130.88565,Benign
192.168.137.97,52902,52.84.108.11,443,23,8380,13,2134,10,6246,3706.972441,159.6353119,106.943757,313.0134518,Benign
192.168.215.49,59170,223.31.160.61,443,571,512235,209,24303,362,487932,279.7305159,13.1379639,14798.64015,297112.7057,Benign
10.0.2.15,60688,119.254.87.201,80,11,1579,6,705,5,874,5115.88056,1.837907,3068.708047,3804.327422,Malicious
10.0.2.15,34757,119.254.87.201,80,11,1579,6,705,5,874,26441.61713,2.022235,2788.993366,3457.56057,Malicious
10.0.2.15,33115,119.254.87.201,80,11,1513,6,705,5,808,20642.03243,6.159493,915.6597791,1049.437023,Malicious
192.168.137.97,36952,18.211.245.141,443,32,7365,17,2547,15,4818,22.65944893,63.59054145,320.4250119,606.1278788,Benign
172.30.6.255,57243,18.211.245.141,443,24,2873,12,1636,12,1237,2206.073739,61.4333,213.0440657,161.0852746,Benign
192.168.43.233,50947,54.77.120.226,443,23,7748,13,1417,10,6331,461.443105,28.841685,393.0422234,1756.069384,Benign
10.0.2.15,49648,119.254.87.201,80,11,1579,6,705,5,874,16857.89953,1.952209,2889.034934,3581.583734,Malicious
172.30.1.136,51836,52.84.110.227,443,389,122437,182,83756,207,38681,3320.537154,161.947377,4137.442745,1910.793529,Benign
172.30.15.2154,51466,52.42.237.125,443,6,348,4,228,2,120,4185.029693,2.656818,686.5355474,361.3344986,Benign
172.30.6.255,57673,103.243.221.75,80,22,12384,13,10282,9,2102,3584.660149,33.384076,2463.92921,503.7132075,Benign
172.30.6.255,57806,180.149.59.232,80,8,480,5,294,3,186,4042.086742,22.755744,103.3585191,65.39008349,Benign
10.0.2.15,42494,119.254.87.201,80,11,1579,6,705,5,874,23793.04274,1.117636,5046.365722,6256.061902,Malicious
10.0.2.15,58336,119.254.87.201,80,11,1579,6,705,5,874,11419.83894,1.7615,3201.816634,3969.344309,Malicious
192.168.215.49,57500,74.125.130.188,5228,100,7195,51,3432,49,3763,15.58727527,2097.308988,13.09106105,14.35363133,Benign
172.30.6.255,57180,157.240.16.39,443,28,5536,15,3430,13,2106,2009.100935,61.014553,449.7287721,276.1308437,Benign
10.0.2.15,51954,119.254.87.201,80,11,1582,6,705,5,877,25420.23306,1.223692,4609.002919,5733.468879,Malicious
172.30.6.255,55803,8.41.222.241,80,17,4253,8,1704,9,2549,90.846779,7.479597,1822.558087,2726.350096,Benign
192.168.42.240,50923,204.79.197.254,443,1,54,0,0,1,54,109.019,0,0,0,Benign
172.30.15.2201,51513,77.88.21.119,443,73,32326,39,24734,34,7592,4299.258593,19.699657,10044.43884,3083.099366,Benign
172.30.15.1639,50949,184.29.25.7,443,752,694221,271,62904,481,631317,3575.557535,31.480068,15985.73421,160435.994,Benign
172.30.6.255,58060,35.230.55.83,443,6,348,4,228,2,120,4820.979197,18.259072,99.89554781,52.57660411,Benign
10.0.2.15,59552,119.254.87.201,80,11,1579,6,705,5,874,4152.648152,1.906964,2957.580741,3666.561089,Malicious
172.30.6.255,58187,157.240.16.39,443,5,330,1,66,4,264,5059.089495,15.066141,35.0454705,140.181882,Benign
172.30.15.1620,50930,103.254.155.35,443,19,8643,10,1699,9,6944,3574.006229,3.164,4295.828066,17557.52212,Benign
10.0.2.15,41799,119.254.87.201,80,11,1513,6,705,5,808,1149.239417,1.890527,2983.295134,3419.152437,Malicious
172.30.15.633,49920,23.198.105.137,443,17,6013,9,1153,8,4860,2392.888824,3.21173,2871.972426,12105.62532,Benign
10.0.2.15,37040,119.254.87.201,80,11,1579,6,705,5,874,1900.136475,1.251816,4505.454476,5585.485407,Malicious
192.168.43.224,38210,140.98.193.112,443,20,6440,11,1377,9,5063,2279.838441,17.01154212,647.56034,2380.971679,Benign
172.30.15.1956,51268,34.205.118.138,443,6,348,4,228,2,120,4029.873503,7.588059,240.3776776,126.5145672,Benign
172.30.15.1349,50657,172.217.166.206,443,20,6750,10,1351,10,5399,3492.273661,4.688691,2305.120982,9211.95276,Benign
10.0.2.15,41728,119.254.87.201,80,11,1582,6,705,5,877,19954.37607,2.424941,2325.829783,2893.266269,Malicious
192.168.43.224,48474,35.171.73.174,443,37,7719,19,2715,18,5004,29.98479129,65.49353609,331.6357811,611.2358928,Benign
172.30.6.255,58058,172.217.166.194,443,16,4829,8,1219,8,3610,4820.664738,25.189072,387.1520158,1146.528939,Benign
172.30.6.255,57975,52.229.207.60,443,22,7505,11,1036,11,6469,4689.287702,3.46279,2393.445748,14945.17427,Benign
172.30.6.255,58022,104.122.91.146,80,7,402,4,228,3,174,4763.898906,9.990001,182.5825643,139.3393254,Benign
192.168.43.224,58548,52.24.249.177,443,17,1874,10,1220,7,654,97.17189762,13.61189055,717.0201642,384.3698258,Benign
172.30.15.852,50156,158.85.224.180,443,10,600,6,360,4,240,3354.009527,13.181926,218.4809716,145.6539811,Benign
172.30.6.255,56204,103.243.221.17,443,6,340,4,228,2,112,467.215331,23.822832,76.56520434,37.61097757,Benign
172.30.15.430,49704,18.204.234.216,443,6,348,4,228,2,120,1623.219147,7.479426,243.8689814,128.3520955,Benign
192.168.137.97,47800,151.101.193.176,443,11,766,7,478,4,288,380.0816287,19.76841802,193.4398593,116.5495387,Benign
10.0.2.15,51253,119.254.87.201,80,11,1582,6,705,5,877,4905.686109,1.918519,2939.767602,3656.987499,Malicious
172.30.15.2509,51843,14.139.45.128,80,10,1418,5,681,5,737,5475.952565,0.148747,36625.94876,39637.77421,Benign
192.168.43.224,45522,172.217.166.196,443,9,606,5,338,4,268,1249.282193,30.62388029,88.29710585,70.01072299,Benign
192.168.137.97,47476,157.240.16.39,443,1038,690108,476,102203,562,587905,133.1657658,190.3687311,4294.949047,24705.94815,Benign
10.0.2.15,36676,119.254.87.201,80,11,1582,6,705,5,877,16077.09378,2.221873,2538.398909,3157.696232,Malicious
10.0.2.15,37035,119.254.87.201,80,11,1582,6,705,5,877,19410.87092,2.0846,2705.555023,3365.633695,Malicious
172.30.15.2173,51485,52.84.108.186,443,43,12317,21,2435,22,9882,4248.358402,9.79266,1989.245006,8072.985277,Benign
192.168.215.49,38606,104.113.142.99,443,14,1703,7,1050,7,653,1252.691278,40.07579488,209.6028295,130.3529978,Benign
172.30.15.2215,51530,13.107.21.200,443,25,11614,12,1306,13,10308,4438.953916,8.534446,1224.215374,9662.490102,Benign
192.168.43.224,57944,174.129.238.218,443,543,450863,229,25331,314,425532,46.5158247,128.13642,1581.501965,26567.43493,Benign
172.30.6.255,57375,172.217.166.206,443,18,1837,11,1208,7,629,2620.406634,80.031892,120.7518623,62.87493491,Benign
172.30.6.255,56457,210.176.156.41,80,64,36502,33,26317,31,10185,708.858014,147.358102,1428.737186,552.938718,Benign
10.0.2.15,37229,119.254.87.201,80,11,1582,6,705,5,877,24939.83831,2.194515,2570.04395,3197.061765,Malicious
172.30.15.838,50141,34.232.42.95,443,18,4306,10,2655,8,1651,3230.438824,6.741381,3150.689747,1959.242476,Benign
192.168.137.97,33920,104.17.40.113,443,13,2053,8,1065,5,988,2435.838575,0.630009062,13523.615,12545.85128,Benign
172.30.6.255,57351,103.243.221.17,80,39,24304,22,20149,17,4155,2510.84005,17.190973,9376.54896,1933.572928,Benign
192.168.43.224,49986,52.0.177.159,443,82,29823,44,18591,38,11232,164.4336095,67.89903272,2190.428848,1323.376732,Benign
10.0.2.15,34231,119.254.87.201,80,11,1579,6,705,5,874,9172.224422,3.076369,1833.330137,2272.809276,Malicious
10.0.2.15,40346,119.254.87.201,80,12,1653,7,779,5,874,132.485588,4.318996,1442.92794,1618.894762,Malicious
192.168.137.97,44344,172.217.161.10,443,46,8630,23,3237,23,5393,8269.162559,255.7491997,101.2554488,168.69652,Benign
172.30.6.255,55681,195.201.82.80,80,38,33468,12,1084,26,32384,41.816283,16.943208,511.8275122,15290.61085,Benign
172.30.15.2066,51378,54.236.156.42,443,19,2842,10,1679,9,1163,4120.526594,7.072671,1899.141074,1315.486045,Benign
172.30.15.1741,51052,184.29.25.7,443,534,506716,179,12931,355,493785,3632.702694,4.324872,23919.32062,913386.5696,Benign
192.168.43.224,42018,23.251.156.28,443,102,61627,52,5453,50,56174,1288.132406,69.08330153,631.4695308,6505.074165,Benign
172.30.1.136,50508,104.113.230.86,443,13,762,9,510,4,252,966.230473,35.931655,113.5489028,56.10651666,Benign
10.0.2.15,54597,119.254.87.201,80,11,1582,6,705,5,877,2384.874712,1.627806,3464.786344,4310.095921,Malicious
192.168.43.233,51526,172.217.161.5,443,35,5589,17,2909,18,2680,4002.016363,54.97627,423.3099117,389.9864432,Benign
172.30.15.922,50228,184.29.24.49,443,27,14020,12,1870,15,12150,3440.209774,6.781453,2206.016911,14333.21148,Benign
172.30.6.255,57909,103.243.220.231,80,15,5482,9,4309,6,1173,4433.893778,13.168495,2617.763078,712.6099072,Benign
172.30.15.724,50011,157.240.16.39,443,21,3366,11,2097,10,1269,2415.33233,0.856703,19582.04885,11850.08107,Benign
172.30.6.255,56447,54.64.58.164,80,6,348,4,228,2,120,700.534891,10.390078,175.5520988,92.39584149,Benign
172.30.15.2527,51861,52.221.28.239,443,15,3533,8,1697,7,1836,5492.158149,5.788484,2345.346381,2537.451948,Benign
192.168.42.240,50994,172.217.163.67,443,54,9677,28,7673,26,2004,332.080811,39.113092,1569.397786,409.888331,Benign
172.30.6.255,58259,35.190.41.40,443,179,47707,77,12244,102,35463,5264.594656,59.401064,1648.994031,4776.076065,Benign
172.30.6.255,57475,103.243.220.231,80,16,5527,9,4299,7,1228,2991.857919,14.169654,2427.158772,693.3126243,Benign
172.30.1.136,50673,172.217.161.14,443,29,8432,14,1615,15,6817,1804.178873,130.459131,99.0348464,418.031299,Benign
192.168.43.224,60338,119.81.21.130,443,984,444826,438,46283,546,398543,36.76550721,1510.117879,245.1888062,2111.321271,Benign
192.168.137.97,51896,172.217.161.3,443,15,2175,8,1533,7,642,5227.735555,16.08105435,762.6365618,319.3820435,Benign
172.30.1.136,51547,52.84.110.227,443,9,546,7,414,2,132,711.152204,30.423324,108.8638441,34.71021115,Benign
10.0.2.15,57396,119.254.87.201,80,11,1579,6,705,5,874,24787.1505,2.025706,2784.214491,3451.636121,Malicious
172.30.15.1617,50927,161.202.1.35,443,19,6622,10,2582,9,4040,3573.953942,3.223841,6407.263882,10025.30832,Benign
192.168.43.233,51360,172.217.160.238,443,18,5758,9,1285,9,4473,3436.292252,28.535383,360.2544953,1254.022068,Benign
10.0.2.15,58217,119.254.87.201,80,11,1579,6,705,5,874,17548.65796,0.923646,6106.235506,7569.999762,Malicious
10.0.2.15,55691,119.254.87.201,80,11,1551,6,705,5,846,25147.57663,2.089871,2698.731166,3238.477399,Malicious
10.0.2.15,47668,119.254.87.201,80,11,1582,6,705,5,877,17186.15115,1.823048,3093.719968,3848.499875,Malicious
192.168.215.49,50364,117.18.237.29,80,18,3536,10,1430,8,2106,826.0071092,180.8206081,63.2671249,93.17522031,Benign
172.30.15.212,49488,162.125.82.3,443,23,6137,12,1530,11,4607,9.861609,1523.621084,8.033493451,24.18974139,Benign
192.168.137.97,39658,192.168.125.7,8380,183,128747,94,9170,89,119577,8302.612103,103.7417475,707.1405848,9221.128648,Benign
172.30.15.2113,51425,151.101.66.2,443,13,1479,6,904,7,575,4178.034147,9.595148,753.7142731,479.4089679,Benign
10.0.2.15,42074,119.254.87.201,80,11,1513,6,705,5,808,5418.356901,1.939416,2908.09192,3332.962088,Malicious
172.30.6.255,56325,152.163.13.4,80,20,2755,11,1421,9,1334,591.077615,265.285643,42.8519232,40.22833607,Benign
10.0.2.15,60736,119.254.87.201,80,11,1582,6,705,5,877,20104.5389,2.1895,2575.930578,3204.384563,Malicious
172.30.1.136,51531,172.217.161.3,443,9,535,5,295,4,240,300.42715,56.288267,41.9270325,34.11012814,Benign
192.168.43.233,51687,54.255.158.169,443,14,794,8,446,6,348,894.959619,125.774923,28.36813504,22.13477801,Benign
192.168.137.97,37486,172.217.160.227,443,2,120,1,66,1,54,24.50932321,0.451544836,1169.319097,956.715625,Benign
172.30.15.2220,51535,104.121.244.70,443,147,119236,62,13228,85,106008,4443.55098,14.270644,7415.502762,59427.17091,Benign
10.0.2.15,47965,119.254.87.201,80,11,1579,6,705,5,874,12535.7363,1.839814,3065.527276,3800.384169,Malicious
192.168.137.97,59898,216.58.196.202,443,34,2547,15,1050,19,1497,17.59732168,198.568348,42.30281454,60.31172701,Benign
192.168.43.233,51323,151.101.154.109,443,24,9634,13,1934,11,7700,3365.31675,12.775876,1211.032418,4821.587185,Benign
192.168.43.233,51044,104.237.191.1,443,7,426,4,240,3,186,868.433396,19.49379,98.49290466,76.33200111,Benign
192.168.137.97,57322,104.244.42.65,443,20,1324,10,668,10,656,289.857387,27.63192568,193.3994779,189.9252358,Benign
192.168.215.49,43696,52.33.0.53,443,21,8880,12,2638,9,6242,510.6639274,31.50392042,669.8848817,1585.072567,Benign
192.168.215.49,46092,52.46.128.194,443,28,8348,15,2007,13,6341,1292.767203,2.479813522,6474.680397,20456.37688,Benign
192.168.43.233,51644,52.84.110.12,443,9,534,5,294,4,240,842.987619,13.868211,169.5964966,138.4461197,Benign
10.0.2.15,34169,119.254.87.201,80,11,1582,6,705,5,877,14575.522,2.412198,2338.116523,2908.550625,Malicious
172.30.6.255,56412,103.243.221.75,80,44,29446,18,10810,26,18636,676.86356,21.188533,4081.452926,7036.258716,Benign
172.30.15.1995,51307,54.169.69.65,443,17,6427,9,1153,8,5274,4077.499504,4.749511,1942.09467,8883.440843,Benign
192.168.137.97,45532,185.199.108.153,80,30,5835,17,1531,13,4304,19.55561122,315.3438835,38.84013815,109.1887359,Benign
192.168.137.97,59492,103.243.221.87,443,27,8201,15,3355,12,4846,1767.492265,50.23425397,534.2967771,771.7443165,Benign
192.168.42.240,50959,13.35.130.15,443,11,1401,7,958,4,443,225.867681,45.884003,167.0298906,77.23824794,Benign
10.0.2.15,44015,119.254.87.201,80,11,1582,6,705,5,877,7520.502694,2.026025,2783.776113,3462.938513,Malicious
10.0.2.15,54410,119.254.87.201,80,11,1544,6,705,5,839,23435.59025,2.157011,2614.729364,3111.713385,Malicious
192.168.43.233,51683,54.172.100.225,443,7,402,4,228,3,174,894.860792,10.713534,170.2519449,129.9291158,Benign
172.30.6.255,58332,35.190.41.40,443,39,13827,19,3617,20,10210,5419.16603,10.14253,2852.937088,8053.217491,Benign
172.30.15.1771,51083,180.149.59.203,443,6853,6897334,2114,130478,4739,6766856,3641.408341,17.143038,60889.09095,3157832.818,Benign
172.30.6.255,57216,157.240.16.39,443,19,1933,10,1125,9,808,2131.088548,61.073963,147.3623056,105.8388826,Benign
10.0.2.15,54589,119.254.87.201,80,11,1582,6,705,5,877,10523.76297,1.224898,4604.465025,5727.823868,Malicious
172.30.15.265,49528,172.217.166.197,443,34,9701,17,4324,17,5377,101.98561,2.559284,13516.28033,16807.82594,Benign
10.0.2.15,56177,119.254.87.201,80,13,1661,8,853,5,808,7248.820461,10.20413,668.7488301,633.4689974,Malicious
172.30.6.255,57233,157.240.16.39,443,27,5467,15,3412,12,2055,2192.098696,61.054582,447.0753727,269.2672599,Benign
192.168.43.224,58622,174.129.238.218,443,25,8755,14,1563,11,7192,2449.35092,18.949977,659.8424896,3036.204213,Benign
10.0.2.15,54775,119.254.87.201,80,11,1579,6,705,5,874,18422.79888,1.799838,3133.615359,3884.794076,Malicious
10.0.2.15,44901,119.254.87.201,80,11,1582,6,705,5,877,13314.21662,3.695641,1526.122261,1898.452799,Malicious
10.0.2.15,43737,119.254.87.201,80,11,1579,6,705,5,874,1662.165295,2.610571,2160.446891,2678.341252,Malicious
192.168.43.233,51405,172.217.166.214,443,16,5034,8,1219,8,3815,3627.888481,18.531195,526.2477676,1646.952612,Benign
192.168.43.224,55194,52.35.44.197,443,7,486,5,346,2,140,94.48948439,12.44183935,222.4751439,90.01884434,Benign
172.30.6.255,56350,172.217.166.226,80,24,4351,12,1921,12,2430,607.828107,248.251616,61.90493439,78.30764735,Benign
172.30.15.2456,51790,14.139.45.128,80,10,1396,5,665,5,731,5420.866791,0.153138,34739.9078,38187.77834,Benign
192.168.43.233,50878,172.217.166.206,443,20,5949,10,1351,10,4598,35.448663,30.048812,359.681441,1224.141573,Benign
172.30.6.255,55966,52.76.187.108,443,6,340,4,228,2,112,166.157996,10.472706,174.1670204,85.55572934,Benign
172.30.6.255,56332,52.32.120.236,80,6,348,4,228,2,120,591.690186,14.444081,126.2801005,66.46321078,Benign
10.0.2.15,41086,119.254.87.201,80,11,1579,6,705,5,874,25808.37382,2.021902,2789.452703,3458.130018,Malicious
192.168.137.97,45514,108.177.12.94,443,5,346,3,206,2,140,1948.90753,10.74850011,153.3237181,104.2005851,Benign
172.30.6.255,57688,157.240.16.39,443,19,1933,10,1125,9,808,3656.088364,61.033851,147.4591534,105.9084409,Benign
192.168.137.97,57334,104.197.3.80,80,10,911,5,425,5,486,4223.81355,0.938310296,3623.534789,4143.618605,Benign
192.168.43.224,57528,172.217.166.196,443,4,280,3,206,1,74,10.85583242,4.51490182,365.0134744,131.1213452,Benign
10.0.2.15,51442,119.254.87.201,80,11,1582,6,705,5,877,6199.092013,1.817288,3103.525693,3860.697919,Malicious
192.168.42.240,50988,216.58.221.46,443,45,10006,22,8028,23,1978,323.176544,50.685639,1267.104475,312.1988854,Benign
172.30.15.221,49405,52.230.84.0,443,18,2150,12,1081,6,1069,25.051812,4631.089518,1.867379148,1.846649685,Benign
192.168.43.233,51340,157.240.16.39,443,8,457,5,283,3,174,3079.428685,58.637266,38.61025853,23.73916956,Benign
192.168.43.224,38198,205.185.216.42,443,35,11624,19,2897,16,8727,94.39170573,13.8070268,1678.565584,5056.555696,Benign
172.30.6.255,57799,69.173.144.142,80,6,348,4,228,2,120,4042.520938,22.506889,81.04185345,42.65360708,Benign
192.168.215.49,55682,159.153.113.136,443,49,28532,24,3966,25,24566,1496.66324,2.742690391,11568.20329,71655.18961,Benign
172.30.15.1141,50449,104.18.255.119,443,16,5869,9,1091,7,4778,3458.310906,8.634796,1010.794001,4426.740365,Benign
10.0.2.15,36052,119.254.87.201,80,11,1582,6,705,5,877,24306.54899,2.220357,2540.13206,3159.852222,Malicious
192.168.215.49,57588,52.84.110.171,443,302,120382,143,32470,159,87912,2093.753088,4.670889871,55612.52934,150570.024,Benign
10.0.2.15,33290,119.254.87.201,80,11,1579,6,705,5,874,16194.98604,2.322411,2428.510716,3010.664348,Malicious
172.30.6.255,56328,52.32.120.236,80,12,2008,7,1028,5,980,591.605078,41.091837,200.1370735,190.7921517,Benign
172.30.6.255,56112,157.240.16.20,443,47,19136,19,2268,28,16868,313.021661,66.073227,274.6044173,2042.340084,Benign
10.0.2.15,45503,119.254.87.201,80,11,1579,6,705,5,874,6409.293737,2.142323,2632.656233,3263.746877,Malicious
192.168.137.97,59942,151.101.192.223,443,596,423976,267,27348,329,396628,2386.798185,191.8330329,1140.491795,16540.55066,Benign
172.30.6.255,56935,151.101.2.49,80,11,2569,6,1902,5,667,1387.640747,0.621371,24487.78588,8587.462241,Benign
10.0.2.15,58441,119.254.87.201,80,11,1513,6,705,5,808,25510.31862,5.054308,1115.87976,1278.909002,Malicious
172.30.15.2071,51383,54.85.199.48,443,24,5974,13,1819,11,4155,4122.405067,5.194566,2801.38899,6398.994642,Benign
172.30.6.255,58306,35.190.43.164,80,6,348,4,228,2,120,5353.834324,5.154141,353.8902021,186.2580011,Benign
10.0.2.15,53920,119.254.87.201,80,11,1513,6,705,5,808,4693.259489,1.819069,3100.487117,3553.466086,Malicious
10.0.2.15,33510,119.254.87.201,80,11,1582,6,705,5,877,5353.858854,1.811915,3112.728798,3872.14632,Malicious
172.30.15.1543,50851,180.179.41.214,443,17,4022,9,2863,8,1159,3536.236514,0.253919,90201.99355,36515.58174,Benign
172.30.6.255,56765,23.198.126.238,443,17,6656,8,1327,9,5329,1244.684752,0.796793,13323.41022,53504.48611,Benign
10.0.2.15,37734,119.254.87.201,80,11,1579,6,705,5,874,22741.96165,0.985545,5722.721946,7094.551745,Malicious
172.30.15.211,49411,162.125.82.3,443,1,54,1,54,0,0,9.752845,0,0,0,Benign
172.30.15.1722,51033,184.29.25.7,443,38,23126,17,7803,21,15323,3619.400817,7.680826,8127.250897,15959.74183,Benign
172.30.6.255,57176,172.217.166.206,80,10,886,6,542,4,344,2008.484119,60.330788,71.87043537,45.61518407,Benign
172.30.1.136,50361,104.244.42.131,443,53,11189,30,4317,23,6872,650.354229,175.277955,197.0356169,313.650396,Benign
192.168.137.97,56018,172.217.161.14,443,14,960,7,494,7,466,88.70682443,14.39394556,274.5598823,258.9977838,Benign
172.30.6.255,56697,173.241.248.220,80,6,535,4,228,2,307,1156.105508,13.482582,135.2856597,182.160954,Benign
172.30.15.1406,50714,13.231.12.16,443,19,7651,10,1744,9,5907,3499.973686,6.989496,1996.138205,6761.00251,Benign
172.30.15.1317,50625,104.244.43.48,443,24,6899,13,1791,11,5108,3488.016911,9.12367,1570.420675,4478.89939,Benign
10.0.2.15,60428,119.254.87.201,80,11,1582,6,705,5,877,21390.39157,2.220512,2539.954749,3159.631653,Malicious
172.30.1.136,50646,157.240.16.20,443,22,5944,10,1778,12,4166,1746.387818,3.553808,4002.467213,9378.109341,Benign
172.30.1.136,50157,184.29.24.99,80,33,5347,20,2263,13,3084,147.400034,21.525329,841.0556698,1146.184572,Benign
192.168.43.233,50965,182.50.136.239,80,14,3211,7,622,7,2589,484.542379,4.721527,1053.896335,4386.716416,Benign
172.30.15.950,50256,117.18.237.29,80,15,3676,9,976,6,2700,3441.409729,109.969554,71.0014701,196.4180013,Benign
10.0.2.15,48324,119.254.87.201,80,11,1513,6,705,5,808,3914.660506,1.490269,3784.551648,4337.47196,Malicious
172.30.6.255,57856,103.243.221.109,80,24,11936,14,7396,10,4540,4225.223012,12.834055,4610.234256,2829.97073,Benign
192.168.43.224,52248,54.87.224.116,443,81,13267,44,5596,37,7671,387.2548567,310.5841267,144.1413007,197.5889774,Benign
172.30.15.1304,50612,23.8.189.227,443,17,5384,8,1099,9,4285,3485.814931,0.265175,33155.46337,129273.1215,Benign
172.30.6.255,56588,13.107.21.200,443,28,10028,14,1891,14,8137,901.259083,105.40425,143.5236245,617.5842056,Benign
192.168.137.97,59356,157.240.16.20,443,22,5596,12,1381,10,4215,466.7454784,101.5972514,108.7430993,331.8987428,Benign
172.30.15.805,50097,34.200.202.18,443,17,4237,10,2633,7,1604,2695.865999,10.635205,1980.591817,1206.558783,Benign
10.0.2.15,57703,119.254.87.201,80,11,1582,6,705,5,877,11662.53457,3.891568,1449.28728,1802.872261,Malicious
172.30.6.255,58139,157.240.16.20,443,6,348,4,228,2,120,4918.980893,9.951714,183.28501,96.46579474,Benign
10.0.2.15,57258,119.254.87.201,80,11,1579,6,705,5,874,14215.12102,1.420802,3969.589007,4921.164244,Malicious
10.0.2.15,55996,119.254.87.201,80,11,1582,6,705,5,877,1513.972043,1.677355,3362.436693,4182.775858,Malicious
192.168.137.97,47064,104.19.197.151,443,74,29786,38,3214,36,26572,2938.816671,141.978985,181.0972236,1497.235664,Benign
192.168.43.224,57952,174.129.238.218,443,1624,1324651,716,61477,908,1263174,46.76603538,127.8861741,3845.732373,79018.64348,Benign
10.0.2.15,57214,119.254.87.201,80,11,1579,6,705,5,874,16137.15056,0.822522,6856.959449,8500.68448,Malicious
192.168.137.97,48934,172.217.166.234,443,23,5158,12,1410,11,3748,420.537963,170.5374,66.14384878,175.8206704,Benign
10.0.2.15,52197,119.254.87.201,80,11,1582,6,705,5,877,4757.574197,1.283861,4392.998931,5464.766046,Malicious
172.30.15.1950,51262,52.84.108.203,443,40,11337,18,2611,22,8726,4028.530903,8.704743,2399.611338,8019.536016,Benign
192.168.137.97,47188,157.240.16.20,443,22,5537,13,1419,9,4118,219.9830719,3.877157642,2927.918091,8496.946228,Benign
172.30.15.1841,51153,104.16.124.127,443,45,11194,23,2919,22,8275,3868.446917,8.738659,2672.263559,7575.533042,Benign
192.168.43.224,44564,151.101.66.217,443,21,8710,12,1503,9,7207,2406.316243,11.94111077,1006.941501,4828.361542,Benign
10.0.2.15,56634,119.254.87.201,80,11,1513,6,705,5,808,3854.550915,1.477399,3817.519844,4375.256786,Malicious
172.30.6.255,55715,173.241.248.143,80,9,1442,6,950,3,492,57.243842,1.489642,5101.896966,2642.245587,Benign
192.168.43.224,52248,192.0.73.2,443,46,18579,24,3103,22,15476,1903.252567,11.45807175,2166.507641,10805.30849,Benign
10.0.2.15,55249,119.254.87.201,80,11,1579,6,705,5,874,20189.05131,3.271468,1723.996689,2137.266817,Malicious
172.30.15.1723,51034,184.29.25.7,443,44,28054,20,4120,24,23934,3619.45241,7.584458,4345.729121,25245.31087,Benign
192.168.43.224,40948,54.85.227.48,443,9,598,5,338,4,260,27.14065403,15.6593203,172.6767158,132.8282429,Benign
10.0.2.15,47618,119.254.87.201,80,11,1579,6,705,5,874,25895.54194,1.230805,4582.366825,5680.834901,Malicious
192.168.43.224,38918,54.77.4.53,443,54,6006,28,3207,26,2799,1430.252582,176.2749988,145.5453138,127.0287911,Benign
172.30.15.1692,51003,184.29.25.7,443,73,55956,32,14284,41,41672,3609.548574,7.579467,15076.52187,43984.09545,Benign
192.168.43.224,49036,157.240.16.39,443,6,412,4,272,2,140,34.7911646,10.88331109,199.9391529,102.9098581,Benign
10.0.2.15,50114,119.254.87.201,80,11,1582,6,705,5,877,20639.48523,1.49855,3763.638184,4681.85913,Malicious
172.30.1.136,50800,172.217.161.14,443,1,66,1,66,0,0,1935.327243,0,0,0,Benign
10.0.2.15,59969,119.254.87.201,80,11,1579,6,705,5,874,24456.70377,1.099906,5127.710913,6356.906863,Malicious
192.168.215.49,43500,52.84.110.226,443,37,9748,19,2353,18,7395,478.7970339,180.0611725,104.5422494,328.5550081,Benign
172.30.6.255,57333,52.213.19.114,443,18,6378,9,1141,9,5237,2468.839279,42.765379,213.443683,979.6709623,Benign
192.168.42.240,50968,172.217.166.234,443,80,13537,37,6659,43,6878,280.297168,328.073226,162.3783832,167.7186544,Benign
172.30.6.255,57860,67.231.251.189,80,6,348,4,228,2,120,4226.045066,12.048213,151.3917458,79.67986622,Benign
10.0.2.15,55656,119.254.87.201,80,11,1579,6,705,5,874,19500.93723,1.246341,4525.246301,5610.021655,Malicious
192.168.215.49,50204,152.195.61.54,443,975,631915,346,30834,629,601081,788.5342521,181.6084876,1358.262509,26478.10168,Benign
10.0.2.15,38472,119.254.87.201,80,11,1582,6,705,5,877,10608.99339,0.948556,5945.879843,7396.505847,Malicious
172.30.6.255,56951,52.77.109.174,443,6,340,4,228,2,112,1389.369565,15.071287,121.0248335,59.45079541,Benign
192.168.43.224,54252,23.60.211.179,443,43,7513,24,5268,19,2245,962.7424349,584.1359526,72.14758792,30.74626706,Benign
10.0.2.15,57983,119.254.87.201,80,11,1579,6,705,5,874,21240.2034,1.120191,5034.855663,6241.792694,Malicious
172.30.6.255,57807,52.213.19.114,443,18,6390,9,1153,9,5237,4042.780961,23.072293,399.7868786,1815.857661,Benign
172.30.15.2523,51857,104.19.199.151,443,7,402,4,228,3,174,5489.040234,8.844466,206.2306532,157.3865511,Benign
172.30.15.2343,51677,139.59.82.147,443,18,6891,10,1174,8,5717,5311.051504,6.716208,1398.408149,6809.795051,Benign
172.30.15.1391,50699,50.31.185.52,443,6,348,4,228,2,120,3496.196499,1.163577,1567.579971,825.04209,Benign
192.168.43.233,51287,104.244.42.3,443,79,8330,40,4273,39,4057,2475.055574,796.972883,42.89230001,40.72409575,Benign
172.30.15.2014,51326,52.7.89.176,443,23,6736,12,2586,11,4150,4089.278167,8.338309,2481.078598,3981.622653,Benign
10.0.2.15,46491,119.254.87.201,80,11,1582,6,705,5,877,20194.62902,3.248481,1736.196087,2159.778678,Malicious
192.168.137.97,36308,74.125.200.188,443,9,610,5,350,4,260,19.65483021,58.43754207,47.91440401,35.59355726,Benign
172.30.15.822,50121,172.217.166.196,443,19,3351,10,1478,9,1873,3102.163388,1.188345,9949.972441,12609.13287,Benign
192.168.43.233,50977,49.44.170.2,443,792,611069,336,54314,456,556755,502.151714,658.74664,659.6041234,6761.385531,Benign
172.30.6.255,58040,157.240.16.39,443,29,6382,16,4237,13,2145,4815.094978,61.045916,555.2541795,281.0998855,Benign
172.30.6.255,57072,35.190.43.164,80,180,52151,92,38465,88,13686,1679.901801,1030.009386,298.7545591,106.2980605,Benign
192.168.43.224,59334,140.98.193.112,443,70,49361,31,5580,39,43781,49.88028526,7.836826697,5696.183127,44692.57948,Benign
192.168.137.97,39600,104.17.39.113,443,32,8200,18,2440,14,5760,3037.551014,43.19122351,451.9436685,1066.883414,Benign
192.168.137.97,44036,172.217.161.10,443,54,11637,27,3625,27,8012,3876.119043,253.7897419,114.2678178,252.555519,Benign
172.30.1.136,50560,52.84.103.186,443,14,864,7,426,7,438,1473.437828,26.20408,130.0560829,133.7196345,Benign
10.0.2.15,48881,219.234.85.238,80,11,1344,6,792,5,552,17.889524,3.878653,1633.556804,1138.539591,Malicious
10.0.2.15,43745,119.254.87.201,80,11,1582,6,705,5,877,14095.02752,1.818494,3101.467478,3858.137558,Malicious
192.168.43.233,51439,192.0.73.2,443,7,402,4,228,3,174,3801.507767,15.223038,119.8183963,91.44035507,Benign
192.168.43.233,50845,52.230.3.194,443,17,2467,13,1453,4,1014,284.416738,57.943681,200.6085875,139.9980094,Benign
192.168.43.224,58348,104.197.3.80,80,17,1484,9,788,8,696,23.81396685,4.898841265,1286.834919,1136.595309,Benign
172.30.15.703,49990,173.241.248.143,443,6,348,4,228,2,120,2403.255422,3.112155,586.0890605,308.4679266,Benign
192.168.43.224,44586,192.168.121.2,443,7,518,7,518,0,0,2461.522621,64.80168591,63.94895351,0,Benign
172.30.6.255,58165,157.240.16.17,443,6,348,4,228,2,120,4965.081759,45.645369,39.96024219,21.03170641,Benign
10.0.2.15,36923,119.254.87.201,80,11,1579,6,705,5,874,15148.864,2.054374,2745.361847,3403.469865,Malicious
10.0.2.15,49817,119.254.87.201,80,11,1593,6,705,5,888,1449.588283,0.82264,6855.975883,8635.612175,Malicious
192.168.215.49,50114,217.12.15.83,443,22,8795,12,2203,10,6592,480.155545,28.65947414,614.9449886,1840.089589,Benign
172.30.6.255,56246,103.243.221.46,80,14,4500,10,3434,4,1066,528.111997,38.827363,707.5422557,219.638918,Benign
172.30.15.1901,51213,54.86.233.56,443,6,348,4,228,2,120,3983.861385,3.606054,505.8160527,266.2189751,Benign
10.0.2.15,34547,119.254.87.201,80,12,1656,7,779,5,877,20732.14996,5.046021,1235.032514,1390.402458,Malicious
172.30.6.255,57520,157.240.16.39,443,19,1933,10,1125,9,808,3107.082258,61.046981,147.4274379,105.8856621,Benign
172.30.6.255,57810,52.213.19.114,443,20,6624,10,1321,10,5303,4042.865395,22.987594,459.7262332,1845.517195,Benign
192.168.43.224,51294,74.125.130.188,5228,12,820,7,494,5,326,6.00052849,103.7498388,38.09162547,25.13738847,Benign
172.30.6.255,55988,207.244.121.27,80,7,402,4,228,3,174,183.508026,2.58737,704.9629547,537.9980443,Benign
172.30.6.255,55865,54.169.196.206,443,6,348,4,228,2,120,105.107078,10.287744,177.2983465,93.31491919,Benign
172.30.15.2272,51591,87.250.251.119,443,20,5968,12,4580,8,1388,4532.008697,5.905625,6204.254418,1880.241295,Benign
192.168.43.224,49828,34.205.118.138,443,33,8620,16,2817,17,5803,366.8015505,13.3664781,1686.008823,3473.166205,Benign
172.30.15.216,49417,40.90.136.20,443,3,162,2,108,1,54,15.11407,0.281307,3071.377534,1535.688767,Benign
10.0.2.15,42093,119.254.87.201,80,11,1579,6,705,5,874,11422.38041,1.616126,3489.826907,4326.395343,Malicious
172.30.1.136,51777,35.241.16.233,443,9,534,5,294,4,240,2974.166946,40.26181,58.41764193,47.68787096,Benign
10.0.2.15,55031,119.254.87.201,80,11,1579,6,705,5,874,2921.396586,1.620334,3480.763843,4315.159714,Malicious
10.0.2.15,48664,119.254.87.201,80,11,1534,6,705,5,829,11059.40237,1.912854,2948.473851,3467.07067,Malicious
192.168.43.224,59398,74.125.24.188,5228,4,280,3,206,1,74,6.007356805,9.362877558,176.0142638,63.22842484,Benign
10.0.2.15,40817,119.254.87.201,80,11,1582,6,705,5,877,1059.145144,1.82282,3094.106933,3848.981249,Malicious
172.30.6.255,56519,23.198.119.247,443,22,9439,12,1354,10,8085,831.968134,41.617003,260.2782329,1554.172462,Benign
192.168.137.97,56336,52.205.114.175,443,7,478,4,272,3,206,1766.932201,51.18523722,42.51225779,32.19678348,Benign
192.168.137.97,46918,157.240.16.16,443,6,412,4,272,2,140,139.5826318,15.82022623,137.5454414,70.79544778,Benign
172.30.6.255,55898,184.84.52.113,80,122,99588,42,6922,80,92666,115.902286,295.813891,187.1987817,2506.062165,Benign
10.0.2.15,33220,119.254.87.201,80,11,1579,6,705,5,874,368.583166,1.448804,3892.866116,4826.049624,Malicious
192.168.43.233,51181,52.229.174.172,443,27,9242,14,1375,13,7867,634.397604,1.952423,5634.025004,32234.81797,Benign
172.30.15.823,50122,172.217.166.196,443,19,3303,10,1478,9,1825,3102.163886,1.187717,9955.233444,12292.49055,Benign
10.0.2.15,37853,119.254.87.201,80,11,1579,6,705,5,874,26108.71792,1.220783,4619.985698,5727.471631,Malicious
10.0.2.15,56115,119.254.87.201,80,12,1653,7,779,5,874,22381.54664,4.523335,1377.744518,1545.762142,Malicious
172.30.6.255,58361,172.217.166.206,443,17,1779,10,1150,7,629,5464.400156,95.799467,96.03393722,52.52638827,Benign
172.30.1.136,50140,172.217.161.14,443,9,534,5,294,4,240,114.920345,17.263303,136.2427573,111.2185773,Benign
192.168.137.97,47564,192.147.130.204,80,11,1434,6,541,5,893,4108.619734,16.62569732,260.3199082,429.6962625,Benign
192.168.43.233,51332,104.16.164.13,443,9,534,5,294,4,240,3368.974621,15.045988,156.3207414,127.6087685,Benign
192.168.43.224,33428,172.217.161.3,443,19,6017,10,1443,9,4574,126.4947931,22.86070671,504.9712657,1600.650429,Benign
10.0.2.15,40962,119.254.87.201,80,11,1582,6,705,5,877,24123.43819,1.35571,4160.18175,5175.148077,Malicious
10.0.2.15,45251,119.254.87.201,80,11,1579,6,705,5,874,5293.776452,1.760006,3204.53453,3972.713729,Malicious
172.30.15.1863,51175,52.6.46.142,443,23,4414,13,2949,10,1465,3923.328729,4.122135,5723.247783,2843.186844,Benign
172.30.6.255,58052,143.204.192.51,80,20,12776,8,1915,12,10861,4819.920253,52.746297,290.4469294,1647.281514,Benign
192.168.43.233,51049,162.212.45.11,443,35,11463,19,2059,16,9404,888.496466,113.830647,144.7061967,660.9116436,Benign
172.30.15.1160,50468,103.243.220.231,80,11,2960,7,1945,4,1015,3460.524682,7.106644,2189.500417,1142.592762,Benign
10.0.2.15,39019,119.254.87.201,80,12,1656,7,779,5,877,13974.8874,15.939188,390.9860402,440.1729875,Malicious
192.168.43.233,51356,52.216.18.144,443,379,307612,155,10102,224,297510,3436.257719,34.196643,2363.27291,69599.81423,Benign
192.168.137.97,50640,192.168.121.7,443,25,8890,13,2679,12,6211,2934.997012,7.339582123,2920.057251,6769.867707,Benign
10.0.2.15,56276,119.254.87.201,80,12,1656,7,779,5,877,9710.734283,4.42891,1407.11823,1584.136955,Malicious
10.0.2.15,60514,119.254.87.201,80,11,1579,6,705,5,874,7460.421996,2.021239,2790.36769,3459.264342,Malicious
172.30.1.136,51799,54.88.180.215,443,7,402,4,228,3,174,2977.408386,37.010344,49.28351922,37.61110678,Benign
192.168.137.97,35200,172.217.161.1,443,15,1053,7,462,8,591,44.16005516,192.3633453,19.21363965,24.57848709,Benign
192.168.43.224,48144,104.244.42.200,443,23,6250,13,1521,10,4729,304.4035142,31.48184067,386.5085314,1201.708642,Benign
192.168.137.97,44848,103.102.166.224,443,14,984,8,536,6,448,19.69633554,16.19018634,264.8518004,221.368669,Benign
10.0.2.15,59930,119.254.87.201,80,12,1587,7,779,5,808,18389.73434,7.215798,863.6605404,895.8122165,Malicious
172.30.15.2065,51377,157.240.16.39,443,24,4148,13,2825,11,1323,4113.355086,3.987954,5667.06637,2653.992498,Benign
172.30.6.255,56459,157.240.16.39,443,27,5488,15,3434,12,2054,728.102079,61.054536,449.9583782,269.1364324,Benign
192.168.137.97,43504,157.240.16.39,443,34,17038,20,15605,14,1433,3079.414263,1.291186636,96686.25474,8878.654472,Benign
192.168.43.224,42246,23.251.156.28,443,11,742,6,404,5,338,2442.286075,17.97543221,179.8009618,150.4275373,Benign
172.30.10.168,62078,172.30.6.255,56740,3,198,0,0,3,198,1224.735378,9.009177,0,175.8207215,Benign
172.30.15.2010,51322,52.84.110.163,443,30,8921,15,1935,15,6986,4085.515883,2.13803,7240.310005,26139.95126,Benign
192.168.43.233,51661,130.211.21.54,443,9,510,5,282,4,228,868.349317,26.611541,84.77524845,68.54169024,Benign
172.30.15.480,49755,172.217.166.196,443,22,5616,11,1374,11,4242,1730.05711,1.45205,7569.987259,23371.09604,Benign
10.0.2.15,50034,119.254.87.201,80,11,1579,6,705,5,874,21510.56357,1.092259,5163.610462,6401.412119,Malicious
172.30.6.255,58437,103.243.221.51,80,14,7073,10,5292,4,1781,5616.846627,2.38054,17784.20022,5985.196636,Benign
172.30.15.2198,51510,52.114.6.46,443,29,11951,16,6964,13,4987,4290.31646,2.192661,25408.39646,18195.24313,Benign
10.0.2.15,54577,119.254.87.201,80,11,1579,6,705,5,874,8176.536679,2.01714,2796.037955,3466.293862,Malicious
192.168.43.224,36038,52.206.154.207,443,7,478,4,272,3,206,53.66221316,13.3221611,163.3368628,123.7036535,Benign
172.30.6.255,56566,103.243.221.87,80,91,63992,54,55538,37,8454,887.893706,63.900513,6953.058421,1058.395259,Benign
172.30.6.255,56429,52.212.134.173,80,11,1658,6,850,5,808,678.979292,68.067184,99.90129752,94.96499811,Benign
172.30.15.1355,50663,35.189.131.178,443,6,348,4,228,2,120,3492.475159,4.651264,392.1514668,206.3955088,Benign
192.168.137.97,34596,172.217.161.3,443,9,606,5,338,4,268,367.7351183,55.61735425,48.61791857,38.54911886,Benign
192.168.43.233,51413,23.100.69.251,443,21,8353,10,1581,11,6772,3647.787738,129.686981,97.52713728,417.7443224,Benign
172.30.15.1402,50710,104.24.246.16,443,14,2727,8,1607,6,1120,3499.832139,7.181048,1790.267939,1247.728744,Benign
172.30.6.255,56764,23.198.126.238,443,17,6654,8,1326,9,5328,1244.684666,0.80246,13219.3505,53116.66625,Benign
172.30.1.136,50620,52.30.87.88,443,10,660,3,198,7,462,1629.583176,23.822521,66.49170338,155.1473079,Benign
10.0.2.15,40659,119.254.87.201,80,11,1582,6,705,5,877,17942.21351,1.121134,5030.620782,6257.94954,Malicious
10.0.2.15,55616,119.254.87.201,80,11,1579,6,705,5,874,7608.473257,2.012423,2802.591702,3474.418649,Malicious
10.0.2.2,49202,10.0.2.15,5555,7,574,4,284,3,290,0,0.201344,11284.17038,11522.56834,Malicious
172.30.1.136,51525,13.107.21.200,443,43,13398,24,4250,19,9148,62.085422,8.917561,3812.701702,8206.728275,Benign
192.168.215.49,44240,172.217.161.5,443,49,6279,24,3064,25,3215,79.37830028,240.1798447,102.0568568,107.0864212,Benign
172.30.1.136,50828,172.217.161.14,443,7,426,4,240,3,186,1980.864667,10.700455,179.4316223,139.0595073,Benign
172.30.1.136,50803,172.217.161.14,443,3,198,3,198,0,0,1938.608961,9.001102,175.9784524,0,Benign
192.168.42.240,51037,172.217.166.206,443,11,1502,6,926,5,576,608.434883,1.444508,5128.389735,3190.013486,Benign
10.0.2.15,41028,119.254.87.201,80,11,1560,6,705,5,855,4635.420843,1.286346,4384.51241,5317.38739,Malicious
10.0.2.15,49621,119.254.87.201,80,11,1582,6,705,5,877,7515.767223,2.095327,2691.703968,3348.403376,Malicious
172.30.15.203,49483,172.217.166.197,443,198,70778,87,23375,111,47403,4.190212,10.232347,18275.3771,37061.292,Benign
172.30.6.255,57703,210.176.156.21,80,11,615,10,553,1,62,3679.795281,81.474764,54.29902196,6.087774615,Benign
192.168.137.97,46284,172.217.161.14,443,45,8763,24,5938,21,2825,26.6432497,240.5854251,197.4516951,93.93752755,Benign
172.30.1.136,50482,172.217.161.3,443,32,1752,15,822,17,930,922.696666,31.998659,205.5086121,232.5097436,Benign
10.0.2.15,52516,119.254.87.201,80,11,1579,6,705,5,874,11722.623,1.155457,4881.18554,6051.285336,Malicious
10.0.2.15,42084,119.254.87.201,80,11,1513,6,705,5,808,16978.05128,1.41809,3977.180574,4558.243835,Malicious
10.0.2.15,33761,119.254.87.201,80,11,1585,6,705,5,880,6614.9523,1.148529,4910.629161,6129.579662,Malicious
172.30.15.1766,51078,157.240.16.20,443,32,6992,16,2067,16,4925,3640.734606,6.515635,2537.895385,6046.993117,Benign
192.168.43.233,51342,139.59.72.43,443,336,283228,130,16324,206,266904,3080.753049,191.410676,682.2607951,11155.23985,Benign
10.0.2.15,32866,119.254.87.201,80,11,1579,6,705,5,874,10311.2004,1.223498,4609.733731,5714.7621,Malicious
10.0.2.15,59358,119.254.87.201,80,11,1582,6,705,5,877,19651.19702,1.426086,3954.880701,4919.759397,Malicious
172.30.1.136,50302,52.213.11.166,443,145,37477,71,16505,74,20972,512.054493,119.676995,1103.303103,1401.906858,Benign
192.168.215.49,32796,52.3.188.193,443,27,3713,14,2340,13,1373,620.4040447,5.680322409,3295.587583,1933.693056,Benign
172.30.15.2391,51725,14.139.45.128,80,39,25824,18,1472,21,24352,5339.496748,0.465485,25298.34474,418522.6162,Benign
172.30.15.2092,51404,52.204.146.6,443,29,8638,16,4311,13,4327,4141.036891,6.662043,5176.790363,5196.003688,Benign
172.30.1.136,50181,172.217.161.3,443,22,2950,11,1988,11,962,356.839986,19.215956,827.6455254,400.5005007,Benign
192.168.43.233,51080,172.217.160.227,443,16,980,8,437,8,543,10.574725,196.643128,17.77839905,22.0907796,Benign
172.30.1.136,51529,52.84.110.12,443,42,8443,21,1831,21,6612,200.395338,273.471819,53.56310589,193.423952,Benign
172.30.6.255,56971,115.114.126.213,443,16,6856,9,1141,7,5715,1421.001275,14.994332,608.7633647,3049.152173,Benign
172.30.15.2322,51652,52.84.108.208,443,12,1931,7,1481,5,450,5042.113127,5.563012,2129.781492,647.1314461,Benign
172.30.6.255,57793,103.243.221.46,80,46,35096,16,5588,30,29508,4041.849887,23.217014,1925.484474,10167.7158,Benign
10.0.2.15,57630,119.254.87.201,80,11,1582,6,705,5,877,9410.418678,1.149409,4906.86953,6104.006494,Malicious
172.30.15.668,49955,104.27.177.100,80,7,402,4,228,3,174,2397.169437,9.104391,200.3428895,152.8932578,Benign
192.168.43.224,36200,52.20.114.147,443,6,412,4,272,2,140,57.36982641,14.98545686,145.2074515,74.73912943,Benign
10.0.2.15,38898,119.254.87.201,80,11,1534,6,705,5,829,2953.743573,0.822985,6853.101818,8058.470081,Malicious
10.0.2.15,55552,119.254.87.201,80,11,1513,6,705,5,808,24158.89504,5.070604,1112.293526,1274.798821,Malicious
172.30.6.255,57008,54.194.27.245,443,12,1416,6,904,6,512,1498.473714,25.196379,287.0253698,162.5630413,Benign
192.168.43.233,51510,13.107.21.200,443,34,13040,19,2483,15,10557,3898.313959,130.041264,152.7515143,649.4553913,Benign
192.168.137.97,35698,161.202.24.167,443,2852,1527241,1541,127758,1311,1399483,349.6788925,2731.175937,374.2212232,4099.283333,Benign
172.30.1.136,50611,157.240.16.20,443,44,12293,24,4165,20,8128,1614.933744,71.964153,463.008298,903.5609715,Benign
192.168.43.224,35402,151.101.65.69,443,22,7174,12,2032,10,5142,1202.775752,11.24176906,1446.035754,3659.210555,Benign
172.30.15.728,50015,104.31.90.207,80,17,4890,10,3588,7,1302,2431.139522,5.091602,5637.518408,2045.721563,Benign
192.168.42.240,51025,54.239.25.128,443,2,128,1,66,1,62,495.067354,0.709586,744.0958531,698.9991347,Benign
172.30.6.255,56918,103.71.26.125,80,8,464,5,294,3,170,1386.065115,18.372585,128.0168251,74.02333422,Benign
172.30.6.255,56810,172.30.20.1,139,6,360,3,198,3,162,1273.531876,1.115707,1419.727581,1161.595293,Benign
192.168.137.97,33204,119.81.209.174,443,1897,869977,797,83242,1100,786735,2.841016492,1987.132099,335.1241724,3167.31837,Benign
172.30.15.291,49554,172.217.166.197,443,34,9144,17,3783,17,5361,465.667534,4.166689,7263.321069,10293.06483,Benign
192.168.43.233,51164,103.243.221.51,443,17,3495,9,2018,8,1477,952.115664,56.571797,285.3718789,208.8673266,Benign
10.0.2.15,39856,115.182.31.2,80,10,1663,5,658,5,1005,243.542,0.868647,6059.999056,9255.773634,Malicious
192.168.137.97,49268,157.240.16.52,443,66,26245,32,3368,34,22877,4025.125099,100.6497474,267.700622,1818.345348,Benign
172.30.15.286,49549,192.0.72.17,443,17,8233,7,971,10,7262,390.536697,0.115144,67463.35024,504550.8233,Benign
172.30.6.255,56509,103.243.221.17,80,6,340,4,228,2,112,830.83509,14.240182,128.0882506,62.92054413,Benign
172.30.15.218,49493,52.114.6.46,443,20,7248,12,2608,8,4640,16.627733,0.952839,21896.6688,38957.2635,Benign
192.168.43.233,51355,52.216.18.144,443,275,216334,114,7722,161,208612,3436.220616,34.234091,1804.517024,48749.53449,Benign
172.30.15.2357,51691,14.139.45.128,80,49,39906,18,1404,31,38502,5332.440976,0.203458,55205.49696,1513904.59,Benign
172.30.6.255,57536,103.243.221.17,80,40,24305,23,20151,17,4154,3147.84644,14.184919,11364.7459,2342.769811,Benign
192.168.43.233,51205,52.175.28.154,443,26,9352,15,2612,11,6740,1240.282949,2.012021,10385.57749,26798.92506,Benign
192.168.43.224,43704,172.217.166.196,443,18,6084,10,1455,8,4629,11.58439873,10.56600127,1101.646659,3504.826382,Benign
192.168.43.224,48548,209.197.3.15,443,24,6993,13,1365,11,5628,2618.887939,20.66714298,528.3749192,2178.530436,Benign
172.30.6.255,55844,54.194.27.245,443,93,34749,55,29977,38,4772,102.830557,308.946488,776.2379872,123.5683249,Benign
192.168.137.97,39740,192.168.125.6,80,252,201930,119,8452,133,193478,8297.345646,24.4297871,2767.768696,63358.0634,Benign
172.30.15.1117,50425,172.217.167.2,80,6,348,4,228,2,120,3458.276433,8.945796,203.8946562,107.312977,Benign
192.168.43.233,51488,23.43.115.95,443,26,8494,14,2322,12,6172,3818.722495,235.198037,78.98025101,209.9337249,Benign
172.30.6.255,58285,52.84.108.179,443,16,3785,10,2880,6,905,5315.682082,8.278343,2783.165665,874.5711551,Benign
172.30.6.255,56919,54.245.243.190,80,11,2436,6,1701,5,735,1386.185531,18.454551,737.3790888,318.6205939,Benign
172.30.15.1618,50928,161.202.1.35,443,18,5924,10,1938,8,3986,3573.954245,3.223806,4809.222391,9891.414062,Benign
192.168.215.49,37030,157.240.16.52,443,33,10498,16,2049,17,8449,28.17863703,65.15302686,251.5923018,1037.434533,Benign
172.30.6.255,58426,172.217.166.206,443,44,7324,25,4340,19,2984,5579.414244,63.037415,550.7840066,378.6957317,Benign
10.0.2.15,46324,119.254.87.201,80,11,1579,6,705,5,874,21600.59511,1.422709,3964.268167,4914.567912,Malicious
10.0.2.15,39231,119.254.87.201,80,11,1582,6,705,5,877,25324.72353,1.058134,5330.137771,6630.540177,Malicious
10.0.2.15,59698,119.254.87.201,80,11,1513,6,705,5,808,1389.538863,0.979678,5756.993624,6598.08631,Malicious
10.0.2.15,35241,119.254.87.201,80,11,1582,6,705,5,877,23856.06199,2.103824,2680.832617,3334.879724,Malicious
10.0.2.15,53785,119.254.87.201,80,11,1513,6,705,5,808,10463.81275,0.790727,7132.676638,8174.755636,Malicious
172.30.15.958,50264,151.101.130.49,443,34,14650,17,2115,17,12535,3442.144198,5.117232,3306.475063,19596.53188,Benign
10.0.2.15,60761,119.254.87.201,80,11,1579,6,705,5,874,458.54753,1.37562,4099.969468,5082.799029,Malicious
172.30.15.275,49538,180.149.59.79,443,17,5140,10,1351,7,3789,231.106863,3.762007,2872.93458,8057.401275,Benign
172.30.15.761,50052,104.27.189.78,443,7,414,5,294,2,120,2615.762274,10.534589,223.2645241,91.1283772,Benign
10.0.2.15,40062,119.254.87.201,80,11,1513,6,705,5,808,22201.31449,0.831265,6784.839973,7776.100281,Malicious
192.168.43.224,51530,23.213.88.167,443,17,1905,9,1134,8,771,1635.256048,0.298916364,30349.62649,20634.53441,Benign
172.30.15.1038,50344,185.84.60.24,443,17,2336,10,1536,7,800,3447.534877,9.778782,1256.598214,654.4782367,Benign
192.168.137.97,51738,172.217.161.3,443,16,2049,11,1563,5,486,3759.493908,107.1198899,116.7290221,36.29578039,Benign
10.0.2.15,41139,119.254.87.201,80,11,1582,6,705,5,877,3435.997359,1.630239,3459.615431,4303.663451,Malicious
192.168.215.49,47912,52.84.110.84,443,169,79603,79,8774,90,70829,279.5807388,182.1881279,385.2720856,3110.147772,Benign
10.0.2.15,53281,119.254.87.201,80,12,1653,7,779,5,874,14848.56402,3.815388,1633.385648,1832.579019,Malicious
192.168.137.97,36730,130.211.21.54,443,49,7447,25,3296,24,4151,1766.952596,241.3520519,109.2511947,137.5915379,Benign
172.30.1.136,50151,172.217.24.234,443,11,642,6,348,5,294,140.921164,26.944745,103.3225588,87.28974796,Benign
172.30.6.255,56504,40.100.140.130,443,18,7094,9,1151,9,5943,824.616705,48.966877,188.0454823,970.9420513,Benign
172.30.15.1172,50480,67.202.94.86,80,8,1359,5,983,3,376,3461.526172,1.345405,5845.080106,2235.758006,Benign
172.30.1.136,50544,13.107.4.52,80,10,1519,5,436,5,1083,1399.877994,0.0562,62064.05694,154163.7011,Benign
172.30.15.2423,51757,14.139.45.128,443,3,198,3,198,0,0,5364.710779,9.001667,175.9674069,0,Benign
172.30.1.136,50276,104.17.37.113,443,11,1752,6,1458,5,294,482.652739,8.785542,1327.635791,267.7125669,Benign
172.30.6.255,58536,157.240.16.17,443,582,504421,231,15090,351,489331,5801.148833,7.936466,15210.80037,493248.2543,Benign
192.168.137.97,41986,23.57.214.252,443,41,10755,23,3040,18,7715,68.86808682,285.7059087,85.12249576,216.0263338,Benign
10.0.2.15,38702,119.254.87.201,80,11,1582,6,705,5,877,23285.41427,1.446378,3899.395594,4850.737497,Malicious
192.168.43.224,37550,172.217.166.202,443,14,4400,9,1417,5,2983,3026.365011,13.40507712,845.6497414,1780.221015,Benign
192.168.43.233,51659,18.185.199.142,443,9,534,5,294,4,240,865.614379,31.237797,75.29340177,61.46400145,Benign
172.30.15.353,49621,131.253.61.80,443,62,26053,24,7201,38,18852,1221.207317,64.752029,889.6709631,2329.131648,Benign
192.168.137.97,34124,52.84.110.227,443,2475,1252584,1133,310014,1342,942570,1754.578027,1028.445342,2411.515613,7331.998784,Benign
192.168.43.224,42748,54.86.164.29,443,6,412,4,272,2,140,3022.111369,10.82442496,201.026845,103.4696996,Benign
10.0.2.15,46830,119.254.87.201,80,11,1579,6,705,5,874,6226.934491,1.502467,3753.826207,4653.679582,Malicious
192.168.43.233,51444,192.0.73.2,80,9,534,5,294,4,240,3802.413543,14.317147,164.2785396,134.1049303,Benign
172.30.6.255,58284,157.240.16.39,443,19,1933,10,1125,9,808,5303.401002,60.721602,148.2174334,106.4530544,Benign
172.30.15.2191,51503,31.24.224.56,443,56,29256,26,3137,30,26119,4282.504925,5.317451,4719.554538,39295.5196,Benign
172.30.6.255,56141,103.243.221.109,80,38,23520,22,19426,16,4094,368.83522,25.190457,6169.32039,1300.174904,Benign
172.30.6.255,57297,103.243.221.17,80,70,47871,43,39948,27,7923,2402.877208,21.155904,15106.13775,2996.04309,Benign
172.30.13.95,50862,172.30.6.255,445,3,198,3,198,0,0,3545.696573,8.984559,176.3024763,0,Benign
172.30.6.255,58321,157.240.16.39,443,19,1933,11,1179,8,754,5364.089632,61.90208,152.369678,97.44422158,Benign
10.0.2.15,54486,119.254.87.201,80,11,1582,6,705,5,877,12175.40156,1.497322,3766.724859,4685.698868,Malicious
10.0.2.15,51940,119.254.87.201,80,11,1579,6,705,5,874,14155.0602,1.02625,5495.736906,6813.154689,Malicious
172.30.1.136,50509,54.239.32.228,443,23,9463,11,2351,12,7112,968.214751,59.176669,317.8279602,961.459997,Benign
10.0.2.15,39731,119.254.87.201,80,11,1582,6,705,5,877,4515.248885,1.592606,3541.365535,4405.358262,Malicious
172.30.1.136,50447,157.240.16.16,443,45,14688,24,7555,21,7133,856.740754,106.85383,565.6325094,534.037947,Benign
172.30.15.1389,50697,50.31.185.52,443,13,2705,8,1923,5,782,3495.944325,1.061082,14498.40823,5895.868557,Benign
192.168.137.97,54070,140.98.193.112,443,41,24338,23,9249,18,15089,15.80155751,9.377839422,7890.090315,12872.04809,Benign
192.168.43.224,43400,173.192.91.155,443,23,6365,13,2019,10,4346,115.6550138,63.28544721,255.2245534,549.3838083,Benign
172.30.15.1724,51035,184.29.25.7,443,74,59951,30,9390,44,50561,3619.506066,7.530118,9975.939288,53716.0241,Benign
192.168.43.233,51663,49.44.149.244,443,17,1756,9,1117,8,639,870.184674,23.489499,380.4253126,217.6291627,Benign
172.30.1.136,51527,52.216.229.171,80,9,512,5,284,4,228,200.215237,116.404457,19.51815299,15.6695031,Benign
192.168.43.233,51338,52.84.110.2,443,9,534,5,294,4,240,3078.838705,58.37237,40.2930359,32.8922742,Benign
172.30.6.255,57522,103.243.221.17,80,72,48342,43,40320,29,8022,3122.844488,25.191008,12804.569,2547.575706,Benign
172.30.6.255,57837,103.243.221.51,80,71,48103,42,40073,29,8030,4162.887182,43.15435,7428.77601,1488.610071,Benign
192.168.42.240,51039,172.217.161.5,443,2,132,2,132,0,0,614.107575,3.000394,351.9537767,0,Benign
10.0.2.15,41821,119.254.87.201,80,11,1587,6,705,5,882,1629.759963,1.74614,3229.981559,4040.9131,Malicious
172.30.15.2159,51471,52.42.237.125,443,15,2798,8,1974,7,824,4195.268915,2.417959,6531.128113,2726.266244,Benign
192.168.215.49,54228,157.240.16.20,443,18,5379,10,1261,8,4118,118.5947383,23.71930529,425.307566,1388.91083,Benign
172.30.15.2266,51583,104.121.244.70,443,244,193563,108,23020,136,170543,4487.748431,20.569519,8953.053302,66328.43481,Benign
172.30.15.2332,51665,172.25.10.224,7680,3,198,3,198,0,0,5110.011677,9.000465,175.9909071,0,Benign
192.168.137.97,60138,172.217.161.4,443,17,1210,9,626,8,584,3799.594557,41.46133329,120.7872396,112.6833034,Benign
172.30.15.424,49698,59.63.81.183,443,1565,1482108,539,34120,1026,1447988,1616.771783,14.128603,19319.67371,819890.2609,Benign
10.0.2.15,37344,119.254.87.201,80,11,1579,6,705,5,874,19711.27901,2.218514,2542.24224,3151.659174,Malicious
10.0.2.15,35969,119.254.87.201,80,11,1582,6,705,5,877,22051.1505,2.154807,2617.403786,3255.976057,Malicious
172.30.6.255,56641,103.243.221.109,80,8,449,5,283,3,166,1025.991235,46.084725,49.12690702,28.81648963,Benign
192.168.42.240,50922,13.107.136.254,443,1,54,0,0,1,54,113.970725,0,0,0,Benign
172.30.6.255,57372,52.213.19.114,443,14,1537,7,959,7,578,2600.202538,49.42714,155.2183679,93.55184217,Benign
172.30.15.315,49578,14.139.45.149,80,13,2642,7,810,6,1832,730.25633,0.073224,88495.57522,200152.9553,Benign
172.30.15.849,50152,162.125.248.4,443,6,348,4,228,2,120,3334.716867,0.344615,5292.86305,2785.717395,Benign
192.168.137.97,33858,172.217.161.5,443,9,606,5,338,4,268,10723.32336,57.24578057,47.23492235,37.45254198,Benign
172.30.15.1682,50993,157.240.16.39,443,283,241936,100,8413,183,233523,3606.914841,10.213733,6589.559371,182909.0304,Benign
172.30.15.2072,51384,54.85.199.48,443,30,7091,16,2560,14,4531,4122.405607,5.17441,3957.939166,7005.24311,Benign
172.30.1.136,50371,172.217.161.3,443,3,198,3,198,0,0,668.953861,9.002408,175.9529228,0,Benign
192.168.137.97,39656,192.168.125.7,8380,267,176222,133,9908,134,166314,8302.605827,825.8192186,95.98226611,1611.141967,Benign
172.30.15.1015,50321,52.0.128.155,443,6,348,4,228,2,120,3444.608525,2.654082,687.2432728,361.7069857,Benign
192.168.43.224,50174,52.207.90.113,443,75,17479,41,10384,34,7095,370.7355,85.91301516,966.9314928,660.668234,Benign
172.30.15.1529,50837,104.20.90.77,443,170,112417,73,5879,97,106538,3527.097701,9.901368,4750.0507,86079.41852,Benign
10.0.2.15,49851,119.254.87.201,80,11,1582,6,705,5,877,26138.77129,0.880101,6408.355405,7971.812326,Malicious
10.0.2.15,42966,119.254.87.201,80,11,1582,6,705,5,877,16677.69156,1.289979,4372.164198,5438.848229,Malicious
172.30.6.255,57553,103.243.220.231,80,20,10309,10,4270,10,6039,3218.852251,35.178849,971.0380234,1373.325205,Benign
172.30.1.136,50272,52.94.220.15,443,43,12324,20,1771,23,10553,482.407033,28.809999,491.7737068,2930.371501,Benign
10.0.2.15,38890,119.254.87.201,80,11,1582,6,705,5,877,3165.71929,276.657521,20.38621607,25.35987446,Malicious
192.168.137.97,51848,103.102.166.224,443,13,878,7,470,6,408,5425.001696,110.2655596,34.09949593,29.60126455,Benign
172.30.6.255,57057,103.243.221.17,80,16,5798,9,4216,7,1582,1663.843652,16.188143,2083.500251,781.8067829,Benign
192.168.137.97,34428,172.217.161.3,443,17,2111,11,1547,6,564,325.4865163,30.41749592,406.8710992,148.3356819,Benign
172.30.6.255,57633,103.243.221.46,80,8,449,5,283,3,166,3451.117067,45.951513,49.26932439,28.90002773,Benign
172.30.15.1860,51172,35.161.208.104,443,6,348,4,228,2,120,3908.994127,8.502063,214.5361661,112.9137716,Benign
192.168.43.233,51072,157.240.16.20,443,7,402,4,228,3,174,908.077886,11.339972,160.846958,122.7516258,Benign
10.0.2.15,55501,119.254.87.201,80,11,1558,6,705,5,853,23913.17704,2.171051,2597.820134,3143.17812,Malicious
192.168.215.49,49290,35.241.13.224,443,46,9472,22,2502,24,6970,789.4553961,240.4711192,83.2366068,231.8781572,Benign
172.30.1.136,50576,172.217.161.14,443,23,2800,13,1918,10,882,1585.856619,24.504696,626.1656949,287.9448086,Benign
192.168.42.240,50950,172.217.163.101,443,3929,2717701,2210,2615609,1719,102092,179.543635,116.338647,179861.7445,7020.332633,Benign
192.168.43.233,50920,204.147.113.115,80,6,344,3,174,3,170,398.177171,33.439024,41.62800924,40.67104351,Benign
192.168.43.224,57524,172.217.166.196,443,18,7454,10,1467,8,5987,10.60560031,4.765390665,2462.757164,10050.80241,Benign
172.30.6.255,56950,184.29.26.182,443,78,38944,47,30161,31,8783,1389.207459,351.06467,687.3035672,200.1454604,Benign
172.30.6.255,58423,216.58.196.162,80,6,348,4,228,2,120,5572.174007,6.879336,265.1418683,139.5483518,Benign
10.0.2.15,39005,119.254.87.201,80,11,1579,6,705,5,874,18960.34723,1.638822,3441.496392,4266.479215,Malicious
172.30.15.1333,50641,13.232.120.220,443,22,9108,11,1748,11,7360,3489.869685,7.148959,1956.088991,8236.164174,Benign
10.0.2.15,49289,119.254.87.201,80,11,1582,6,705,5,877,3103.889554,1.755466,3212.822122,3996.659576,Malicious
172.30.6.255,58558,157.240.16.17,443,188,155910,71,5424,117,150486,5821.06809,8.321857,5214.220816,144665.7879,Benign
10.0.2.15,58668,119.254.87.201,80,11,1579,6,705,5,874,6224.609008,0.893885,6309.536462,7822.035273,Malicious
10.0.2.15,33402,119.254.87.201,80,11,1579,6,705,5,874,24063.41341,2.05313,2747.025274,3405.532041,Malicious
172.30.6.255,57254,151.101.1.69,443,16,5714,10,1186,6,4528,2252.357256,19.870979,477.480249,1822.960006,Benign
10.0.2.15,44259,119.254.87.201,80,11,1582,6,705,5,877,17882.1512,1.420064,3971.651982,4940.622394,Malicious
10.0.2.15,49068,219.234.85.216,80,8,1325,4,1069,4,256,23.847623,0.665912,12842.53775,3075.481445,Malicious
172.30.15.2378,51712,14.139.45.128,80,12,1930,6,1120,6,810,5334.669566,2.353098,3807.746214,2753.816458,Benign
172.30.1.136,51833,74.125.24.188,5228,9,534,5,294,4,240,3305.043535,12.721624,184.8820559,150.9241273,Benign
172.30.6.255,57759,103.231.98.53,80,39,17418,20,15672,19,1746,3910.850124,65.123542,1925.20241,214.4846483,Benign
192.168.43.224,37244,151.101.194.217,443,19,8473,11,1344,8,7129,542.185671,31.62105546,340.0266007,1803.608361,Benign
10.0.2.15,33719,119.254.87.201,80,11,1513,6,705,5,808,25414.7775,0.8933,6313.66842,7236.090899,Malicious
10.0.2.15,58851,119.254.87.201,80,11,1579,6,705,5,874,578.63657,1.618227,3485.295944,4320.778234,Malicious
172.30.6.255,56988,103.243.220.231,80,21,10339,10,4270,11,6069,1452.837753,27.736175,1231.604574,1750.493714,Benign
192.168.43.224,36684,169.55.74.36,443,30,7832,16,2946,14,4886,370.714394,1.343453372,17542.84927,29095.16684,Benign
192.168.43.224,46112,104.17.40.113,443,2246,1286649,953,63519,1293,1223130,36.7651333,1510.11496,336.4988848,6479.665627,Benign
192.168.137.97,57554,104.198.143.177,80,10,911,5,425,5,486,1062.830205,1.163484694,2922.25589,3341.685559,Benign
192.168.43.224,56880,117.18.237.70,443,2755,2081239,1206,89593,1549,1991646,32.62575415,264.9388603,2705.318499,60139.03729,Benign
172.30.15.1820,51132,158.85.224.180,443,27,7583,13,2861,14,4722,3757.807963,1.568651,14590.88095,24081.83847,Benign
192.168.137.97,56330,52.84.108.195,443,35,9215,18,2460,17,6755,8276.377055,222.5459227,88.43118654,242.8262866,Benign
10.0.2.15,33023,119.254.87.201,80,11,1582,6,705,5,877,7365.627137,1.740066,3241.256366,4032.030969,Malicious
192.168.137.97,33312,104.19.199.151,443,20,6219,11,1243,9,4976,5243.725635,64.2258823,154.8285464,619.8124272,Benign
192.168.43.233,51429,104.131.222.33,80,120,89832,54,7172,66,82660,3788.530869,38.883197,1475.59883,17006.83203,Benign
172.30.15.652,49939,157.240.16.20,443,65,39631,27,2498,38,37133,2395.776407,10.407848,1920.089532,28542.30769,Benign
192.168.137.97,39438,35.171.73.174,443,27,3310,16,2011,11,1299,3714.046817,87.28635871,184.3128782,119.0564042,Benign
10.0.2.15,54744,119.254.87.201,80,12,1587,7,779,5,808,24937.34058,5.090198,1224.313868,1269.891662,Malicious
172.30.15.1345,50653,172.217.166.206,443,6,348,4,228,2,120,3492.023196,5.009706,364.0932222,191.6280117,Benign
10.0.2.15,49135,119.254.87.201,80,11,1582,6,705,5,877,20249.13098,1.62083,3479.698673,4328.646434,Malicious
172.30.1.136,51775,35.241.16.233,443,52,19688,23,4014,29,15674,2973.932122,40.06876,801.422355,3129.420526,Benign
172.30.6.255,55642,122.15.34.40,80,105,101053,32,4177,73,96876,36.774876,21.801884,1532.711577,35547.75358,Benign
172.30.6.255,56799,54.194.27.245,443,624,256773,367,217900,257,38873,1255.262123,1793.921469,971.7259256,173.3542997,Benign
10.0.2.15,55760,119.254.87.201,80,11,1582,6,705,5,877,13762.3292,1.896241,2974.305481,3699.951641,Malicious
192.168.43.233,51372,52.212.88.15,443,43,11955,22,5141,21,6814,3473.609585,151.827949,270.8855667,359.0379792,Benign
172.30.15.1273,50581,157.240.16.37,443,15,5291,8,1025,7,4266,3469.546767,7.404272,1107.468769,4609.230995,Benign
192.168.43.224,47348,54.236.156.42,443,39,8158,21,2666,18,5492,33.5430277,63.58978236,335.3997955,690.928611,Benign
192.168.43.233,51113,172.217.161.3,443,10,629,5,272,5,357,2.455257,58.050471,37.48462265,49.19856723,Benign
192.168.43.233,51456,23.74.147.187,80,7,402,4,228,3,174,3811.995832,17.355257,105.0978387,80.20624529,Benign
172.30.6.255,56027,103.243.221.75,80,21,11743,9,3613,12,8130,237.859588,15.169524,1905.399273,4287.543894,Benign
172.30.6.255,57320,103.243.221.51,80,25,15257,11,5835,14,9422,2467.878689,43.149406,1081.82254,1746.860664,Benign
192.168.43.224,39224,54.89.94.62,443,26,8997,13,2686,13,6311,3250.802979,2.224868383,9658.099402,22692.57831,Benign
10.0.2.15,60819,119.254.87.201,80,11,1513,6,705,5,808,20702.09311,2.123038,2656.570443,3044.693501,Malicious
172.30.15.727,50014,162.125.34.6,443,22,7209,12,2813,10,4396,2428.093894,1117.669575,20.13475226,31.46547136,Benign
192.168.43.233,51171,172.217.160.238,443,11,642,6,348,5,294,500.859822,41.06755,67.79074963,57.27149538,Benign
192.168.43.233,51244,157.240.16.20,443,22,5883,10,1147,12,4736,1593.383555,110.662485,82.91879583,342.3743828,Benign
192.168.43.224,58354,23.23.105.113,443,35,15720,18,3426,17,12294,106.286599,68.36543613,400.9043392,1438.621701,Benign
172.30.1.136,50396,172.217.161.3,443,47,6640,26,3742,21,2898,759.962347,49.811688,600.9834479,465.4329321,Benign
192.168.137.97,35500,104.198.143.177,80,11,977,6,491,5,486,12327.81636,1.553975456,2527.710451,2501.970018,Benign
172.30.1.136,50550,157.240.16.20,443,15,4923,8,1025,7,3898,1461.545984,10.165615,806.6408181,3067.596009,Benign
10.0.2.15,54657,119.254.87.201,80,12,1653,7,779,5,874,25780.70974,9.875624,631.0487317,708.0058941,Malicious
192.168.215.49,49614,103.243.221.46,443,13,4512,8,1179,5,3333,482.7922857,26.02300286,362.4485633,1024.631944,Benign
192.168.42.240,50939,216.58.221.67,443,41,8281,22,2611,19,5670,160.589045,50.952306,409.9520049,890.2443002,Benign
10.0.2.15,38702,119.254.87.201,80,11,1579,6,705,5,874,23798.53357,1.022833,5514.096632,6835.91554,Malicious
172.30.6.255,57861,54.171.10.96,80,13,1751,7,1021,6,730,4226.05069,77.976745,104.7491787,74.89412388,Benign
172.30.6.255,57473,103.243.220.231,80,24,14163,10,5275,14,8888,2991.852701,14.174872,2977.099194,5016.200499,Benign
172.30.15.252,49459,184.29.26.24,443,4,247,2,108,2,139,66.270207,0.027119,31859.58184,41004.46182,Benign
172.30.6.255,58448,52.213.19.114,443,6,348,4,228,2,120,5617.972365,1.241822,1468.80954,773.0576524,Benign
172.30.15.1269,50577,184.29.26.86,443,14,1543,7,958,7,585,3469.542771,7.964237,962.3018501,587.6269127,Benign
172.30.15.264,49527,13.107.4.50,80,700,718126,203,11439,497,706687,93.262036,11.891765,7695.409386,475412.6911,Benign
192.168.43.233,51068,49.44.148.176,443,58,15020,28,5346,30,9674,898.139559,537.303721,79.59743871,144.0377146,Benign
10.0.2.15,58242,119.254.87.201,80,11,1579,6,705,5,874,9647.865378,2.018324,2794.397728,3464.260446,Malicious
10.0.2.15,45754,119.254.87.201,80,11,1582,6,705,5,877,7820.874032,2.051618,2749.049774,3419.739932,Malicious
10.0.2.15,35327,119.254.87.201,80,11,1579,6,705,5,874,22086.72118,1.328003,4246.978358,5265.048347,Malicious
172.30.15.1290,50598,103.243.220.231,80,6,340,4,228,2,112,3471.106161,6.518127,279.8349894,137.4628018,Benign
172.30.15.604,49890,13.107.21.200,443,260,94270,119,22508,141,71762,2368.233682,18.203489,9891.730096,31537.69038,Benign
172.30.6.255,55774,195.201.82.80,80,6,348,4,228,2,120,62.72897,17.433037,104.6289295,55.06785765,Benign
172.30.6.255,57143,103.243.220.231,80,36,22427,16,8395,20,14032,1875.852251,46.190186,1453.988516,2430.299804,Benign
172.30.15.2413,51747,14.139.45.128,80,29,20305,11,1035,18,19270,5346.672887,0.454288,18226.32339,339344.2046,Benign
172.30.6.255,55653,172.217.166.194,80,17,8753,8,868,9,7885,37.313196,21.299548,326.016308,2961.565194,Benign
192.168.43.224,58488,52.24.249.177,443,52,26650,26,8829,26,17821,93.12143671,81.53064865,866.3245193,1748.643024,Benign
192.168.215.49,53868,54.165.86.233,443,8,544,5,338,3,206,556.0328063,78.48025578,34.45452583,20.99891219,Benign
172.30.15.907,50213,104.28.18.232,443,6,348,4,228,2,120,3439.518773,7.542347,241.8345377,127.2813356,Benign
10.0.2.15,60797,119.254.87.201,80,12,1656,7,779,5,877,9262.309121,4.854774,1283.684884,1445.175409,Malicious
192.168.137.97,50056,104.237.191.1,443,48,6035,24,3002,24,3033,1822.377604,242.3932572,99.07866363,100.1017944,Benign
172.30.6.255,57293,103.243.220.231,80,22,10400,10,4270,12,6130,2369.840391,33.220865,1028.269432,1476.180708,Benign
192.168.43.224,36092,107.21.25.13,443,32,7171,17,2284,15,4887,55.67318441,61.79074051,295.7077363,632.7161591,Benign
10.0.2.15,53377,119.254.87.201,80,11,1582,6,705,5,877,23075.13002,1.413748,3989.395564,4962.694907,Malicious
10.0.2.15,41203,119.254.87.201,80,11,1579,6,705,5,874,8271.291714,1.951286,2890.40151,3583.2779,Malicious
192.168.215.49,46876,157.240.16.39,443,17,5203,10,1225,7,3978,118.2548649,0.086686034,113051.6595,367117.9604,Benign
172.30.15.1921,51233,35.189.139.118,443,28,13466,15,2072,13,11394,3986.823929,10.552745,1570.776135,8637.752547,Benign
172.30.15.476,49751,162.247.242.19,443,7,398,4,228,3,170,1729.403914,6.40843,284.6250954,212.2204659,Benign
172.30.1.136,50648,157.240.16.20,443,23,5999,10,1778,13,4221,1746.398411,3.578214,3975.1675,9437.110246,Benign
192.168.43.233,51335,172.217.160.238,443,9,534,5,294,4,240,3371.003894,11.996621,196.0552059,160.045066,Benign
192.168.137.97,54618,172.217.160.234,443,22,5410,11,1497,11,3913,4023.422559,240.3213631,49.83327261,130.258915,Benign
172.30.6.255,56434,103.243.220.231,80,91,72366,56,64019,35,8347,697.83478,49.236049,10401.97194,1356.242049,Benign
10.0.2.15,59136,119.254.87.201,80,11,1582,6,705,5,877,17371.5151,1.572444,3586.773201,4461.84411,Malicious
172.30.6.255,56872,103.15.158.129,80,49,19691,25,6588,24,13103,1383.679845,10.277575,5128.057932,10199.29312,Benign
10.0.2.15,58297,119.254.87.201,80,11,1579,6,705,5,874,11872.73471,1.447118,3897.401594,4831.672331,Malicious
192.168.43.224,33050,35.171.73.174,443,6,412,4,272,2,140,1246.873673,27.88997305,78.02087139,40.15780145,Benign
192.168.43.224,42732,107.21.25.13,443,6,412,4,272,2,140,57.07299309,14.23425826,152.8706281,78.68341152,Benign
10.0.2.15,39089,119.254.87.201,80,11,1582,6,705,5,877,3734.489081,1.695476,3326.499461,4138.070961,Malicious
192.168.137.97,32822,172.217.24.238,443,9,618,5,338,4,280,1098.822246,23.31590956,115.9723147,96.07173997,Benign
172.30.6.255,57859,54.171.10.96,80,6,348,4,228,2,120,4226.05065,11.985442,152.1846253,80.09717122,Benign
172.30.1.136,51838,52.84.110.227,443,13,750,7,402,6,348,3320.787599,77.428112,41.5353018,35.9559329,Benign
172.30.15.536,49820,64.106.240.4,443,19,5718,11,1773,8,3945,2249.062546,7.207712,1967.892169,4378.64332,Benign
192.168.215.49,49692,103.243.221.46,443,18,6993,10,2537,8,4456,516.5994274,10.56769384,1920.570401,3373.299845,Benign
10.0.2.15,60499,119.254.87.201,80,11,1579,6,705,5,874,2985.536068,1.827245,3086.614001,3826.525726,Malicious
172.30.6.255,56271,31.172.81.172,80,6,348,4,228,2,120,530.584018,35.763136,51.00223873,26.84328354,Benign
10.0.2.15,40307,119.254.87.201,80,12,1653,7,779,5,874,17338.48177,4.027029,1547.542866,1736.267606,Malicious
172.30.6.255,56062,103.243.221.46,80,20,9439,11,8154,9,1285,286.021005,18.094634,3605.046667,568.1242295,Benign
172.30.6.255,58447,52.213.19.114,443,15,2276,8,1578,7,698,5617.849488,1.349764,9352.74611,4137.019509,Benign
172.30.6.255,56099,13.228.114.100,80,13,1669,7,855,6,814,305.826042,63.110987,108.3804948,103.1833015,Benign
10.0.2.15,39946,119.254.87.201,80,11,1559,6,705,5,854,21750.92817,1.424109,3960.371011,4797.385593,Malicious
10.0.2.15,57215,119.254.87.201,80,11,1582,6,705,5,877,12380.68804,1.556514,3623.481703,4507.508445,Malicious
172.30.6.255,56168,103.243.221.17,80,19,11949,8,3869,11,8080,434.862925,30.166699,1026.032049,2142.760134,Benign
172.30.6.255,57405,103.243.221.17,80,28,12724,15,9263,13,3461,2721.862119,48.197122,1537.51919,574.4741356,Benign
172.30.6.255,56161,103.243.221.109,80,6,340,4,228,2,112,408.085839,3.70733,491.9982845,241.6833678,Benign
10.0.2.15,43122,119.254.87.201,80,11,1579,6,705,5,874,15806.78996,1.417528,3978.757386,4932.530433,Malicious
10.0.2.15,51698,119.254.87.201,80,11,1579,6,705,5,874,6256.952434,0.883176,6386.043099,7916.881799,Malicious
192.168.43.224,60180,151.101.153.2,443,21,5942,11,1308,10,4634,913.7259506,2.526715807,4141.344258,14672.01016,Benign
172.30.6.255,57932,103.243.221.75,80,6,340,4,228,2,112,4501.203757,25.861195,70.53038346,34.64650415,Benign
172.30.15.1182,50490,52.86.241.228,80,11,2028,6,1405,5,623,3464.492705,3.154882,3562.732299,1579.773824,Benign
10.0.2.15,45328,119.254.87.201,80,11,1582,6,705,5,877,8031.005246,1.554127,3629.047047,4514.431575,Malicious
172.30.6.255,55914,151.101.192.166,80,6,348,4,228,2,120,121.807224,30.066413,60.66570029,31.92931594,Benign
172.30.6.255,57267,103.243.220.231,80,24,11981,14,9292,10,2689,2270.844351,2.804186,26508.94056,7671.388417,Benign
172.30.6.255,57068,103.231.98.53,80,19,6855,10,6121,9,734,1679.880428,55.038822,889.6992745,106.6883299,Benign
192.168.43.233,51153,35.171.204.130,443,27,9415,14,3124,13,6291,927.390584,81.278011,307.4878395,619.208066,Benign
172.30.1.136,51898,172.217.194.188,5228,18,2222,10,1348,8,874,4739.642462,9.760917,1104.81423,716.3261403,Benign
172.30.6.255,58539,172.217.166.226,80,14,2828,8,1608,6,1220,5801.816437,7.285144,1765.785275,1339.712708,Benign
172.30.6.255,57315,103.243.221.51,80,22,11123,10,4552,12,6571,2467.839018,43.189077,843.1761577,1217.159607,Benign
172.30.6.255,58324,172.217.167.2,80,66,19957,36,11268,30,8689,5373.016835,16.02499,5625.214119,4337.725016,Benign
172.30.6.255,56761,23.198.126.238,443,17,6692,8,1317,9,5375,1244.684415,0.785347,13415.72579,54752.8672,Benign
192.168.137.97,60534,157.240.16.17,443,18,5378,10,1261,8,4117,24.78522795,12.58966606,801.2921035,2616.11387,Benign
172.30.6.255,56618,157.240.16.39,443,36,7955,20,5263,16,2692,972.086254,122.066607,344.9264384,176.4282676,Benign
172.30.15.777,50069,52.84.108.93,443,211,155911,103,7912,108,147999,2660.239093,5.994323,10559.32421,197518.8858,Benign
172.30.6.255,57459,157.240.16.39,443,27,5476,15,3419,12,2057,2924.091817,61.02468,448.2121004,269.6613895,Benign
192.168.43.224,57990,172.217.166.206,443,19,6090,10,1455,9,4635,22.15054014,10.53513881,1104.873909,3519.649874,Benign
10.0.2.15,38741,119.254.87.201,80,11,1582,6,705,5,877,21603.13247,1.07939,5225.173478,6499.967574,Malicious
172.30.15.1473,50781,35.201.123.46,443,6,348,4,228,2,120,3508.734592,8.249789,221.0965638,116.3666125,Benign
172.30.6.255,58301,157.240.16.17,443,15,4922,8,1025,7,3897,5326.657027,7.293757,1124.249135,4274.340371,Benign
10.0.2.15,46635,119.254.87.201,80,11,1554,6,705,5,849,6314.647409,1.810529,3115.111661,3751.389787,Malicious
10.0.2.15,57709,119.254.87.201,80,11,1558,6,705,5,853,16735.56522,2.115617,2665.888958,3225.536569,Malicious
172.30.1.136,50327,157.240.16.20,443,29,9167,15,1667,14,7500,568.978272,27.88558,478.2400079,2151.649706,Benign
172.30.6.255,56746,209.67.99.89,443,24,7043,12,1455,12,5588,1243.462786,2.24822,5177.429255,19884.17504,Benign
10.0.2.15,56273,119.254.87.201,80,11,1513,6,705,5,808,5238.121332,1.460772,3860.972143,4425.057435,Malicious
172.30.15.2532,51866,192.168.121.37,443,77,61291,30,5123,47,56168,5499.875393,3.505028,11692.91658,128199.8318,Benign
172.30.15.1962,51274,35.171.73.174,443,49,12733,27,5869,22,6864,4075.60369,6.963838,6742.259082,7885.306924,Benign
192.168.43.233,50876,172.217.166.206,443,180,111055,82,6826,98,104229,35.144709,244.774281,223.0953341,3406.534365,Benign
10.0.2.15,46208,119.254.87.201,80,11,1582,6,705,5,877,24216.41576,2.023314,2787.506042,3467.578438,Malicious
192.168.137.97,52468,117.18.237.70,443,41,7462,22,1715,19,5747,28.54802781,264.1668044,51.93688144,174.0415496,Benign
172.30.6.255,58210,210.176.156.41,80,15,4359,10,4081,5,278,5155.864598,121.167431,269.4453429,18.3547673,Benign
172.30.6.255,58330,172.217.167.2,80,10,1582,6,912,4,670,5389.236719,9.77185,746.6344653,548.514355,Benign
10.0.2.15,40766,119.254.87.201,80,11,1579,6,705,5,874,13316.60825,1.922854,2933.14001,3636.261515,Malicious
192.168.43.224,60936,151.101.1.69,443,12,840,7,470,5,370,1202.733141,47.58888979,79.0100382,62.19939178,Benign
192.168.43.233,51210,52.114.14.1,443,15,6232,8,1637,7,4595,1242.695224,123.921804,105.6795461,296.6386771,Benign
172.30.6.255,56420,52.206.38.25,443,22,6462,12,2421,10,4041,678.978863,20.299732,954.101266,1592.53334,Benign
192.168.43.224,34204,172.217.166.206,443,21,6158,12,1583,9,4575,941.9389904,31.8329479,397.8268064,1149.752141,Benign
10.0.2.15,56752,119.254.87.201,80,11,1582,6,705,5,877,3644.428285,1.815172,3107.143565,3865.19845,Malicious
172.30.15.1953,51265,64.74.232.52,443,7,402,4,228,3,174,4028.684093,8.819165,206.8223012,157.838072,Benign
192.168.137.97,33924,104.17.40.113,443,12,704,5,314,7,390,2436.034783,24.82840975,101.1744218,125.6624984,Benign
192.168.43.233,51699,157.240.16.39,443,32,5044,15,3157,17,1887,1573.619147,67.642682,373.3737228,223.1727003,Benign
172.30.15.2475,51809,14.139.45.128,80,298,269728,111,6799,187,262929,5424.010852,10.672645,5096.393631,197086.2893,Benign
192.168.43.233,51284,104.244.42.193,443,1011,556180,484,265953,527,290227,2472.294186,799.730378,2660.426637,2903.248475,Benign
192.168.43.233,51314,52.114.76.37,443,19,7404,10,2710,9,4694,2603.453149,6.268012,3458.831923,5991.054261,Benign
172.30.15.1562,50871,52.84.108.98,443,18,6927,10,1219,8,5708,3557.050158,0.154592,63082.1776,295383.9785,Benign
192.168.137.97,44266,140.98.193.112,443,31,14111,17,4450,14,9661,78.9503879,18.26926333,1948.628106,4230.493512,Benign
172.30.15.638,49925,52.84.110.77,443,18,6765,9,1153,9,5612,2394.06678,0.202756,45493.10501,221428.7123,Benign
172.30.6.255,57256,23.58.57.98,443,48,12757,26,4466,22,8291,2252.077283,541.413146,65.99027058,122.5090312,Benign
172.30.6.255,58351,157.240.16.39,443,27,5491,15,3397,12,2094,5425.393743,60.755729,447.2993814,275.7270841,Benign
172.30.6.255,56234,157.240.16.39,443,18,1879,10,1125,8,754,484.088279,61.061826,147.3915962,98.78512313,Benign
172.30.6.255,56597,52.229.173.178,443,29,10102,16,2253,13,7849,914.696617,73.657271,244.7008931,852.4888195,Benign
172.30.15.897,50203,103.243.220.231,80,32,14984,17,8748,15,6236,3438.495958,8.765944,7983.623897,5691.115526,Benign
172.30.1.136,50655,146.112.234.203,80,23,5102,13,1424,10,3678,1755.742917,70.961911,160.5368266,414.6449776,Benign
192.168.43.233,51051,117.18.237.29,80,17,1968,9,736,8,1232,889.384852,136.517631,43.12996026,72.19580305,Benign
172.30.6.255,56886,52.76.116.64,80,6,348,4,228,2,120,1384.547007,19.89522,91.68031316,48.2527964,Benign
172.30.15.868,50174,180.149.59.136,80,107,77868,47,6452,60,71416,3434.521059,12.461785,4141.942747,45846.40162,Benign
192.168.42.240,51042,216.58.221.35,443,1,66,1,66,0,0,616.170364,0,0,0,Benign
192.168.137.97,36284,52.84.103.186,443,8,552,5,338,3,214,3707.102673,14.34868912,188.4492708,119.3140353,Benign
172.30.15.339,49607,104.25.218.21,443,43,16076,20,2467,23,13609,990.30729,9.94157,1985.199521,10951.18779,Benign
10.0.2.15,34907,119.254.87.201,80,12,1587,7,779,5,808,5568.513848,4.784011,1302.67259,1351.167462,Malicious
172.30.15.1564,50873,52.84.108.98,443,18,6915,10,1207,8,5708,3557.051183,0.153914,62736.33328,296685.1618,Benign
172.30.1.136,50595,157.240.16.39,443,17,5054,9,1091,8,3963,1598.991484,14.043497,621.4976227,2257.557359,Benign
172.30.6.255,56065,52.54.208.77,80,15,1843,8,1021,7,822,286.544266,107.512164,75.97279876,61.16517197,Benign
192.168.137.97,40452,104.17.161.9,443,10,604,6,364,4,240,3521.310163,38.45844428,75.71809142,49.92401632,Benign
10.0.2.15,57135,119.254.87.201,80,11,1579,6,705,5,874,10191.11479,1.819416,3099.895791,3842.991377,Malicious
172.30.15.1868,51180,52.6.46.142,443,7,402,4,228,3,174,3937.885313,9.591916,190.1601307,145.122205,Benign
192.168.43.224,44950,172.217.166.196,443,3,198,2,132,1,66,0.695601214,8.730046048,120.9615613,60.48078064,Benign
10.0.2.15,50169,119.254.87.201,80,11,1544,6,705,5,839,4513.048051,0.838374,6727.30786,8005.973468,Malicious
172.30.15.287,49550,192.0.72.17,443,6,348,4,228,2,120,390.569356,4.200741,434.2091074,228.5311092,Benign
192.168.43.233,51146,74.125.158.9,443,24,8979,11,2373,13,6606,475.757653,3.717676,5106.415944,14215.33237,Benign
172.30.6.255,55836,103.243.221.75,80,27,10679,16,7186,11,3493,101.880427,20.858682,2756.07059,1339.681961,Benign
172.30.15.665,49952,104.27.177.100,80,65,45886,31,2334,34,43552,2397.039683,9.23351,2022.199575,37733.86285,Benign
192.168.137.97,51122,52.84.110.84,443,2044,807601,896,71143,1148,736458,291.5623781,64.14816091,8872.335417,91844.62838,Benign
10.0.2.15,56560,119.254.87.201,80,11,1579,6,705,5,874,2112.745407,1.463788,3853.016967,4776.647985,Malicious
192.168.43.224,43494,18.206.249.150,443,9,598,5,338,4,260,739.0715062,108.3246367,24.96200386,19.20154143,Benign
172.30.6.255,56710,172.217.166.210,443,7,402,4,228,3,174,1170.104918,20.708792,88.07853206,67.21782709,Benign
192.168.43.233,51056,23.213.64.67,443,32,11652,18,1969,14,9683,891.087759,107.299227,146.8044127,721.9436912,Benign
172.30.6.255,58247,176.34.147.227,443,22,8809,12,3386,10,5423,5222.603293,36.542345,741.2770034,1187.225396,Benign
192.168.43.233,51195,204.79.197.213,443,50,19277,25,6966,25,12311,675.767935,68.274542,816.2339632,1442.5289,Benign
172.30.6.255,56081,103.243.221.87,80,14,4375,8,2848,6,1527,303.86752,20.155925,1130.387219,606.0748886,Benign
172.30.6.255,58561,157.240.16.17,443,950,795143,403,26104,547,769039,5851.200681,17.898031,11667.87565,343742.3927,Benign
172.30.6.255,57071,210.176.156.21,80,323,187262,157,134632,166,52630,1679.891973,1090.095018,988.0386409,386.2415597,Benign
172.30.15.841,50144,34.232.42.95,443,6,348,4,228,2,120,3240.438315,6.714147,271.665187,142.9816773,Benign
172.30.6.255,57012,157.240.16.39,443,28,5559,15,3413,13,2146,1521.092997,61.021603,447.4480947,281.342986,Benign
172.30.6.255,57875,103.243.221.109,80,31,16154,15,8559,16,7595,4276.848778,27.199225,2517.424669,2233.887179,Benign
172.30.6.255,57797,103.231.98.53,80,24,7125,16,6445,8,680,4041.9162,80.308441,642.0246659,67.73883209,Benign
192.168.137.97,38786,157.240.16.16,443,22,5604,15,1627,7,3977,224.8365108,79.69833523,163.3158329,399.2053273,Benign
192.168.43.233,51207,52.114.128.8,443,19,7339,10,2645,9,4694,976.069811,5.320523,3977.052632,7057.952761,Benign
192.168.43.233,50872,172.217.166.197,443,46,6050,24,3208,22,2842,3.132218,243.757601,105.284922,93.27298885,Benign
10.0.2.15,44557,119.254.87.201,80,11,1587,6,705,5,882,19348.18286,1.07626,5240.369427,6556.036645,Malicious
172.30.6.255,58120,157.240.16.37,443,23,6107,12,2731,11,3376,4895.105315,3.924749,5566.725414,6881.459171,Benign
10.0.2.15,55554,119.254.87.201,80,11,1582,6,705,5,877,3494.266584,1.780395,3167.836351,3940.698553,Malicious
172.30.15.1179,50487,52.86.241.228,80,11,2026,6,1404,5,622,3464.491838,3.149435,3566.353965,1579.96593,Benign
172.30.15.1249,50557,208.100.17.187,80,6,531,4,228,2,303,3469.51815,8.200265,222.431836,295.6002032,Benign
172.30.15.1224,50532,173.241.248.220,80,6,535,4,228,2,307,3467.401858,10.220193,178.4702109,240.3085734,Benign
172.30.6.255,55903,104.24.246.16,443,7,402,4,228,3,174,121.706148,30.1657,60.46602598,46.14512509,Benign
172.30.15.1926,51238,34.201.201.2,443,19,5522,11,1790,8,3732,3991.665708,5.534409,2587.448813,5394.613951,Benign
172.30.15.2511,51845,14.139.45.128,80,10,1404,5,674,5,730,5475.958367,0.147718,36501.98351,39534.78926,Benign
172.30.15.2336,51669,162.125.248.4,443,6,348,4,228,2,120,5135.50899,0.260838,6992.846134,3680.445334,Benign
172.30.1.136,50184,172.217.161.3,443,177,109761,81,15501,96,94260,353.056413,30.314867,4090.666141,24874.92358,Benign
192.168.43.224,33256,172.217.166.195,443,56,13360,29,6778,27,6582,369.278931,241.3822913,224.6395114,218.1435917,Benign
192.168.215.49,49222,104.237.191.1,443,8,552,5,338,3,214,510.5120511,40.83794637,66.21292794,41.92179461,Benign
172.30.15.2257,51574,104.121.244.70,443,16,4057,9,3088,7,969,4486.764523,0.844992,29235.77975,9174.051352,Benign
172.30.1.136,51885,52.229.207.60,443,34,10110,21,3271,13,6839,4464.915768,1.579178,16570.64625,34645.87273,Benign
172.30.15.1748,51060,184.29.25.7,443,88,67685,37,7441,51,60244,3637.487083,9.691054,6142.572315,49731.6391,Benign
192.168.43.224,52052,54.236.156.42,443,31,8175,16,2732,15,5443,2924.110778,61.32627758,356.3888249,710.0382042,Benign
10.0.2.15,44389,119.254.87.201,80,11,1582,6,705,5,877,24697.08941,2.276736,2477.230562,3081.604543,Malicious
172.30.6.255,55768,195.201.82.80,80,64,60733,20,2984,44,57749,62.235038,1.669544,14298.51504,276717.475,Benign
192.168.137.97,46612,172.217.161.14,443,7,466,4,272,3,194,1047.404454,55.58420138,39.14781442,27.92160293,Benign
172.30.6.255,55832,103.231.98.48,80,7,402,4,228,3,174,91.716504,10.260677,177.766048,135.6635629,Benign
172.30.6.255,58517,172.217.166.197,443,31,6656,16,3920,15,2736,5753.099603,5.986135,5238.772597,3656.449445,Benign
10.0.2.15,56169,119.254.87.201,80,11,1582,6,705,5,877,10101.02661,1.415516,3984.412751,4956.49643,Malicious
192.168.137.97,50122,169.237.6.105,80,15,4060,8,1410,7,2650,1955.403317,1.884142113,5986.809552,11251.80519,Benign
10.0.2.15,59657,119.254.87.201,80,11,1579,6,705,5,874,6707.447101,0.90089,6260.475752,7761.213911,Malicious
172.30.15.1010,50316,185.84.60.24,443,28,9743,15,2491,13,7252,3443.736259,3.525989,5651.747637,16453.82331,Benign
192.168.137.97,54646,52.84.108.88,443,8,552,5,338,3,214,383.189997,14.23802942,189.9139213,120.2413585,Benign
10.0.2.15,57047,119.254.87.201,80,11,1582,6,705,5,877,15869.55534,1.355635,4160.41191,5175.434391,Malicious
10.0.2.15,52116,119.254.87.201,80,11,1582,6,705,5,877,13702.27302,1.821962,3095.564013,3850.793815,Malicious
172.30.15.2297,51625,172.217.166.196,443,19,3287,10,1478,9,1809,4923.377827,1.169386,10111.28917,12375.72538,Benign
192.168.43.224,51246,54.236.156.42,443,33,9165,17,4023,16,5142,46.48632036,63.61263277,505.9372423,646.664007,Benign
10.0.2.15,34882,119.254.87.201,80,11,1579,6,705,5,874,26075.77011,0.827829,6813.001236,8446.188766,Malicious
192.168.43.224,42876,54.208.114.197,443,12,796,7,458,5,338,1073.974334,99.59555894,36.78878897,27.14980496,Benign
10.0.2.15,38666,119.254.87.201,80,11,1559,6,705,5,854,7575.828778,0.859216,6564.123573,7951.434796,Malicious
192.168.215.49,52396,104.198.143.177,80,10,911,5,425,5,486,1162.836468,0.778776923,4365.820172,4992.443773,Benign
192.168.137.97,38772,157.240.16.16,443,30,6553,19,5002,11,1551,184.7264095,124.8094667,320.6167052,99.41553573,Benign
10.0.2.15,45681,119.254.87.201,80,11,1513,6,705,5,808,1814.382666,1.693669,3330.048551,3816.566283,Malicious
10.0.2.15,36221,119.254.87.201,80,11,1582,6,705,5,877,11154.47807,1.587223,3553.375928,4420.298849,Malicious
10.0.2.15,56589,119.254.87.201,80,11,1579,6,705,5,874,11570.00874,1.627214,3466.046875,4296.91485,Malicious
172.30.15.1142,50450,104.18.255.119,80,7,402,4,228,3,174,3458.3128,8.909085,204.7348297,156.2450016,Benign
10.0.2.15,55608,119.254.87.201,80,12,1653,7,779,5,874,3225.801601,4.558392,1367.148766,1533.874226,Malicious
192.168.43.233,51102,144.2.1.5,443,47,8815,22,2969,25,5846,918.709585,118.57955,200.3043526,394.4019015,Benign
192.168.215.49,37468,157.240.16.52,443,30,7131,15,1983,15,5148,1357.114582,65.16933575,243.4273699,631.9536562,Benign
10.0.2.15,59578,119.254.87.201,80,11,1513,6,705,5,808,22802.04116,1.052337,5359.499856,6142.518984,Malicious
172.30.15.1680,50991,184.29.25.7,443,32,19236,15,6162,17,13074,3597.151374,9.885697,4986.598315,10580.13411,Benign
172.30.15.1243,50551,87.248.118.22,443,6,348,4,228,2,120,3469.496895,8.126952,224.4383872,118.125467,Benign
172.30.1.136,50767,172.217.161.4,443,33,4511,14,2530,19,1981,1917.589731,4.86064,4164.0607,3260.475987,Benign
172.30.6.255,56605,172.30.6.35,7680,15,1137,9,671,6,466,954.791051,10.7921,497.4008766,345.4378666,Benign
172.30.15.1693,51004,184.29.25.7,443,142,119939,59,30135,83,89804,3609.549616,7.57887,31809.49139,94794.0788,Benign
10.0.2.15,57952,119.254.87.201,80,11,1579,6,705,5,874,25838.42345,2.087942,2701.224459,3348.752025,Malicious
192.168.43.224,38204,205.185.216.42,443,8,484,5,310,3,174,94.64178985,12.05204313,205.7742387,115.4990888,Benign
172.30.15.2331,51664,52.229.170.171,443,34,11993,19,2643,15,9350,5109.95209,141.730591,149.1844481,527.7618577,Benign
172.30.6.255,57751,172.217.166.206,443,38,6507,21,3988,17,2519,3852.40199,126.09137,253.0228675,159.8206126,Benign
172.30.15.1621,50931,54.171.197.251,443,6,348,4,228,2,120,3574.101321,3.121303,584.3713347,307.5638603,Benign
172.30.15.1267,50575,104.20.15.243,80,8,468,5,282,3,186,3469.540114,7.968196,283.1255657,186.7423944,Benign
192.168.137.97,42252,176.9.122.53,443,35,14484,18,2962,17,11522,77.79304859,9.556703646,2479.516042,9645.166724,Benign
10.0.2.15,45022,119.254.87.201,80,13,1730,8,853,5,877,22714.62416,10.011594,681.6097417,700.787507,Malicious
192.168.137.97,57552,104.197.3.80,80,11,977,6,491,5,486,7823.814227,1.688332537,2326.555885,2302.86387,Benign
172.30.6.255,56119,103.243.221.109,80,27,13806,15,11564,12,2242,325.147564,15.304859,6044.616288,1171.915403,Benign
172.30.1.136,50818,172.217.161.3,443,20,2389,10,1357,10,1032,1956.672195,24.503596,443.0370138,336.9301387,Benign
172.30.1.136,50827,172.217.161.14,443,43,13840,22,3445,21,10395,1980.613606,9.450053,2916.38576,8799.950646,Benign
172.30.15.1139,50447,54.169.236.196,80,12,1975,8,1401,4,574,3458.308723,8.914334,1257.300882,515.1254149,Benign
10.0.2.15,35111,119.254.87.201,80,11,1513,6,705,5,808,18750.14093,1.774377,3178.580426,3642.968772,Malicious
172.30.6.255,55732,182.161.72.94,80,12,1974,6,1020,6,954,58.29418,0.418496,19498.39425,18236.73345,Benign
172.30.6.255,57882,103.243.221.75,80,15,5482,9,4309,6,1173,4303.839423,41.192143,836.8586213,227.8104346,Benign
172.30.6.255,57197,103.243.221.109,80,6,340,4,228,2,112,2074.069625,13.95691,130.6879531,64.19759101,Benign
192.168.137.97,39450,158.85.224.171,443,30,6238,17,1789,13,4449,6772.377538,32.98825036,433.8514423,1078.929607,Benign
172.30.6.255,58027,172.30.13.95,7680,3,198,3,198,0,0,4777.78798,9.00029,175.9943291,0,Benign
172.30.15.393,49661,195.154.150.142,80,14,3393,7,990,7,2403,1470.366108,9.799371,808.2151395,1961.758566,Benign
10.0.2.15,41224,119.254.87.201,80,11,1582,6,705,5,877,2955.534201,2.707515,2083.090952,2591.30605,Malicious
10.0.2.15,55893,119.254.87.201,80,11,1579,6,705,5,874,14995.8604,1.621341,3478.601972,4312.479608,Malicious
10.0.2.15,57632,119.254.87.201,80,12,1587,7,779,5,808,26168.78314,3.914979,1591.834848,1651.094425,Malicious
10.0.2.15,37039,119.254.87.201,80,11,1579,6,705,5,874,15384.14049,1.684218,3348.73514,4151.481578,Malicious
172.30.6.255,57202,103.243.221.75,80,16,5442,9,4215,7,1227,2087.852271,12.173799,2769.883091,806.3218392,Benign
172.30.15.2301,51629,172.217.166.196,443,16,3125,8,1370,8,1755,4925.465208,0.198568,55195.19761,70706.2568,Benign
192.168.137.97,52074,172.217.161.3,443,43,10679,22,3034,21,7645,7413.045606,291.7521359,83.19390679,209.6299992,Benign
172.30.15.2466,51800,14.139.45.128,80,39,25880,19,1582,20,24298,5422.544802,0.378584,33429.83327,513450.1194,Benign
172.30.15.1342,50650,35.201.123.46,443,75,15133,32,5036,43,10097,3491.682813,5.351196,7528.784219,15094.94326,Benign
192.168.43.233,51694,52.114.128.43,443,20,7863,11,3169,9,4694,1368.551317,3.965161,6393.687419,9470.485562,Benign
10.0.2.15,57735,119.254.87.201,80,11,1513,6,705,5,808,7668.550323,2.024826,2785.424525,3192.373073,Malicious
172.30.6.255,56224,159.127.41.210,80,11,1476,6,806,5,670,470.032266,6.05755,1064.456752,884.8461837,Benign
172.30.1.136,50683,151.101.0.188,443,30,13952,18,2050,12,11902,1805.552005,23.167583,707.8856694,4109.880603,Benign
10.0.2.15,34138,119.254.87.201,80,12,1587,7,779,5,808,9020.03793,5.126372,1215.674555,1260.930732,Malicious
172.30.15.1711,51022,184.29.25.7,443,200,177979,73,26412,127,151567,3618.867829,8.213449,25725.61174,147628.1158,Benign
192.168.137.97,45526,54.82.135.50,443,55,11436,30,4945,25,6491,4017.446934,120.5622887,328.129139,430.7151145,Benign
192.168.137.97,46438,74.50.21.249,80,6,412,4,272,2,140,569.0515722,23.93088958,90.92850447,46.80143613,Benign
192.168.215.49,60080,192.82.210.131,443,18,6648,10,2259,8,4389,1252.654135,1.524624211,11853.41271,23029.93731,Benign
172.30.15.2420,51754,14.139.45.128,80,10,1424,5,694,5,730,5351.997531,0.070167,79125.51484,83230.00841,Benign
192.168.43.233,50733,172.217.166.206,443,18,5747,8,1219,10,4528,1857.300236,0.334212,29179.08393,108386.2937,Benign
172.30.1.136,51834,13.107.4.52,80,10,1519,5,436,5,1083,3314.480264,0.607868,5738.087874,14253.09442,Benign
172.30.6.255,56020,34.234.151.4,443,36,13625,21,11890,15,1735,229.690735,121.733941,781.3761653,114.0191461,Benign
172.30.6.255,55747,173.241.248.143,80,6,535,4,228,2,307,58.278666,0.448165,4069.929602,5480.124508,Benign
192.168.43.233,51641,52.84.110.227,443,3855,1663547,1822,638000,2033,1025547,842.734688,1422.006822,3589.29361,5769.575696,Benign
172.30.6.255,57378,184.29.26.80,80,13,2580,7,617,6,1963,2634.846867,2.151635,2294.069394,7298.635689,Benign
172.30.6.255,57301,103.243.221.17,80,6,348,4,228,2,120,2403.090772,20.941728,87.09882967,45.8414893,Benign
192.168.43.224,49990,172.217.166.195,443,11,754,6,428,5,326,383.3262451,56.21587127,60.90806605,46.39259236,Benign
172.30.6.255,57737,103.243.221.87,80,39,24248,23,20155,16,4093,3799.833915,45.235159,3564.483989,723.86172,Benign
172.30.15.884,50190,151.101.66.202,80,6,348,4,228,2,120,3437.411192,9.849317,185.1905061,97.46868742,Benign
192.168.215.49,37122,157.240.16.52,443,28,6737,13,1850,15,4887,877.3047226,65.13743157,227.2119063,600.2078844,Benign
172.30.6.255,56191,77.238.185.35,443,32,8346,14,1858,18,6488,466.618826,119.098589,124.8041654,435.8070103,Benign
10.0.2.15,37309,124.95.142.228,80,6724,7297128,1960,106134,4764,7190994,182.239614,46.357489,18315.74614,1240963.504,Malicious
172.30.6.255,57755,103.229.205.254,80,22,2441,12,1367,10,1074,3855.741732,307.294107,35.58805636,27.96018474,Benign
192.168.43.224,48140,104.244.42.200,443,75,15073,39,7733,36,7340,303.9699178,916.635201,67.49031669,64.06038077,Benign
172.30.6.255,56184,103.243.221.75,80,6,348,4,228,2,120,466.107361,24.930577,73.16316827,38.50693067,Benign
192.168.43.224,58264,174.129.238.218,443,9,610,5,338,4,272,567.8780823,87.49808109,30.90353487,24.86911682,Benign
172.30.6.255,56604,103.243.221.87,80,21,11739,14,9760,7,1979,953.868998,43.182759,1808.129027,366.6278016,Benign
172.30.6.255,56270,31.172.81.172,80,21,3308,11,1570,10,1738,530.519504,216.522958,58.00770558,64.21489956,Benign
172.30.15.336,49604,104.25.218.21,443,260,192258,95,7894,165,184364,972.881076,7.35861,8582.055578,200433.5058,Benign
10.0.2.15,48909,119.254.87.201,80,12,1653,7,779,5,874,3161.657749,3.891614,1601.392122,1796.683844,Malicious
172.30.1.136,50483,172.217.161.3,443,53,10276,24,7566,29,2710,922.709577,31.740386,1906.971138,683.0414728,Benign
172.30.6.255,56124,172.64.128.2,443,83,42345,37,3334,46,39011,333.0944,78.656152,339.0961714,3967.750673,Benign
10.0.2.15,60710,119.254.87.201,80,11,1579,6,705,5,874,14785.66274,1.489265,3787.103034,4694.933407,Malicious
172.30.6.255,58454,172.217.166.206,443,47,9691,25,6891,22,2800,5642.409796,83.058298,663.7265791,269.6900917,Benign
172.30.15.2289,51614,104.121.255.145,443,19,2594,10,1458,9,1136,4801.18793,109.982479,106.053256,82.63134349,Benign
192.168.215.49,36662,54.173.224.161,443,14,1660,8,1080,6,580,613.4043028,17.43199957,495.6402141,266.177152,Benign
172.30.6.255,57746,103.243.221.87,80,41,21327,23,16497,18,4830,3844.927454,37.139752,3553.497072,1040.394669,Benign
192.168.43.233,51355,131.253.61.66,443,163,67780,67,19229,96,48551,3086.791056,70.34776,2186.736294,5521.256114,Benign
172.30.15.2250,51567,184.29.25.145,443,63,52109,22,2945,41,49164,4469.371312,8.258292,2852.890162,47626.31304,Benign
192.168.137.97,46362,173.241.248.143,443,33,6549,16,2456,17,4093,348.9620029,87.37837344,224.8611324,374.7380354,Benign
192.168.43.233,50953,104.20.23.135,80,10,3736,6,768,4,2968,466.961803,9.131316,672.8493461,2600.282369,Benign
10.0.2.15,51343,119.254.87.201,80,11,1582,6,705,5,877,9352.397432,2.012394,2802.632089,3486.394811,Malicious
192.168.43.233,51095,117.18.237.116,443,103,38659,49,4212,54,34447,916.873186,185.494375,181.6551041,1485.629955,Benign
172.30.6.255,55623,157.240.16.17,443,16,4988,9,1091,7,3897,5.266771,0.087025,100293.0192,358241.8845,Benign
172.30.6.255,57796,103.243.221.46,80,41,33675,17,6148,24,27527,4041.915178,23.151436,2124.447054,9511.980164,Benign
10.0.2.15,47680,119.254.87.201,80,11,1582,6,705,5,877,24609.50866,0.917516,6147.031768,7646.733136,Malicious
172.30.6.255,56129,103.243.221.87,80,25,15701,10,3256,15,12445,345.849232,23.17668,1123.888322,4295.697227,Benign
172.30.6.255,55999,103.243.221.75,80,29,21026,10,2947,19,18079,223.859391,14.182853,1662.288963,10197.66615,Benign
10.0.2.15,38251,119.254.87.201,80,11,1582,6,705,5,877,1363.886291,0.962639,5858.894144,7288.298106,Malicious
172.30.15.1513,50821,104.20.90.77,443,114,72967,49,4639,65,68328,3524.538132,2.499593,14847.21713,218685.202,Benign
192.168.43.233,51158,173.194.166.76,443,1193,956122,538,36752,655,919370,479.611053,83.437394,3523.791743,88149.44532,Benign
10.0.2.15,36777,119.254.87.201,80,11,1534,6,705,5,829,15449.14281,1.296439,4350.378228,5115.551137,Malicious
192.168.43.224,45662,209.197.3.15,80,24,9438,13,1120,11,8318,804.2731212,30.11398567,297.5361714,2209.737387,Benign
172.30.15.1875,51187,54.201.241.25,443,6,348,4,228,2,120,3961.872846,5.682672,320.9757663,168.9346139,Benign
10.0.2.15,33824,119.254.87.201,80,11,1513,6,705,5,808,4543.111746,0.880414,6406.077141,7342.000468,Malicious
172.30.15.1784,51096,172.217.194.156,443,28,6686,14,2292,14,4394,3642.279667,4.896865,3744.436492,7178.470307,Benign
10.0.2.15,55957,119.254.87.201,80,12,1653,7,779,5,874,14335.3127,7.032056,886.2272997,994.3037996,Malicious
10.0.2.15,43457,119.254.87.201,80,11,1582,6,705,5,877,20254.71657,3.693308,1527.086287,1899.652019,Malicious
172.30.6.255,57833,157.240.16.39,443,4,264,1,66,3,198,4144.089653,15.140172,34.87410843,104.6223253,Benign
192.168.43.233,51139,52.68.47.152,443,32,7724,17,2680,15,5044,925.506523,111.500036,192.2869334,361.9012284,Benign
172.30.6.255,56326,147.75.111.32,80,5,294,3,174,2,120,590.944036,15.137583,91.95655608,63.41831454,Benign
172.30.6.255,57043,115.114.126.194,443,16,6794,9,1108,7,5686,1610.138828,10.121633,875.7480142,4494.13647,Benign
192.168.137.97,53276,52.222.190.164,443,23,8439,13,1662,10,6777,306.6176096,10.91833216,1217.768411,4965.593575,Benign
172.30.15.639,49926,52.84.110.77,443,508,406625,229,15660,279,390965,2394.067232,12.109646,10345.4717,258283.3553,Benign
192.168.42.240,50986,35.188.42.15,443,35,8267,18,3376,17,4891,310.531512,61.125427,441.8455842,640.1264076,Benign
192.168.137.97,56482,172.217.161.14,443,13,1758,8,1126,5,632,1718.30907,28.38023755,317.4039677,178.1521381,Benign
10.0.2.15,38994,119.254.87.201,80,11,1579,6,705,5,874,15509.2029,1.291847,4365.842085,5412.405649,Malicious
192.168.137.97,46546,151.101.193.170,443,21,9399,12,1458,9,7941,382.7902519,17.02435405,685.1361272,3731.595327,Benign
172.30.15.375,49643,62.210.213.13,80,20,10891,9,893,11,9998,1443.11226,7.441615,960.0066652,10748.20452,Benign
10.0.2.15,36710,119.254.87.201,80,11,1582,6,705,5,877,7007.765445,5.027536,1121.821902,1395.514622,Malicious
10.0.2.15,44304,119.254.87.201,80,11,1582,6,705,5,877,8539.454578,1.685533,3346.122562,4162.481541,Malicious
192.168.215.49,58900,35.187.217.213,443,23,9328,13,2115,10,7213,1296.172295,14.33041227,1180.705738,4026.681082,Benign
172.30.6.255,57642,103.231.98.53,80,175,90952,89,82520,86,8432,3496.862305,348.106191,1896.432804,193.7799492,Benign
172.30.6.255,57571,103.243.221.51,80,25,12627,14,10416,11,2211,3256.311077,25.756452,3235.228206,686.7405495,Benign
192.168.43.224,51866,54.197.248.134,443,73,46016,38,6610,35,39406,2406.385198,22.27960146,2373.471541,14149.62474,Benign
172.30.15.1467,50775,103.231.98.244,443,8,664,5,490,3,174,3506.380644,0.313723,12495.09918,4437.035219,Benign
172.30.6.255,58508,103.243.221.87,80,29,18046,12,5401,17,12645,5747.869035,1.347777,32058.71594,75056.92707,Benign
172.30.6.255,58254,172.217.194.189,443,22,5002,12,1094,10,3908,5243.530455,96.693636,90.51267862,323.3304827,Benign
172.30.1.136,51874,172.217.160.228,443,9,534,5,294,4,240,4186.096904,18.801342,125.0974531,102.1203699,Benign
172.30.6.255,57973,131.253.61.102,443,77,30766,32,7809,45,22957,4686.891609,65.348111,955.9878479,2810.425538,Benign
172.30.15.789,50081,34.200.202.18,443,27,14222,13,4990,14,9232,2674.749447,1.792144,22274.99576,41210.97412,Benign
192.168.42.240,50930,74.125.68.189,443,52,10006,25,3630,27,6376,28.932661,262.737212,110.5286905,194.1407523,Benign
192.168.43.224,43410,172.217.161.14,443,9,618,5,338,4,280,2895.111084,13.98480254,193.3527479,160.173874,Benign
10.0.2.15,57447,119.254.87.201,80,11,1579,6,705,5,874,12353.258,1.548897,3641.300874,4514.180091,Malicious
10.0.2.15,49611,119.254.87.201,80,11,1513,6,705,5,808,11239.57373,1.612633,3497.385952,4008.351559,Malicious
10.0.2.15,40529,219.234.85.243,80,2,138,1,74,1,64,89.924314,0.361669,1636.855799,1415.659069,Malicious
172.30.6.255,58345,52.213.19.114,443,15,2949,8,2251,7,698,5420.598517,8.590022,2096.385783,650.0565423,Benign
172.30.15.949,50255,103.243.221.108,443,32,15669,17,6806,15,8863,3441.276389,5.985236,9097.051478,11846.48358,Benign
192.168.43.224,36094,136.146.210.117,443,4,272,2,140,2,132,94.33421006,11.6837405,95.85971203,90.3820142,Benign
172.30.6.255,57820,157.240.16.39,443,5,330,1,66,4,264,4083.087598,15.143854,34.86562932,139.4625173,Benign
10.0.2.15,60255,119.254.87.201,80,12,1656,7,779,5,877,19140.51878,6.121592,1018.035831,1146.107091,Malicious
172.30.15.908,50214,104.244.42.72,443,11,1376,7,958,4,418,3439.68662,7.259911,1055.660324,460.6117072,Benign
10.0.2.15,47212,119.254.87.201,80,12,1656,7,779,5,877,21696.33891,4.105171,1518.085361,1709.064007,Malicious
192.168.43.224,39070,103.37.200.184,443,17,1902,9,1182,8,720,2513.992089,27.96150802,338.1791852,205.9974732,Benign
192.168.43.233,51408,151.101.152.223,443,15,897,8,459,7,438,3646.670991,142.807896,25.71286394,24.5364584,Benign
10.0.2.15,49784,119.254.87.201,80,11,1579,6,705,5,874,401.000067,0.819678,6880.750734,8530.178924,Malicious
192.168.137.97,39336,54.87.224.116,443,35,8756,17,3463,18,5293,4067.926363,4.561896013,6072.913526,9282.105484,Benign
10.0.2.15,51513,119.254.87.201,80,12,1587,7,779,5,808,18026.81153,4.103175,1518.823838,1575.365418,Malicious
192.168.137.97,49270,157.240.16.52,443,10,676,8,536,2,140,4025.37555,20.81550845,206.0002527,53.80603614,Benign
10.0.2.15,42261,119.254.87.201,80,11,1582,6,705,5,877,26165.85545,1.423487,3962.101516,4928.741885,Malicious
172.30.6.255,55629,157.240.16.37,443,1285,1159334,457,39811,828,1119523,14.479699,44.236335,7199.692289,202462.1615,Benign
10.0.2.15,34390,119.254.87.201,80,11,1579,6,705,5,874,5834.203682,1.547213,3645.264097,4519.093363,Malicious
192.168.137.97,58708,104.17.162.9,443,36,13926,19,2344,17,11582,26.37679111,10.99827006,1704.995412,8424.597638,Benign
192.168.43.233,50957,163.53.78.128,80,12,1132,7,414,5,718,473.508816,16.570914,199.8682752,346.6314532,Benign
192.168.43.233,51440,192.0.73.2,80,21,8615,10,1053,11,7562,3802.208202,89.082181,94.56436636,679.1032653,Benign
172.30.6.255,56480,13.107.3.128,443,18,8754,9,1372,9,7382,803.629867,9.272252,1183.746947,6369.110762,Benign
10.0.2.15,56943,119.254.87.201,80,11,1579,6,705,5,874,15294.08166,2.08917,2699.636698,3346.783651,Malicious
192.168.43.224,34084,52.84.108.208,443,46,18856,26,3247,20,15609,2885.163607,140.6352901,184.7047066,887.9136944,Benign
172.30.6.255,57656,157.240.16.39,443,28,5420,15,3275,13,2145,3534.090467,61.070501,429.0123639,280.9867239,Benign
172.30.1.136,50123,52.230.84.0,443,41,9955,23,3829,18,6126,102.221531,1715.608345,17.854891,28.56596037,Benign
10.0.2.15,35212,119.254.87.201,80,11,1579,6,705,5,874,23525.68687,2.087295,2702.061759,3349.790039,Malicious
192.168.43.233,51162,74.125.170.249,443,29,10146,13,3298,16,6848,481.67544,6.292082,4193.206637,8706.815963,Benign
172.30.6.255,57317,103.243.221.51,80,32,23480,12,4659,20,18821,2467.839443,43.188653,863.0044563,3486.286085,Benign
172.30.6.255,58531,35.190.41.40,443,85,18813,38,6009,47,12804,5790.841886,8.267699,5814.435189,12389.42056,Benign
172.30.6.255,57386,103.243.221.75,80,40,28295,25,24254,15,4041,2664.836817,17.27679,11230.78998,1871.180931,Benign
172.30.1.136,50797,151.101.129.181,443,20,1924,10,1132,10,792,1931.886919,29.613485,305.8066283,213.9565809,Benign
172.30.1.136,50236,74.125.68.188,443,30,3791,17,2587,13,1204,433.074769,318.294196,65.02160661,30.26131208,Benign
172.30.6.255,57602,161.69.226.18,443,19,5301,11,2412,8,2889,3366.080509,138.871145,138.9489516,166.4276621,Benign
10.0.2.15,42151,119.254.87.201,80,11,1582,6,705,5,877,9142.199258,1.218696,4627.897359,5756.973027,Malicious
172.30.1.136,50267,104.17.161.9,443,11,1688,6,1394,5,294,481.707055,9.403643,1185.92337,250.1158328,Benign
192.168.43.233,50726,172.217.24.232,443,18,5316,9,1285,9,4031,1846.534395,12.028971,854.6034403,2680.861065,Benign
10.0.2.15,43071,119.254.87.201,80,11,1579,6,705,5,874,9953.149973,1.731838,3256.655646,4037.329127,Malicious
192.168.43.233,51123,13.228.37.108,443,7,402,4,228,3,174,920.394594,19.514206,93.47036718,71.33264864,Benign
10.0.2.15,39376,119.254.87.201,80,12,1653,7,779,5,874,18599.9703,4.378922,1423.181322,1596.74002,Malicious
172.30.15.627,49914,172.217.160.226,80,6,348,4,228,2,120,2392.30722,3.829127,476.3487866,250.7098877,Benign
172.30.6.255,56883,103.231.98.244,80,9,522,6,348,3,174,1385.017898,22.609858,123.1321311,61.56606556,Benign
10.0.2.15,56273,119.254.87.201,80,12,1656,7,779,5,877,19017.79985,3.996706,1559.28407,1755.445609,Malicious
10.0.2.15,39026,219.234.85.243,80,2,138,1,74,1,64,23.51789,0.326816,1811.416822,1566.630765,Malicious
172.30.15.944,50250,23.58.57.98,443,17,3198,9,2017,8,1181,3441.193498,5.823284,2770.945054,1622.452211,Benign
172.30.6.255,57374,157.240.16.39,443,27,5469,15,3413,12,2056,2619.091969,61.04567,447.2716902,269.4376194,Benign
172.30.15.2417,51751,14.139.45.128,80,170,154244,62,4012,108,150232,5350.986836,1.02153,31419.53736,1176525.408,Benign
172.30.1.136,50817,172.217.161.3,443,12,708,7,414,5,294,1956.622488,24.699722,134.090578,95.22374381,Benign
10.0.2.15,51180,119.254.87.201,80,12,1587,7,779,5,808,24759.68707,7.338635,849.2042457,880.8177543,Malicious
172.30.6.255,58583,157.240.16.17,443,105,68982,51,4524,54,64458,5881.605122,0.742577,48738.37999,694424.9553,Benign
172.30.15.1594,50903,157.240.16.20,443,47,24531,24,2246,23,22285,3572.836349,4.280418,4197.720877,41650.13791,Benign
172.30.6.255,56415,103.243.223.145,443,28,13508,15,5579,13,7929,678.696102,85.046872,524.7929636,745.8475369,Benign
172.30.6.255,57047,103.243.221.17,80,51,36227,23,10049,28,26178,1614.861856,7.011425,11465.85751,29868.96387,Benign
172.30.6.255,58185,157.240.16.20,443,453,305989,204,19546,249,286443,5041.907503,72.359456,2160.989159,31668.8948,Benign
172.30.6.255,55850,172.217.167.34,80,58,38698,23,3386,35,35312,103.295034,242.544785,111.6824672,1164.716858,Benign
10.0.2.15,33134,119.254.87.201,80,11,1593,6,705,5,888,24279.04409,1.001471,5631.715746,7093.565365,Malicious
172.30.15.1709,51020,184.29.25.7,443,24,5189,12,2125,12,3064,3617.920036,9.161472,1855.597004,2675.552575,Benign
10.0.2.15,52535,119.254.87.201,80,11,1582,6,705,5,877,19110.4575,2.290996,2461.811369,3062.423505,Malicious
172.30.6.255,56735,103.243.221.75,80,14,5505,9,5231,5,274,1222.955589,0.568375,73627.44667,3856.608753,Benign
172.30.6.255,55762,103.231.98.43,80,64,27402,28,22047,36,5355,61.680377,167.845239,1050.825159,255.2351217,Benign
172.30.15.1678,50989,162.247.242.19,443,7,398,4,228,3,170,3596.955637,10.279054,177.448236,132.3078953,Benign
10.0.2.15,40652,119.254.87.201,80,11,1579,6,705,5,874,12861.16577,2.226894,2532.675556,3139.7992,Malicious
10.0.2.15,50185,119.254.87.201,80,11,1513,6,705,5,808,371.020017,1.614078,3494.254924,4004.763091,Malicious
172.30.1.136,51886,13.75.122.216,443,22,8795,14,2532,8,6263,4465.70525,0.79029,25631.09745,63399.51157,Benign
172.30.1.136,50677,172.217.161.14,443,26,7423,16,2473,10,4950,1804.192868,24.520456,806.836545,1614.978123,Benign
10.0.2.15,58613,119.254.87.201,80,11,1534,6,705,5,829,25177.63564,5.071594,1112.0764,1307.675654,Malicious
172.30.6.255,56260,31.172.81.158,80,6,348,4,228,2,120,529.952633,36.405468,50.10236374,26.36966513,Benign
172.30.1.136,50789,151.101.129.181,443,19,2861,11,2208,8,653,1925.407015,7.970011,2216.308108,655.4570627,Benign
172.30.6.255,56589,13.107.21.200,443,28,9074,15,1302,13,7772,901.258923,105.40555,98.81832598,589.8740626,Benign
172.30.1.136,50644,157.240.16.20,443,19,5288,10,1209,9,4079,1746.376799,28.101399,344.1821526,1161.223326,Benign
10.0.2.15,58500,119.254.87.201,80,11,1579,6,705,5,874,15324.1167,1.449666,3890.551341,4823.17996,Malicious
172.30.6.255,56846,104.122.99.56,80,20,8904,11,1301,9,7603,1339.214517,86.189104,120.7577236,705.7040528,Benign
172.30.6.255,57048,54.194.27.245,443,220,82294,128,66251,92,16043,1615.796522,983.698521,538.7910917,130.4708681,Benign
192.168.43.233,51248,172.217.161.3,443,46,5927,22,3755,24,2172,1957.028571,245.771768,122.2272202,70.69973961,Benign
172.30.1.136,51865,172.217.160.238,443,13,1445,8,995,5,450,4168.84791,15.781961,504.3733158,228.1085348,Benign
10.0.2.15,38825,119.254.87.201,80,12,1653,7,779,5,874,5147.952107,4.93397,1263.080238,1417.114413,Malicious
192.168.215.49,49834,172.217.161.14,443,21,5934,11,1344,10,4590,878.1297946,101.6812155,105.742245,361.1286493,Benign
192.168.43.233,51664,54.255.158.169,443,14,1587,8,1024,6,563,870.209211,23.737701,345.1050293,189.7403628,Benign
192.168.137.97,46818,52.84.110.231,443,8,552,5,338,3,214,1334.668099,20.87783307,129.5153568,82.00084722,Benign
192.168.137.97,43400,52.222.190.38,443,1031,906350,398,34422,633,871928,174.9107783,131.8602717,2088.392481,52900.1185,Benign
172.30.1.136,50500,172.217.163.133,443,36,7048,17,3829,19,3219,964.335289,62.770033,488.0035669,410.2594625,Benign
172.30.6.255,58483,103.243.221.87,80,15,5491,9,4317,6,1174,5682.843489,6.406679,5390.624378,1465.970123,Benign
172.30.15.230,49499,111.221.29.40,443,33,12805,17,6521,16,6284,50.25222,0.677016,77055.78598,74255.26132,Benign
192.168.43.224,45660,209.197.3.15,80,23,9148,12,1085,11,8063,804.2730869,30.11368756,288.2410194,2142.015981,Benign
10.0.2.15,33550,119.254.87.201,80,11,1579,6,705,5,874,17401.57579,1.420454,3970.561525,4922.36989,Malicious
192.168.137.97,52502,172.217.163.142,443,58,13313,29,5326,29,7987,19.75459585,283.5448393,150.2690019,225.3470744,Benign
172.30.6.255,56159,103.243.221.17,80,29,21266,11,3310,18,17956,406.952789,4.840304,5470.730764,29677.4748,Benign
192.168.137.97,43978,104.244.42.67,443,43,2918,22,1440,21,1478,23.68003561,853.6059184,13.495689,13.85182523,Benign
172.30.6.255,57075,180.149.59.232,80,419,298438,261,227734,158,70704,1680.047166,1368.970527,1330.833618,413.1805534,Benign
10.0.2.15,47531,119.254.87.201,80,11,1582,6,705,5,877,26045.75111,0.89311,6315.011589,7855.695267,Malicious
10.0.2.15,59062,119.254.87.201,80,11,1582,6,705,5,877,25568.09847,1.225693,4601.478511,5724.108729,Malicious
10.0.2.15,40708,119.254.87.201,80,11,1579,6,705,5,874,7368.207205,2.935049,1921.603353,2382.243022,Malicious
172.30.1.136,50636,172.217.160.228,443,38,5601,18,2171,20,3430,1738.941542,56.859276,305.4558767,482.5949595,Benign
172.30.15.2232,51549,104.121.244.70,443,301,222961,143,26689,158,196272,4457.925738,10.73325,19892.57681,146290.8252,Benign
10.0.2.15,60348,119.254.87.201,80,11,1582,6,705,5,877,14873.52296,1.495051,3772.446559,4692.816499,Malicious
192.168.137.97,57386,172.217.160.237,443,2,120,1,66,1,54,1.170013435,0.045803375,11527.53482,9431.619395,Benign
10.0.2.15,60369,119.254.87.201,80,11,1579,6,705,5,874,12986.13633,1.419135,3974.251921,4926.944935,Malicious
172.30.6.255,56364,217.12.15.83,443,5,294,3,174,2,120,607.751081,24.297324,57.29025962,39.51052388,Benign
192.168.42.240,50948,13.35.130.15,443,455,290849,185,40624,270,250225,179.533709,47.320507,6867.889222,42303.01252,Benign
192.168.137.97,46954,52.84.110.17,443,11,1529,7,1038,4,491,1755.108508,11.56348426,718.1226536,339.6900028,Benign
172.30.15.2434,51768,14.139.45.128,80,50,39964,19,1462,31,38502,5418.293309,0.447923,26111.63079,687653.9048,Benign
172.30.6.255,58007,157.240.16.39,443,35,12025,21,9287,14,2738,4743.384091,30.500719,2435.877003,718.147005,Benign
172.30.15.2175,51487,77.88.21.119,443,141,114031,54,6614,87,107417,4250.981144,17.314448,3055.944954,49631.15197,Benign
10.0.2.15,42376,119.254.87.201,80,11,1585,6,705,5,880,11364.67491,1.441388,3912.895071,4884.181081,Malicious
192.168.43.224,35162,35.171.73.174,443,16,5004,9,1258,7,3746,1252.702509,27.10496284,371.2973178,1105.627784,Benign
172.30.6.255,55627,157.240.16.16,443,65,27001,34,13908,31,13093,7.968098,67.855445,1639.721028,1543.634413,Benign
172.30.6.255,56739,103.243.221.46,80,24,12441,13,10222,11,2219,1224.069177,18.666687,4380.852371,950.9989641,Benign
172.30.6.255,55633,117.18.232.131,80,286,199858,109,10892,177,188966,34.667034,23.913935,3643.733246,63215.35958,Benign
10.0.2.15,46552,119.254.87.201,80,11,1582,6,705,5,877,8716.923753,2.100522,2685.04686,3340.122122,Malicious
172.30.6.255,57112,52.175.23.79,443,24,9836,11,1987,13,7849,1816.366658,124.262846,127.922388,505.3159655,Benign
10.0.2.15,49123,119.254.87.201,80,11,1582,6,705,5,877,18452.94705,3.411337,1653.310711,2056.671622,Malicious
172.30.15.714,50001,104.17.146.111,443,21,3624,11,1651,10,1973,2406.260034,9.929239,1330.212718,1589.648512,Benign
172.30.6.255,56410,103.243.220.231,80,30,18128,17,15791,13,2337,676.84873,21.203362,5957.923088,881.7469607,Benign
192.168.43.233,51178,172.217.166.206,443,8,480,4,240,4,240,1042.663352,33.536886,57.25039588,57.25039588,Benign
192.168.137.97,35842,103.102.166.240,443,30,4393,16,2537,14,1856,5667.849189,180.8039006,112.2542154,82.12212207,Benign
172.30.15.1773,51085,52.84.108.56,443,26,8252,14,1877,12,6375,3641.65464,5.512554,2723.964246,9251.610052,Benign
172.30.6.255,58579,210.176.156.21,80,1,66,1,66,0,0,5880.115745,0,0,0,Benign
10.0.2.15,48852,119.254.87.201,80,11,1582,6,705,5,877,68.253256,1.810415,3115.307816,3875.354546,Malicious
172.30.15.1106,50414,180.149.59.138,80,6,348,4,228,2,120,3458.263245,8.769066,208.0039083,109.4757412,Benign
192.168.43.233,51150,182.161.72.94,443,4,240,2,120,2,120,926.019346,10.728075,89.48483302,89.48483302,Benign
192.168.43.224,45938,104.31.92.239,80,39,12632,20,2240,19,10392,804.2816316,76.62582341,233.8637186,1084.960609,Benign
172.30.6.255,56316,66.117.28.68,80,6,348,4,228,2,120,590.941749,15.054568,121.1592388,63.76802044,Benign
172.30.15.514,49797,23.9.250.106,443,285,198609,140,95888,145,102721,2052.693027,13.394688,57269.26973,61350.2905,Benign
172.30.1.136,50685,151.139.105.14,443,39,13955,22,4325,17,9630,1806.161301,19.356184,1787.542421,3980.123355,Benign
172.30.6.255,55834,74.125.11.41,443,20,6384,11,1252,9,5132,98.80968,11.333562,883.746875,3622.515146,Benign
172.30.6.255,57435,157.240.16.39,443,19,1933,10,1125,9,808,2802.091066,61.020047,147.4925118,105.9323996,Benign
192.168.137.97,55964,169.44.84.154,443,34,9310,18,4316,16,4994,2863.007987,2.101116159,16433.17046,19014.65553,Benign
172.30.6.255,57023,103.243.221.51,80,23,10506,14,8316,9,2190,1548.861406,45.230288,1470.872792,387.35106,Benign
192.168.43.224,58226,162.213.83.13,443,13,1610,7,1038,6,572,106.593377,33.74840767,246.0560534,135.5915824,Benign
172.30.6.255,56590,157.240.16.39,443,28,5547,15,3399,13,2148,911.094619,61.054316,445.3739192,281.4543037,Benign
172.30.15.2269,51587,146.185.29.13,443,28,11364,14,2069,14,9295,4527.45691,10.416228,1589.058918,7138.860632,Benign
172.30.6.255,58432,157.240.16.17,443,1236,1079046,493,31382,743,1047664,5604.264818,14.767566,17000.49961,567548.64,Benign
10.0.2.15,33908,119.254.87.201,80,11,1582,6,705,5,877,491.087037,1.778817,3170.646559,3944.194372,Malicious
172.30.6.255,55879,199.166.0.200,443,19,8825,9,1710,10,7115,108.340608,0.617152,22166.33828,92230.11511,Benign
172.30.6.255,56944,199.166.0.200,443,29,14475,15,3003,14,11472,1388.126396,0.741402,32403.47342,123787.0953,Benign
172.30.6.255,57340,192.0.73.2,443,31,4644,16,2112,15,2532,2475.727667,180.732186,93.48639207,112.0774359,Benign
172.30.15.920,50226,184.29.24.49,443,34,19875,16,2173,18,17702,3440.031177,6.969351,2494.349904,20319.82605,Benign
172.30.1.136,50553,54.229.103.82,443,42,12072,23,4822,19,7250,1471.792099,100.268116,384.7284814,578.4490855,Benign
10.0.2.15,43238,119.254.87.201,80,11,1579,6,705,5,874,4036.667731,1.302763,4329.260195,5367.054483,Malicious
192.168.43.233,51039,49.44.170.2,443,52,22203,24,3436,28,18767,820.532228,318.495097,86.30588119,471.391872,Benign
10.0.2.15,56988,119.254.87.201,80,11,1582,6,705,5,877,12711.02716,2.229074,2530.198639,3147.495328,Malicious
10.0.2.15,54076,119.254.87.201,80,11,1513,6,705,5,808,13013.9237,2.219525,2541.084241,2912.334846,Malicious
10.0.2.15,54697,119.254.87.201,80,11,1579,6,705,5,874,19263.72109,1.684999,3347.182995,4149.557359,Malicious
172.30.6.255,56155,172.217.166.210,443,32,6972,15,2189,17,4783,406.085045,5.571685,3143.034827,6867.581351,Benign
172.30.15.832,50133,34.232.42.95,443,6,348,4,228,2,120,3199.335924,7.752758,235.2711126,123.8269013,Benign
10.0.2.15,48546,119.254.87.201,80,12,1656,7,779,5,877,11634.99591,4.382572,1421.996033,1600.88642,Malicious
172.30.15.1165,50473,210.176.156.62,80,21,11238,10,3715,11,7523,3460.537942,6.73914,4410.058257,8930.516357,Benign
192.168.43.224,40128,54.243.243.77,443,9,610,5,338,4,272,2270.016118,74.95603399,36.07448068,29.03035131,Benign
172.30.15.1026,50332,151.101.130.49,80,6,348,4,228,2,120,3446.756903,0.503636,3621.663265,1906.13856,Benign
172.30.6.255,56923,52.192.95.113,80,6,348,4,228,2,120,1386.864684,17.652056,103.3307395,54.38459973,Benign
172.30.15.1177,50485,104.36.113.23,443,23,7016,12,1441,11,5575,3464.38581,3.812417,3023.803535,11698.61534,Benign
192.168.137.97,44890,104.17.41.113,443,177,101598,89,7438,88,94160,26.10412773,150.3530614,395.7618118,5010.07424,Benign
172.30.6.255,56298,209.205.217.82,80,6,348,4,228,2,120,569.160183,19.931701,91.51251065,48.16447929,Benign
172.30.1.136,51871,74.125.24.188,443,26,2741,13,1549,13,1192,4185.544908,163.209659,75.92687881,58.42791449,Benign
172.30.15.783,50075,52.84.108.93,443,16,5114,9,1567,7,3547,2674.648214,1.666356,7523.002288,17028.77416,Benign
10.0.2.15,47105,119.254.87.201,80,11,1582,6,705,5,877,2322.974781,1.641221,3436.465899,4274.866091,Malicious
192.168.137.97,57712,104.197.3.80,80,11,977,6,491,5,486,9323.813364,1.597359438,2459.05831,2434.016983,Benign
172.30.1.136,50352,172.217.161.4,443,43,5099,21,2970,22,2129,632.587927,194.865995,121.9299447,87.40365398,Benign
192.168.43.233,51463,172.217.160.238,443,20,5673,10,1175,10,4498,3814.927924,76.160801,123.4230717,472.4740224,Benign
10.0.2.15,35344,119.254.87.201,80,11,1579,6,705,5,874,12505.73532,1.682108,3352.935721,4156.689107,Malicious
192.168.43.224,58368,23.23.105.113,443,9,610,5,338,4,272,106.5371169,68.43862175,39.50985468,31.79491264,Benign
172.30.6.255,56418,217.182.126.163,80,10,2038,6,1236,4,802,678.978745,1.391281,7107.119266,4611.577388,Benign
172.30.6.255,57762,103.243.220.231,80,66,51982,30,18435,36,33547,3910.874982,65.170743,2262.97865,4118.044197,Benign
172.30.6.255,55749,184.29.25.122,443,23,11676,12,4477,11,7199,58.311693,0.28642,125047.1336,201075.3439,Benign
192.168.43.224,35468,104.198.143.177,80,11,977,6,491,5,486,2723.813749,1.466585051,2678.330859,2651.056614,Benign
192.168.43.233,50884,104.16.92.188,80,12,1391,6,569,6,822,72.225143,47.766442,95.29702882,137.6698729,Benign
172.30.6.255,55863,50.116.239.135,443,22,6310,12,2272,10,4038,104.905195,7.635946,2380.320657,4230.517083,Benign
172.30.15.262,49525,184.85.125.146,443,21,8167,10,1229,11,6938,92.418579,0.7725,12727.50809,71849.83819,Benign
192.168.43.224,35972,34.224.176.220,443,34,8079,18,3206,16,4873,992.2367221,152.662998,168.0040373,255.3598483,Benign
172.30.6.255,58381,173.241.248.220,80,6,535,4,228,2,307,5485.113941,5.039888,361.9128044,487.3124165,Benign
172.30.6.255,56809,172.30.20.1,445,6,360,3,198,3,162,1272.405194,1.124231,1408.963105,1152.787995,Benign
10.0.2.15,60448,119.254.87.201,80,11,1582,6,705,5,877,6377.071649,0.890772,6331.586534,7876.314029,Malicious
192.168.137.97,49204,52.84.109.5,443,373,131014,188,17700,185,113314,3808.37209,206.6347188,685.2672232,4387.026561,Benign
172.30.15.2227,51543,117.18.237.29,80,15,3128,9,1204,6,1924,4450.205434,91.235024,105.5734912,168.7071404,Benign
192.168.43.233,51639,52.46.6.89,443,1769,1473235,741,44675,1028,1428560,839.56698,211.366597,1690.901046,54069.47059,Benign
172.30.6.255,57205,172.217.166.195,443,57,10426,26,3194,31,7232,2089.11016,282.033112,90.59929105,205.1390335,Benign
192.168.43.233,50709,204.79.197.213,443,50,21753,25,8021,25,13732,1843.355958,2.744038,23384.51581,40034.43101,Benign
10.0.2.15,45745,119.254.87.201,80,11,1579,6,705,5,874,70.505455,1.835739,3072.332178,3808.820317,Malicious
192.168.137.97,43106,52.84.110.229,443,8,552,5,338,3,214,1041.966799,12.09787633,223.5103027,141.5124402,Benign
172.30.15.674,49961,104.31.90.207,80,88,68889,38,4711,50,64178,2397.492523,8.781402,4291.797597,58467.20148,Benign
172.30.6.255,57153,103.243.220.231,80,17,5534,9,4245,8,1289,1921.877125,20.206088,1680.681585,510.3412397,Benign
192.168.43.233,51029,163.53.78.128,443,247,173507,108,44895,139,128612,818.539477,69.152964,5193.703628,14878.55242,Benign
10.0.2.15,33543,119.254.87.201,80,11,1513,6,705,5,808,24904.34865,2.11424,2667.625246,3057.363402,Malicious
192.168.215.49,38454,158.85.224.176,443,29,8236,15,3350,14,4886,1862.822852,1.235481165,21691.95352,31637.87608,Benign
172.30.15.402,49674,62.210.213.13,80,6,348,4,228,2,120,1486.778517,3.792963,480.8905333,253.1002807,Benign
172.30.15.649,49936,146.88.138.85,80,6,348,4,228,2,120,2395.564274,0.732273,2490.874305,1310.986476,Benign
10.0.2.15,43978,119.254.87.201,80,11,1579,6,705,5,874,23675.82445,1.356234,4158.574405,5155.452525,Malicious
172.30.1.136,50670,151.101.1.181,443,10,588,6,348,4,240,1802.016269,23.471854,118.6101447,81.80009981,Benign
172.30.1.136,50137,104.17.161.9,443,9,534,5,294,4,240,113.564657,18.621475,126.305784,103.1067625,Benign
10.0.2.15,52349,119.254.87.201,80,11,1582,6,705,5,877,16560.41264,1.457149,3870.571918,4814.881663,Malicious
172.30.6.255,57097,172.30.10.168,445,3,198,3,198,0,0,1758.346953,9.004253,175.9168695,0,Benign
172.30.15.370,49638,62.210.213.13,80,42,29620,17,2127,25,27493,1442.717406,7.836466,2171.386949,28066.73314,Benign
192.168.43.233,51428,104.131.222.33,80,178,139029,78,8063,100,130966,3788.458059,30.556227,2110.993612,34288.52653,Benign
10.0.2.15,57168,119.254.87.201,80,11,1579,6,705,5,874,7610.687926,2.096804,2689.807917,3334.598751,Malicious
10.0.2.15,52192,119.254.87.201,80,11,1579,6,705,5,874,7458.295528,3.749817,1504.073399,1864.624327,Malicious
192.168.43.233,51191,172.217.161.5,443,11,643,6,349,5,294,646.041018,58.889174,47.41109121,39.93942927,Benign
10.0.2.15,41685,119.254.87.201,80,11,1579,6,705,5,874,21059.9768,1.642641,3433.495207,4256.560015,Malicious
172.30.6.255,56653,172.30.10.168,80,3,198,3,198,0,0,1079.360258,9.002024,175.9604285,0,Benign
192.168.43.224,41322,52.10.2.252,443,27,9541,15,3440,12,6101,116.1129131,62.82769026,438.0234239,776.8549154,Benign
192.168.43.233,50865,172.217.166.206,443,4,216,2,108,2,108,0.010516,3.120991,276.8351463,276.8351463,Benign
172.30.6.255,57313,104.36.113.23,443,4,240,2,120,2,120,2453.917503,10.689702,89.8060582,89.8060582,Benign
172.30.1.136,50176,172.217.161.3,443,2,132,2,132,0,0,347.000317,9.000669,117.3246122,0,Benign
172.30.15.284,49547,172.217.166.197,443,35,10574,17,3794,18,6780,328.981732,5.783548,5247.989642,9378.326245,Benign
10.0.2.15,50571,119.254.87.201,80,11,1582,6,705,5,877,14004.91354,1.223475,4609.820389,5734.485788,Malicious
10.0.2.15,38085,119.254.87.201,80,11,1582,6,705,5,877,848.974389,0.828726,6805.62695,8466.006859,Malicious
192.168.137.97,60182,172.217.161.4,443,59,11893,27,3173,32,8720,4013.204461,247.6067391,102.5174036,281.7370814,Benign
10.0.2.15,54191,119.254.87.201,80,11,1579,6,705,5,874,5143.658619,1.816367,3105.099355,3849.442321,Malicious
10.0.2.15,59310,119.254.87.201,80,11,1568,6,705,5,863,20281.76616,2.213428,2548.083787,3119.143699,Malicious
192.168.43.233,51215,172.217.160.229,443,39,7382,19,4169,20,3213,1442.956286,276.133672,120.7820827,93.08535179,Benign
172.30.6.255,56225,54.221.241.51,80,6,348,4,228,2,120,469.969819,21.092578,86.47591584,45.51363992,Benign
10.0.2.15,34468,119.254.87.201,80,11,1587,6,705,5,882,22804.7229,0.993706,5675.723001,7100.691754,Malicious
172.30.6.255,58099,161.69.38.37,80,7,398,4,228,3,170,4873.908177,0.586123,3111.97479,2320.33208,Benign
10.0.2.15,35645,119.254.87.201,80,11,1579,6,705,5,874,3464.262878,1.753416,3216.578382,3987.644689,Malicious
172.30.15.1834,51146,104.16.118.145,443,15,5566,8,1066,7,4500,3864.71594,0.124095,68721.54398,290100.3264,Benign
192.168.137.97,58510,119.81.119.5,443,40,8963,23,3923,17,5040,57.00185547,240.1979482,130.6589013,167.8615505,Benign
172.30.6.255,56783,74.125.24.188,5228,98,7147,51,3654,47,3493,1247.552157,1803.354284,16.20979319,15.49556859,Benign
172.30.15.862,50168,104.18.255.119,80,10,2251,6,753,4,1498,3434.381994,2.765649,2178.15059,4333.160137,Benign
172.30.1.136,50394,172.217.161.3,443,77,20545,38,6774,39,13771,755.673527,70.142303,772.6008084,1570.635626,Benign
192.168.43.224,38568,34.236.23.199,443,28,7733,16,1817,12,5916,938.5381841,36.43175147,398.9926209,1299.086596,Benign
10.0.2.15,56326,119.254.87.201,80,11,1513,6,705,5,808,1694.194463,1.221078,4618.869556,5293.683123,Malicious
192.168.137.97,52268,172.217.161.3,443,257,26330,117,11875,140,14455,9511.393083,1014.414417,93.65008857,113.9968025,Benign
192.168.215.49,35446,52.84.110.215,443,43,8802,21,2651,22,6151,1252.265546,224.4183627,94.50207082,219.2690447,Benign
172.30.6.255,58024,172.217.31.2,80,14,2919,8,1699,6,1220,4766.558235,7.339246,1851.96136,1329.83688,Benign
172.30.1.136,51782,172.217.160.243,443,11,642,6,348,5,294,2974.532571,35.625599,78.14605447,66.01994257,Benign
172.30.6.255,58258,172.217.167.2,80,30,7788,16,4368,14,3420,5264.594389,4.420281,7905.379771,6189.651744,Benign
10.0.2.15,44146,119.254.87.201,80,11,1551,6,705,5,846,24218.93776,2.168389,2601.009321,3121.211185,Malicious
172.30.1.136,51855,52.114.132.21,443,20,7392,11,2698,9,4694,3916.711564,2.945454,7327.902592,12749.13816,Benign
172.30.6.255,55944,35.201.85.114,80,7,402,4,228,3,174,152.568719,10.309335,176.9270278,135.023258,Benign
172.30.1.136,50372,157.240.16.20,443,3,198,3,198,0,0,671.387453,8.999441,176.0109322,0,Benign
192.168.137.97,37696,23.57.214.252,443,18,2648,10,1765,8,883,3532.580726,27.11367875,520.7703511,260.5327026,Benign
10.0.2.15,54031,119.254.87.201,80,11,1587,6,705,5,882,26225.95052,1.086859,5189.265581,6492.102471,Malicious
172.30.15.2093,51405,54.236.156.42,443,6,348,4,228,2,120,4141.171897,6.526693,279.4677182,147.0882727,Benign
10.0.2.15,53790,119.254.87.201,80,11,1579,6,705,5,874,3736.353513,1.744168,3233.633457,4008.788144,Malicious
10.0.2.15,37975,119.254.87.201,80,11,1579,6,705,5,874,15479.14798,1.359889,4147.397324,5141.596116,Malicious
172.30.15.1866,51178,54.201.241.25,443,6,348,4,228,2,120,3930.019467,7.530508,242.214735,127.4814395,Benign
192.168.42.240,50933,172.217.161.14,443,15,859,8,457,7,402,107.28123,72.101746,50.70612298,44.60363553,Benign
172.30.6.255,57418,103.243.221.17,80,17,6271,9,5040,8,1231,2771.011107,22.01984,1831.075975,447.2330407,Benign
192.168.43.224,34376,52.84.110.254,443,14,2256,8,1621,6,635,360.3854509,10.46443197,1239.245478,485.453966,Benign
172.30.6.255,57124,184.29.25.174,443,50,34495,20,2897,30,31598,1859.342851,142.587662,162.5386073,1772.83221,Benign
10.0.2.15,52916,119.254.87.201,80,11,1582,6,705,5,877,5838.788492,1.55842,3619.050064,4501.995611,Malicious
10.0.2.15,38969,119.254.87.201,80,11,1513,6,705,5,808,9500.595952,1.420264,3971.092698,4551.266525,Malicious
172.30.6.255,56912,103.71.26.125,80,10,2535,6,1738,4,797,1386.06497,42.878989,324.2613766,148.6975358,Benign
172.30.15.456,49730,23.9.250.106,443,51,30800,21,3305,30,27495,1641.167762,9.34196,2830.241191,23545.3802,Benign
192.168.215.49,37898,158.85.224.176,443,7,478,4,272,3,206,40.89980578,11.55275676,188.3533121,142.6499349,Benign
172.30.15.1745,51057,184.29.25.7,443,18,3611,9,1546,9,2065,3635.669303,1.358667,9103.039965,12158.97641,Benign
172.30.15.819,50117,162.125.82.3,443,6,348,4,228,2,120,3094.591516,1.348483,1352.631068,711.9110882,Benign
172.30.6.255,57462,103.243.221.17,80,42,27824,17,9371,25,18453,2926.844998,24.184291,3099.863461,6104.127675,Benign
172.30.6.255,57611,192.168.240.1,7680,2,132,2,132,0,0,3402.631419,3.003445,351.5962503,0,Benign
172.30.6.255,56849,172.217.194.189,443,19,2345,11,1650,8,695,1352.726095,137.477095,96.01599452,40.44310072,Benign
10.0.2.15,39500,219.234.85.243,80,11,1340,6,788,5,552,331.229996,36453.10287,0.172934524,0.121141951,Malicious
172.30.6.255,58238,103.231.98.53,80,19,6478,10,5744,9,734,5221.882096,37.191612,1235.547413,157.8850629,Benign
172.30.1.136,50268,104.17.162.9,443,15,3062,8,2660,7,402,481.708066,9.730216,2187.00181,330.5168148,Benign
10.0.2.15,46106,119.254.87.201,80,11,1559,6,705,5,854,10581.431,1.221164,4618.544274,5594.662142,Malicious
192.168.43.233,50889,49.44.169.252,443,42,22359,19,2117,23,20242,121.106486,5.586687,3031.492546,28986.05202,Benign
172.30.6.255,57419,103.243.221.17,80,6,348,4,228,2,120,2771.108308,21.922766,83.20118,43.79009474,Benign
172.30.15.347,49615,162.125.34.137,443,23,5726,12,1572,11,4154,1105.489285,254.072631,49.49765723,130.7972444,Benign
172.30.15.1857,51169,104.31.84.161,443,6,348,4,228,2,120,3908.447527,8.832221,206.5165715,108.6929324,Benign
172.30.15.817,50115,13.107.4.52,80,10,1685,6,644,4,1041,3093.179094,0.432092,11923.38669,19273.6732,Benign
172.30.6.255,55721,202.241.208.55,80,10,1947,6,855,4,1092,57.78902,0.944402,7242.678436,9250.298072,Benign
10.0.2.15,40099,119.254.87.201,80,11,1579,6,705,5,874,24694.07792,2.110168,2672.772974,3313.480254,Malicious
10.0.2.15,33837,119.254.87.201,80,12,1653,7,779,5,874,6979.933187,13.479223,462.3411898,518.7242618,Malicious
192.168.43.224,39082,103.37.200.184,443,132,86911,68,6694,64,80217,2542.329076,28.6721941,1867.732892,22381.82393,Benign
10.0.2.15,33643,119.254.87.201,80,11,1579,6,705,5,874,12565.79189,2.29101,2461.796326,3051.929062,Malicious
172.30.1.136,51523,52.84.108.135,443,13,752,7,404,6,348,25.28749,127.352739,25.37833128,21.86054279,Benign
172.30.15.1049,50355,52.77.33.157,80,13,3175,8,1673,5,1502,3448.432521,8.786729,1523.20619,1367.516854,Benign
192.168.137.97,35130,104.198.143.177,80,11,977,6,491,5,486,5723.814242,0.961630506,4084.728984,4043.132966,Benign
192.168.43.224,49808,172.217.166.195,443,32,6712,16,1674,16,5038,23.05341688,285.9309875,46.83647658,140.9570902,Benign
172.30.6.255,55784,172.217.166.197,443,17,1779,10,1150,7,629,64.405134,105.770791,86.98053511,47.57457094,Benign
172.30.15.860,50166,52.84.112.65,80,18,9721,8,869,10,8852,3434.380804,2.672025,2601.772064,26502.74604,Benign
10.0.2.15,44555,119.254.87.201,80,11,1579,6,705,5,874,10068.4143,1.221984,4615.445047,5721.842512,Malicious
10.0.2.15,41643,119.254.87.201,80,11,1579,6,705,5,874,24363.75933,1.225113,4603.656969,5707.228639,Malicious
192.168.137.97,37092,140.98.193.112,443,9,1256,4,276,5,980,1.823922342,3.168245395,696.9157135,2474.555794,Benign
192.168.215.49,34276,151.101.66.49,443,62,13318,31,3531,31,9787,516.5970376,600.8675022,47.01202827,130.3049336,Benign
172.30.6.255,57936,103.243.221.17,80,26,17048,11,4615,15,12433,4526.856235,27.958874,1320.510976,3557.510936,Benign
192.168.215.49,50202,152.195.61.54,443,19,6201,11,1341,8,4860,788.5342116,0.030324173,353777.1665,1282145.436,Benign
192.168.137.97,57566,169.60.79.147,443,12,812,7,478,5,334,6798.334929,124.2392185,30.77933076,21.50689639,Benign
192.168.137.97,44552,172.217.161.10,443,11,754,6,428,5,326,11107.49052,57.68219,59.35974345,45.21326254,Benign
172.30.6.255,58096,172.217.166.195,443,28,3286,16,1952,12,1334,4873.073551,132.379655,117.963746,80.61661741,Benign
192.168.137.97,33412,172.217.161.5,443,11,742,7,482,4,260,4160.080216,45.62848619,84.50861122,45.58555792,Benign
192.168.43.233,51243,52.84.110.84,443,11,644,6,350,5,294,1672.269554,126.807072,22.08078742,18.54786143,Benign
172.30.15.2370,51704,14.139.45.128,80,10,1390,5,660,5,730,5334.507326,0.167796,31466.78109,34804.16696,Benign
192.168.215.49,40718,13.127.63.105,443,26,4219,12,2325,14,1894,1297.900874,31.10225738,598.0273319,487.1672115,Benign
10.0.2.15,41409,119.254.87.201,80,11,1513,6,705,5,808,17071.1056,2.025014,2785.16593,3192.076697,Malicious
192.168.43.224,35460,172.217.166.196,443,20,5534,11,2026,9,3508,19.78620386,11.70111954,1385.166603,2398.402983,Benign
172.30.6.255,57361,157.240.16.39,443,28,5424,15,3275,13,2149,2558.085078,61.065058,429.0506037,281.5358007,Benign
172.30.6.255,56689,103.243.220.231,80,17,6965,10,5283,7,1682,1155.904394,3.644263,11597.40666,3692.378953,Benign
172.30.6.255,55890,63.251.88.51,443,21,6720,10,2005,11,4715,113.30237,1.140516,14063.80971,33072.74953,Benign
172.30.6.255,57778,172.217.166.206,443,16,1725,10,1150,6,575,3978.419007,82.051377,112.1248703,56.06243513,Benign
10.0.2.15,47075,119.254.87.201,80,11,1513,6,705,5,808,13882.59889,1.89934,2969.452547,3403.287458,Malicious
172.30.15.1503,50811,117.18.237.66,443,16,6753,9,1153,7,5600,3521.084564,5.881781,1568.232479,7616.740576,Benign
192.168.43.224,35548,104.198.143.177,80,11,977,6,491,5,486,3323.81225,1.498559377,2621.184092,2594.49179,Benign
192.168.43.233,51185,49.44.170.52,443,102,66300,47,3659,55,62641,1076.200942,72.829031,401.9276324,6880.882433,Benign
192.168.42.240,50938,216.58.221.67,443,41,8281,22,2611,19,5670,160.588778,50.954377,409.9353427,890.208117,Benign
172.30.6.255,58399,157.240.16.39,443,19,1933,10,1125,9,808,5547.098627,61.050953,147.4178462,105.8787731,Benign
172.30.15.1074,50380,162.210.197.200,80,10,2695,6,1681,4,1014,3452.763099,4.557618,2950.664141,1779.87712,Benign
172.30.1.136,51902,172.217.194.188,5228,60,4805,31,2524,29,2281,4750.523946,996.438647,20.26416785,18.31321984,Benign
172.30.6.255,56223,139.99.8.179,80,6,348,4,228,2,120,469.968024,20.958874,87.027576,45.80398737,Benign
10.0.2.15,54522,119.254.87.201,80,12,1656,7,779,5,877,10583.82507,3.946223,1579.231584,1777.902567,Malicious
172.30.1.136,50809,172.217.161.14,443,29,4200,16,2591,13,1609,1952.395059,12.517167,1655.965763,1028.347708,Benign
192.168.215.49,33136,52.206.154.207,443,25,4859,13,2417,12,2442,554.9916552,10.90822218,1772.607825,1790.942619,Benign
172.30.6.255,56832,103.231.98.53,80,9,510,6,336,3,174,1315.092454,12.601982,213.2997809,110.4588151,Benign
192.168.43.233,51502,13.107.54.254,443,39,16401,21,2317,18,14084,3897.282912,7.062486,2624.571574,15953.58915,Benign
172.30.1.136,50567,184.29.24.13,443,20,1152,8,468,12,684,1495.55472,48.439205,77.29276317,112.9663462,Benign
172.30.15.440,49714,54.222.61.197,443,7,398,4,228,3,170,1624.191481,6.700564,272.2158911,202.967989,Benign
192.168.137.97,34434,172.217.161.3,443,275,209082,116,11457,159,197625,337.4774347,241.4711999,379.5732163,6547.364657,Benign
172.30.6.255,57265,103.243.221.87,80,40,24220,24,20125,16,4095,2270.841721,15.54135,10359.46041,2107.924987,Benign
172.30.6.255,58065,103.243.221.51,80,25,14240,11,5347,14,8893,4826.85381,12.348996,3463.925326,5761.116126,Benign
192.168.43.224,50892,23.251.156.28,443,9,610,5,338,4,272,2273.596872,71.38832162,37.87734378,30.48117606,Benign
192.168.43.233,51165,74.125.170.89,443,23,9047,11,2439,12,6608,483.6775,7.114733,2742.478179,7430.215582,Benign
192.168.43.224,50896,23.251.156.28,443,17,7300,10,1347,7,5953,2443.140233,24.88160316,433.0910645,1914.024578,Benign
172.30.6.255,57339,13.228.141.18,443,29,9836,15,2863,14,6973,2475.813755,105.646035,216.7994284,528.0273888,Benign
192.168.215.49,54750,195.8.215.225,443,19,5663,11,2533,8,3130,514.7161917,1.875009008,10807.41474,13354.60251,Benign
10.0.2.15,43611,119.254.87.201,80,12,1608,7,779,5,829,26531.73623,5.108214,1219.995873,1298.301128,Malicious
172.30.6.255,58167,172.217.166.197,443,52,9608,26,5267,26,4341,4966.840334,147.396303,285.8687711,235.6097086,Benign
172.30.15.2311,51640,192.168.45.1,7680,3,198,3,198,0,0,5016.444649,9.040181,175.2177307,0,Benign
172.30.6.255,55827,172.217.166.211,443,49,8220,21,2339,28,5881,91.391272,240.821525,77.70069557,195.3645963,Benign
172.30.6.255,57702,210.176.156.21,80,11,615,10,553,1,62,3679.546372,90.101929,49.09994768,5.504876594,Benign
172.30.6.255,56461,103.243.220.231,80,47,29255,27,24945,20,4310,746.845161,15.558888,12826.10942,2216.096677,Benign
172.30.15.1539,50847,182.161.72.100,443,18,5817,9,1970,9,3847,3531.590949,5.503893,2863.427759,5591.678472,Benign
172.30.6.255,56901,217.12.15.54,443,5,294,3,174,2,120,1385.145572,19.386599,71.80217634,49.5187423,Benign
172.30.1.136,50537,52.230.84.217,443,39,11654,23,5767,16,5887,1172.17771,620.276006,74.3797915,75.92748961,Benign
172.30.6.255,58039,157.240.16.39,443,19,1933,10,1125,9,808,4815.094978,61.046657,147.4282204,105.886224,Benign
172.30.6.255,58343,180.149.59.232,80,12,4895,8,3668,4,1227,5420.146205,8.866799,3309.424292,1107.051147,Benign
10.0.2.15,55386,119.254.87.201,80,11,1513,6,705,5,808,11302.23462,0.879136,6415.389655,7352.673534,Malicious
172.30.6.255,57127,13.67.76.139,443,20,8628,12,975,8,7653,1861.605819,109.992458,70.91395303,556.6199821,Benign
10.0.2.15,47142,119.254.87.201,80,11,1513,6,705,5,808,10761.63298,1.425371,3956.864564,4534.95967,Malicious
10.0.2.15,33863,119.254.87.201,80,11,1582,6,705,5,877,582.973459,1.617533,3486.791305,4337.469467,Malicious
172.30.1.136,50626,157.240.16.16,443,47,6813,23,3981,24,2832,1694.587348,124.010788,256.8163667,182.6937831,Benign
172.30.6.255,56178,172.217.166.206,443,18,1837,11,1208,7,629,448.420761,162.029521,59.64345226,31.0560691,Benign
10.0.2.15,54409,119.254.87.201,80,11,1582,6,705,5,877,8359.338698,1.483243,3802.478758,4730.175703,Malicious
172.30.15.1760,51072,184.29.25.7,443,30,16707,13,3684,17,13023,3638.248343,8.922989,3302.929097,11675.90815,Benign
172.30.6.255,57729,103.243.221.87,80,63,42186,37,35147,26,7039,3779.836976,20.229209,13899.50541,2783.697573,Benign
172.30.6.255,56324,52.221.7.77,80,6,348,4,228,2,120,590.943302,14.993798,121.6502983,64.02647281,Benign
192.168.43.233,51080,119.161.10.150,443,91,17394,44,3424,47,13970,916.283529,1201.443161,22.79924751,93.02146254,Benign
172.30.6.255,56723,103.243.220.231,80,17,5891,10,4309,7,1582,1193.836674,28.622018,1204.387475,442.177068,Benign
192.168.137.97,49568,172.82.254.215,443,51,13131,28,6807,23,6324,18.34377723,330.679247,164.6792186,152.9941793,Benign
172.30.6.255,57029,192.168.1.35,7680,3,198,3,198,0,0,1556.84455,9.004163,175.9186279,0,Benign
172.30.6.255,57892,52.229.173.178,443,27,10012,14,2162,13,7850,4367.694967,125.562632,137.7479886,500.1488022,Benign
192.168.137.97,51646,172.217.161.3,443,196,114602,101,103272,95,11330,3619.154997,315.5881398,2617.893057,287.2097793,Benign
172.30.6.255,56452,35.168.107.25,80,6,348,4,228,2,120,700.729786,10.678488,170.810699,89.90036792,Benign
192.168.137.97,51794,172.217.161.3,443,863,531336,345,50172,518,481164,3835.142626,427.5038082,938.8828645,9004.158388,Benign
172.30.15.677,49964,104.31.90.207,80,114,99909,45,3834,69,96075,2397.79565,8.478133,3617.77764,90656.75191,Benign
192.168.43.233,51397,172.217.166.206,443,9,534,5,294,4,240,3625.691818,20.859766,112.7529427,92.04321851,Benign
172.30.15.1906,51218,157.240.16.39,443,24,3316,13,1777,11,1539,3984.846028,2.423105,5866.852654,5081.083981,Benign
10.0.2.15,44151,119.254.87.201,80,11,1551,6,705,5,846,5958.858249,1.904437,2961.505159,3553.80619,Malicious
172.30.1.136,50220,52.84.103.186,443,29,5147,14,3503,15,1644,385.106825,57.463724,487.681585,228.8748289,Benign
172.30.15.2310,51639,18.211.245.141,443,23,6094,12,1939,11,4155,5013.287481,4.585245,3383.025335,7249.340003,Benign
10.0.2.15,52657,219.234.85.243,80,8,940,4,684,4,256,241.548195,0.646976,8457.809872,3165.496093,Malicious
192.168.43.233,50738,52.214.173.82,443,24,9017,12,2428,12,6589,1868.688089,2.426439,8005.146637,21724.01614,Benign
192.168.137.97,45782,151.101.193.63,443,1515,1418399,543,37169,972,1381230,2030.061456,9.111433074,32635.04188,1212744.462,Benign
172.30.6.255,56304,139.162.49.205,80,7,402,4,228,3,174,569.654554,19.332245,94.35013885,72.00405333,Benign
172.30.15.1807,51119,162.247.242.19,443,7,398,4,228,3,170,3701.166716,6.247269,291.9675782,217.6951241,Benign
172.30.1.136,50178,172.217.161.4,443,50,15647,24,3179,26,12468,356.574018,25.86517,983.2527681,3856.305603,Benign
172.30.6.255,56070,13.228.225.25,80,6,348,4,228,2,120,286.66907,17.397462,104.8428788,55.18046253,Benign
172.30.6.255,56491,103.243.221.17,80,54,39475,25,16921,29,22554,817.861223,12.68513,10671.39241,14223.89838,Benign
172.30.6.255,55892,63.251.88.51,443,4,236,2,120,2,116,113.43032,10.518319,91.26933686,88.22702563,Benign
192.168.43.233,51378,151.101.154.110,443,56,11888,27,2520,29,9368,3477.198137,603.135697,33.42531391,124.257278,Benign
10.0.2.15,60020,119.254.87.201,80,11,1513,6,705,5,808,23165.24489,2.218967,2541.723243,2913.067207,Malicious
172.30.1.136,51857,52.84.108.120,443,36,9133,19,2443,17,6690,3982.098397,97.725295,199.9891635,547.6575947,Benign
10.0.2.15,42093,119.254.87.201,80,11,1513,6,705,5,808,3371.925714,0.830438,6791.596724,7783.844188,Malicious
10.0.2.15,44171,119.254.87.201,80,11,1582,6,705,5,877,16139.9999,1.56226,3610.15452,4490.929807,Malicious
172.30.6.255,57858,67.231.251.189,80,11,1226,6,787,5,439,4225.947353,12.142885,518.4929282,289.2228659,Benign
172.30.6.255,57093,103.243.221.17,80,37,20806,19,12304,18,8502,1734.846755,35.996252,2734.506915,1889.530054,Benign
192.168.137.97,50656,192.168.121.7,443,17,2932,9,1758,8,1174,2995.539176,10.83598375,1297.897848,866.7417941,Benign
10.0.2.15,34434,119.254.87.201,80,11,1579,6,705,5,874,21272.75407,1.601438,3521.834751,4366.075989,Malicious
172.30.6.255,57291,103.243.220.231,80,16,5442,9,4215,7,1227,2369.835207,33.226344,1014.857367,295.4282301,Benign
10.0.2.15,37595,119.254.87.201,80,11,1579,6,705,5,874,16920.89262,2.821496,1998.93957,2478.117991,Malicious
172.30.15.693,49980,54.248.216.124,443,15,2738,8,1497,7,1241,2402.409121,3.90971,3063.142791,2539.318773,Benign
172.30.15.1365,50673,184.29.25.122,443,32,16057,18,10389,14,5668,3493.317521,3.700224,22461.34288,12254.39325,Benign
172.30.15.1113,50421,173.241.248.220,80,9,1917,6,1439,3,478,3458.272373,9.108928,1263.815018,419.8079071,Benign
172.30.15.2153,51465,52.42.237.125,443,20,8138,10,2211,10,5927,4184.825191,2.834442,6240.381705,16728.51305,Benign
192.168.43.224,39780,54.148.54.246,443,6,412,4,272,2,140,94.22205492,12.67848566,171.62933,88.33862574,Benign
192.168.137.97,45438,103.243.221.75,443,6,412,4,272,2,140,376.0779836,14.87725364,146.2635546,75.28271193,Benign
192.168.137.97,43476,157.240.16.39,443,29,5373,14,2512,15,2861,3006.380432,65.32137184,307.6481622,350.3906816,Benign
10.0.2.15,56568,119.254.87.201,80,11,1582,6,705,5,877,1031.588257,1.816965,3104.077404,3861.384231,Malicious
172.30.6.255,57672,103.243.220.231,80,39,33912,13,5437,26,28475,3582.906189,0.896324,48527.09511,254149.1693,Benign
172.30.6.255,56668,103.243.221.109,80,16,6535,9,5326,7,1209,1132.843274,17.40437,2448.120788,555.7224996,Benign
192.168.137.97,35034,104.198.143.177,80,10,911,5,425,5,486,4523.81401,1.291910927,2631.760386,3009.495406,Benign
172.30.6.255,57962,103.231.98.53,80,39,17419,20,15673,19,1746,4629.907169,67.052582,1869.935449,208.3141258,Benign
192.168.43.224,46042,35.170.201.81,443,29,10176,15,3502,14,6674,34.17529289,3.083248823,9086.51932,17316.79896,Benign
10.0.2.15,50368,119.254.87.201,80,11,1569,6,705,5,864,5083.578667,1.452853,3882.016969,4757.53569,Malicious
172.30.15.1025,50331,14.128.26.213,80,10,1948,6,855,4,1093,3446.723776,10.536323,649.1828316,829.891035,Benign
10.0.2.15,41280,119.254.87.201,80,11,1554,6,705,5,849,3586.356369,1.783684,3161.995062,3807.849372,Malicious
172.30.15.1340,50648,184.29.26.86,443,69,52085,29,5837,40,46248,3491.429304,5.589263,8354.589863,66195.48946,Benign
192.168.137.97,60966,206.189.157.46,443,574,514138,216,17238,358,496900,418.811719,149.5308958,922.2441911,26584.47259,Benign
192.168.43.233,51193,23.9.140.60,443,19,3520,10,2396,9,1124,666.876534,76.608869,250.2060173,117.3754438,Benign
172.30.6.255,58509,103.243.221.87,80,16,5907,9,4317,7,1590,5747.869754,1.348532,25610.0708,9432.47917,Benign
172.30.15.1658,50969,184.29.25.7,443,16,1765,8,1114,8,651,3587.426416,9.953099,895.3995133,523.2541141,Benign
172.30.6.255,55722,54.169.20.177,80,17,6380,10,2839,7,3541,57.789062,0.871206,26069.60925,32515.84585,Benign
192.168.215.49,35732,188.65.124.64,443,58,35252,36,28931,22,6321,514.22783,97.17926013,2381.660446,520.357944,Benign
192.168.43.224,48870,151.101.153.177,443,8,552,5,338,3,214,3245.427584,19.03344126,142.0657443,89.94695054,Benign
10.0.2.15,56670,119.254.87.201,80,11,1579,6,705,5,874,9532.634808,2.02525,2784.841378,3452.413282,Malicious
172.30.6.255,55718,50.116.239.135,443,19,6052,10,2084,9,3968,57.511584,1.20356,13852.23836,26375.08724,Benign
172.30.15.1367,50675,103.243.220.231,443,19,7282,10,2955,9,4327,3493.393395,3.943598,5994.525811,8777.770959,Benign
172.30.15.2383,51717,14.139.45.128,80,10,1382,5,656,5,726,5334.750195,0.346557,15143.25205,16759.14785,Benign
172.30.15.1984,51296,35.200.76.2,443,6,348,4,228,2,120,4077.019188,5.411737,337.0452038,177.3922125,Benign
172.30.1.136,50791,151.101.129.181,443,21,4005,13,3347,8,658,1931.585865,29.844821,897.1740859,176.3790106,Benign
192.168.43.233,51353,209.197.3.15,443,7,402,4,228,3,174,3084.86879,52.447238,34.77780851,26.54095913,Benign
172.30.6.255,57441,192.168.1.44,7680,3,198,3,198,0,0,2840.878417,9.009501,175.8143986,0,Benign
192.168.137.97,37694,172.217.194.189,443,9,618,5,338,4,280,150.3010736,24.7102731,109.4281714,90.6505562,Benign
172.30.6.255,55987,119.42.60.92,80,6,348,4,228,2,120,183.56132,30.409006,59.98223026,31.56959488,Benign
172.30.15.553,49837,104.16.241.231,443,35,11688,19,3878,16,7810,2252.767432,3.327084,9324.681914,18779.20726,Benign
172.30.6.255,57847,103.243.221.109,80,16,5439,9,4203,7,1236,4205.867592,18.198384,1847.636581,543.3449476,Benign
172.30.6.255,56617,172.217.166.206,443,42,6798,23,4355,19,2443,968.423267,81.789096,425.973653,238.9560584,Benign
10.0.2.15,56145,119.254.87.201,80,11,1582,6,705,5,877,14423.06995,1.413599,3989.816065,4963.217999,Malicious
172.30.15.358,49626,162.125.33.7,443,23,6683,12,2281,11,4402,1359.665691,1068.218826,17.0826422,32.96702805,Benign
10.0.2.15,35718,219.234.85.243,80,11,1631,6,796,5,835,328.752892,36455.5826,0.174678322,0.183236682,Malicious
172.30.15.2108,51420,34.205.118.138,443,6,348,4,228,2,120,4146.378205,1.31768,1384.251108,728.5532147,Benign
172.30.6.255,56880,52.76.116.64,80,14,2563,8,1836,6,727,1384.439475,68.478504,214.490667,84.93176194,Benign
192.168.137.97,52834,52.220.54.9,443,8,544,5,338,3,206,1765.51889,52.58520957,51.4213031,31.33961076,Benign
192.168.137.97,39760,172.217.167.10,443,24,7403,13,1923,11,5480,98.20956952,40.77589438,377.2817307,1075.145025,Benign
10.0.2.15,52688,119.254.87.201,80,11,1579,6,705,5,874,25775.33823,3.528779,1598.286546,1981.421903,Malicious
172.30.6.255,55992,151.101.153.108,80,44,33477,14,2428,30,31049,183.9998,227.627251,85.33248947,1091.222597,Benign
172.30.15.1937,51249,52.6.46.142,443,22,4314,12,2849,10,1465,3993.591153,3.863415,5899.443886,3033.585571,Benign
172.30.6.255,57347,157.240.16.20,443,39,16956,16,1956,23,15000,2476.555172,65.206725,239.975248,1840.300981,Benign
10.0.2.15,43722,119.254.87.201,80,11,1579,6,705,5,874,20465.0413,1.85446,3041.31661,3770.369811,Malicious
172.30.6.255,55753,103.15.158.128,80,2,132,1,66,1,66,58.380199,0.216798,2435.446821,2435.446821,Benign
192.168.43.224,35592,23.111.9.35,443,573,429120,267,16250,306,412870,2589.407495,209.286412,621.1583386,15782.00882,Benign
10.0.2.15,47279,119.254.87.201,80,12,1656,7,779,5,877,14245.16679,5.638953,1105.169701,1244.202603,Malicious
192.168.137.97,57064,104.113.214.101,443,77,19249,41,11333,36,7916,24.63204504,655.4903003,138.3147851,96.61165081,Benign
172.30.1.136,50395,172.217.161.3,443,13,798,8,492,5,306,755.924174,22.431575,175.4669478,109.1318822,Benign
172.30.1.136,50450,157.240.16.20,443,3,198,3,198,0,0,857.311632,9.007301,175.8573406,0,Benign
172.30.6.255,55707,210.176.156.41,80,6,344,4,228,2,116,53.278334,5.437469,335.4501883,170.6676397,Benign
192.168.43.233,51032,52.230.84.217,443,26,4052,10,936,16,3116,254.565774,520.844146,14.37666154,47.8607664,Benign
192.168.43.233,50985,74.207.230.33,443,28,8266,14,1729,14,6537,509.188128,71.969969,192.1912736,726.6364114,Benign
172.30.15.2036,51348,34.205.118.138,443,24,6983,13,2659,11,4324,4090.72054,6.896074,3084.653674,5016.187471,Benign
192.168.43.224,56076,117.18.237.66,443,9,626,6,412,3,214,2462.764212,13.99122186,235.5762801,122.3624367,Benign
10.0.2.15,52572,119.254.87.201,80,12,1653,7,779,5,874,15298.982,5.113818,1218.658935,1367.275879,Malicious
172.30.15.2242,51559,184.29.25.145,443,63,42355,28,5194,35,37161,4468.137704,9.527373,4361.328144,31203.56472,Benign
172.30.6.255,57953,103.243.221.75,80,40,24625,23,20467,17,4158,4586.842189,15.251483,10735.74288,2181.033805,Benign
192.168.137.97,51838,103.102.166.224,443,24,6527,15,1758,9,4769,5424.445592,4.51244609,3116.713135,8454.83785,Benign
10.0.2.15,54974,119.254.87.201,80,11,1579,6,705,5,874,14788.45411,1.580866,3567.664812,4422.892263,Malicious
172.30.6.255,58248,176.34.147.227,443,20,7186,10,1763,10,5423,5222.760388,36.398796,387.4853443,1191.907557,Benign
10.0.2.15,55571,119.254.87.201,80,11,1513,6,705,5,808,25477.98956,1.095524,5148.221308,5900.37279,Malicious
10.0.2.15,52706,119.254.87.201,80,11,1579,6,705,5,874,8269.288919,1.894027,2977.78226,3691.605241,Malicious
172.30.15.590,49875,131.253.61.80,443,33,10226,14,2288,19,7938,2315.086648,11.255352,1626.248562,5642.115857,Benign
172.30.6.255,55965,207.244.121.27,443,22,8721,12,2605,10,6116,166.157892,7.36027,2831.417869,6647.582222,Benign
172.30.15.2083,51395,52.86.72.168,443,15,2758,8,1988,7,770,4123.33573,4.263442,3730.319305,1444.841984,Benign
192.168.43.224,50186,49.44.90.17,443,24,6843,13,2557,11,4286,37.94997913,6.21429357,3291.765954,5517.60222,Benign
172.30.6.255,56996,103.243.221.51,80,45,29423,26,25168,19,4255,1483.838435,14.189971,14189.17629,2398.877348,Benign
172.30.6.255,57575,103.243.221.51,80,40,24299,24,20205,16,4094,3288.844119,27.380022,5903.574511,1196.200646,Benign
172.30.6.255,56366,23.56.25.36,80,11,2141,6,712,5,1429,608.519375,68.511411,83.13943498,166.8627143,Benign
172.30.6.255,56675,172.217.166.226,80,10,2169,6,1499,4,670,1135.602688,14.477634,828.31214,370.22624,Benign
192.168.43.233,51059,49.44.178.225,443,37,12463,18,2024,19,10439,891.903149,323.490401,50.05403545,258.1591285,Benign
172.30.15.1334,50642,104.244.42.133,443,6,348,4,228,2,120,3489.928993,7.21057,252.9619711,133.1378795,Benign
172.30.15.1000,50306,188.125.88.204,443,20,7306,10,1195,10,6111,3443.241662,3.704183,2580.86601,13198.05204,Benign
172.30.1.136,50342,104.121.241.30,443,36,11093,19,1854,17,9239,608.608945,87.438488,169.6278188,845.3028145,Benign
10.0.2.15,47986,119.254.87.201,80,11,1534,6,705,5,829,22807.62367,1.088925,5179.42007,6090.410267,Malicious
172.30.6.255,58214,180.149.59.210,80,12,4893,8,3668,4,1225,5156.022654,7.934423,3698.315555,1235.12447,Benign
172.30.6.255,56984,176.34.147.227,443,14,2116,8,1580,6,536,1438.681369,15.844102,797.7732029,270.6369853,Benign
192.168.43.233,50735,172.217.166.202,443,7,402,4,228,3,174,1858.814665,12.597827,144.7868748,110.4952465,Benign
192.168.137.97,34686,172.217.161.3,443,7,466,4,272,3,194,397.5001863,56.0927693,38.79287878,27.66845031,Benign
172.30.6.255,55874,52.74.163.34,443,93,86707,26,6908,67,79799,107.744089,60.679075,910.7587748,10520.79321,Benign
192.168.137.97,33526,172.217.161.5,443,78,32082,39,6650,39,25432,5963.729193,241.2701037,220.4997602,843.2706618,Benign
172.30.6.255,57693,172.217.166.206,443,17,1779,10,1150,7,629,3663.409737,136.798771,67.25206618,36.7839562,Benign
192.168.43.233,51201,104.237.191.1,443,23,4108,12,2225,11,1883,1235.898817,46.796504,380.3702943,321.9043884,Benign
192.168.137.97,44292,172.217.161.10,443,13,898,7,490,6,408,7294.110026,71.77261121,54.61693442,45.47695764,Benign
172.30.15.820,50119,74.125.24.188,5228,6,348,4,228,2,120,3097.67552,9.164409,199.0308377,104.7530725,Benign
192.168.215.49,52126,54.88.46.124,443,145,19003,82,8439,63,10564,639.0247006,582.0517791,115.9896807,145.1967042,Benign
172.30.1.136,50153,172.217.24.234,443,16,4722,9,1285,7,3437,142.132294,23.561795,436.2995264,1166.973908,Benign
172.30.15.746,50036,52.84.110.85,443,48,27007,24,2649,24,24358,2575.919599,10.308253,2055.828471,18903.68814,Benign
172.30.15.927,50233,208.100.17.185,80,8,2062,5,1431,3,631,3440.769247,0.909442,12587.93854,5550.656337,Benign
192.168.215.49,58284,157.240.16.16,443,286,28597,144,13623,142,14974,126.5733495,1984.3715,54.92116775,60.36772854,Benign
192.168.43.233,50943,172.217.166.226,443,19,5297,11,1663,8,3634,454.050635,22.600254,588.6659504,1286.357224,Benign
10.0.2.15,40859,119.254.87.201,80,11,1582,6,705,5,877,25630.55615,2.056496,2742.52904,3411.628323,Malicious
192.168.215.49,54748,195.8.215.225,443,19,5869,11,2739,8,3130,514.7153066,1.875832403,11681.21415,13348.74052,Benign
172.30.15.933,50239,52.221.102.82,80,16,5023,10,2415,6,2608,3440.981157,6.081571,3176.810729,3430.692497,Benign
172.30.1.136,50688,151.101.0.188,443,29,12307,16,3602,13,8705,1806.183847,18.405803,1565.593199,3783.589339,Benign
10.0.2.15,44971,119.254.87.201,80,11,1582,6,705,5,877,2084.639459,1.023065,5512.846202,6857.824283,Malicious
192.168.215.49,49974,52.84.108.179,443,21,3150,12,1972,9,1178,1268.013876,130.287053,121.0864751,72.3325901,Benign
192.168.137.97,40074,172.217.161.14,443,9,606,5,338,4,268,7221.512817,58.10124009,46.53945416,36.90110567,Benign
172.30.15.395,49663,195.154.150.142,80,13,3392,7,1042,6,2350,1474.666563,5.943183,1402.6154,3163.28809,Benign
172.30.1.136,50218,172.217.161.4,443,18,3666,12,3282,6,384,385.106312,45.563692,576.2482988,67.42210442,Benign
10.0.2.15,50059,119.254.87.201,80,11,1582,6,705,5,877,19864.27928,2.154123,2618.234892,3257.009929,Malicious
192.168.137.97,57366,104.244.46.135,443,16,5778,10,1335,6,4443,680.3754722,58.95115077,181.1669469,602.9398839,Benign
10.0.2.15,53890,119.254.87.201,80,11,1579,6,705,5,874,3584.372371,1.645627,3427.265109,4248.836462,Malicious
192.168.43.233,51187,131.253.61.100,443,250,86784,121,23601,129,63183,636.859026,108.460178,1740.804814,4660.364839,Benign
10.0.2.15,38860,119.254.87.201,80,11,1558,6,705,5,853,2172.797932,1.289731,4373.004913,5291.025803,Malicious
172.30.1.136,50750,172.217.194.188,443,13,798,7,426,6,372,1894.361535,14.910102,228.5698649,199.5962201,Benign
192.168.43.224,45022,157.240.16.52,443,35,9625,17,2127,18,7498,2084.867526,65.72180559,258.9095027,912.6955576,Benign
172.30.6.255,58556,54.194.27.245,443,15,2278,8,1580,7,698,5816.260965,2.938778,4301.107467,1900.109501,Benign
172.30.15.963,50269,64.124.217.61,443,7,402,4,228,3,174,3442.332334,4.930991,369.9053598,282.2961956,Benign
10.0.2.15,47000,119.254.87.201,80,11,1582,6,705,5,877,2741.159497,2.356157,2393.728432,2977.730262,Malicious
10.0.2.15,45363,119.254.87.201,80,11,1582,6,705,5,877,24336.56002,1.418813,3975.153879,4944.978655,Malicious
10.0.2.15,39091,119.254.87.201,80,11,1593,6,705,5,888,5684.059109,1.62531,3470.107241,4370.858482,Malicious
192.168.43.233,51524,49.44.164.114,443,23,7693,13,1416,10,6277,3975.130768,24.515342,462.0779918,2048.349968,Benign
172.30.15.2299,51627,172.217.166.196,443,19,3223,10,1478,9,1745,4923.378657,1.311881,9013.012613,10641.20907,Benign
172.30.15.1255,50563,180.149.59.136,80,8,468,5,282,3,186,3469.525002,7.981468,282.6547698,186.4318694,Benign
172.30.15.1157,50465,151.101.66.202,80,10,1783,6,792,4,991,3460.108829,7.478142,847.2692816,1060.156386,Benign
172.30.6.255,57732,103.243.221.87,80,62,52819,19,9491,43,43328,3779.86461,20.201577,3758.518456,17158.26443,Benign
192.168.43.233,51192,40.77.226.13,443,32,13801,18,4628,14,9173,651.397825,112.582257,328.8617673,651.8256247,Benign
192.168.43.233,51143,52.114.74.45,443,31,11002,16,5551,15,5451,474.241631,12.725846,3489.591183,3426.726993,Benign
192.168.43.224,35058,34.232.42.95,443,17,1874,10,1220,7,654,3042.774068,15.90020477,613.8285727,329.052366,Benign
192.168.43.224,35960,151.101.153.177,443,24,9356,14,1550,10,7806,2424.821119,14.80796754,837.3870327,4217.189147,Benign
172.30.15.1641,50951,184.29.25.7,443,278,249362,103,25038,175,224324,3575.997049,11.501813,17414.99362,156026.8803,Benign
172.30.6.255,58520,157.240.16.17,443,15,870,11,630,4,240,5771.208083,18.77575,268.4313543,102.2595635,Benign
10.0.2.15,57375,119.254.87.201,80,11,1579,6,705,5,874,2350.690222,1.48646,3794.249425,4703.792904,Malicious
192.168.43.233,51301,13.107.42.254,443,33,10774,17,1446,16,9328,2900.166705,122.671814,94.3003908,608.3222997,Benign
10.0.2.15,43473,119.254.87.201,80,11,1582,6,705,5,877,23732.94851,1.025503,5499.740128,6841.520698,Malicious
10.0.2.15,47591,119.254.87.201,80,11,1579,6,705,5,874,13281.86015,1.724197,3271.087933,4055.221068,Malicious
172.30.6.255,57664,172.30.13.95,7680,3,198,3,198,0,0,3569.073867,9.004597,175.910149,0,Benign
192.168.43.233,51135,13.107.140.254,443,1,54,0,0,1,54,17.690899,0,0,0,Benign
10.0.2.15,56633,119.254.87.201,80,11,1582,6,705,5,877,13704.59844,1.954671,2885.396059,3589.350842,Malicious
192.168.43.233,51339,172.217.194.154,443,9,534,5,294,4,240,3375.132613,14.026688,167.6803533,136.8819211,Benign
172.30.15.756,50046,216.239.36.21,443,37,7290,18,2270,19,5020,2586.950767,9.324905,1947.472923,4306.746289,Benign
172.30.15.675,49962,104.17.146.111,443,6,348,4,228,2,120,2397.513322,8.673745,210.2897883,110.678836,Benign
172.30.1.136,50296,172.217.161.3,443,184,48199,80,18728,104,29471,499.543267,112.384758,1333.134516,2097.864552,Benign
192.168.137.97,49436,74.125.130.188,5228,94,12795,49,4815,45,7980,9482.68934,1456.700954,26.44331351,43.82505541,Benign
192.168.43.224,35164,35.171.73.174,443,16,5004,9,1258,7,3746,1252.703892,27.10343954,371.3181858,1105.689924,Benign
172.30.15.1923,51235,144.2.1.5,443,30,7115,15,2714,15,4401,3991.507341,5.729542,3789.48265,6144.993788,Benign
10.0.2.15,55753,119.254.87.201,80,11,1513,6,705,5,808,21330.32191,1.030774,5471.616475,6271.015761,Malicious
172.30.15.1174,50482,52.221.102.82,80,12,2601,7,941,5,1660,3462.931503,4.291847,1754.023384,3094.238914,Benign
10.0.2.15,34763,119.254.87.201,80,11,1579,6,705,5,874,7248.823386,0.834051,6762.176414,8383.180405,Malicious
172.30.1.136,50121,13.107.4.52,80,11,1550,4,339,7,1211,99.757642,2.695997,1005.935837,3593.475809,Benign
172.30.6.255,57110,103.243.221.87,80,57,42424,24,13748,33,28676,1800.858545,41.17329,2671.246335,5571.767522,Benign
10.0.2.15,40345,119.254.87.201,80,11,1579,6,705,5,874,24486.76346,1.02087,5524.699521,6849.060115,Malicious
192.168.137.97,39744,192.168.125.6,80,318,249338,157,11442,161,237896,8298.893948,31.10035691,2943.245965,61194.41025,Benign
172.30.6.255,56054,54.251.186.7,80,20,6280,11,2893,9,3387,254.748213,92.418682,250.4255579,293.1874748,Benign
192.168.43.233,51186,104.104.182.224,443,18,6781,9,1169,9,5612,636.153988,1.295777,7217.291247,34647.93711,Benign
10.0.2.15,47721,119.254.87.201,80,11,1579,6,705,5,874,3254.122573,2.42783,2323.062158,2879.938052,Malicious
192.168.215.49,32906,172.217.161.19,443,54,9745,26,3399,28,6346,479.7685974,240.483012,113.0724361,211.108467,Benign
192.168.43.224,38498,140.98.193.112,443,23,8617,13,4102,10,4515,3265.896062,9.471960563,3464.541452,3813.360472,Benign
172.30.15.2059,51371,157.240.16.39,443,22,3963,11,2640,11,1323,4103.831744,3.499478,6035.185819,3024.451075,Benign
192.168.43.233,51648,52.84.110.140,443,7,426,4,240,3,186,855.773913,14.481666,132.5814309,102.7506089,Benign
172.30.1.136,50311,104.244.42.1,443,30,9558,16,2234,14,7324,561.877039,3.245317,5507.012104,18054.32258,Benign
192.168.43.224,50580,49.44.150.71,443,74,22486,40,17868,34,4618,2283.100084,315.6156978,452.9052293,117.0537469,Benign
192.168.215.49,53874,54.165.86.233,443,60,13699,29,3576,31,10123,556.5723436,610.8836585,46.830521,132.5686141,Benign
192.168.43.233,51077,182.161.72.131,443,24,13138,10,1816,14,11322,916.246116,15.907569,913.275938,5693.893266,Benign
172.30.6.255,58514,54.194.27.245,443,25,9669,13,4006,12,5663,5748.512565,10.678579,3001.148374,4242.512042,Benign
172.30.1.136,51912,172.217.160.238,443,24,1416,13,762,11,654,5745.109449,58.113648,104.8979063,90.03048647,Benign
172.30.6.255,55674,35.201.68.223,80,263,269355,73,4329,190,265026,41.308125,17.305119,2001.257547,122519.1228,Benign
192.168.42.240,50984,172.217.163.99,443,77,17805,38,9385,39,8420,297.353183,309.877366,242.2893965,217.3763152,Benign
192.168.43.224,60680,54.165.86.233,443,20,5396,12,1577,8,3819,42.65304885,20.6968323,609.5618798,1476.167926,Benign
172.30.15.935,50241,182.161.72.94,80,12,1888,6,918,6,970,3440.981882,6.188087,1186.796501,1254.022447,Benign
192.168.43.224,35062,34.232.42.95,443,17,1874,10,1220,7,654,3042.774699,15.87588232,614.7689814,329.5564868,Benign
192.168.215.49,41134,52.221.36.205,443,25,8853,14,2367,11,6486,480.1340901,65.43655942,289.3795176,792.9512257,Benign
192.168.42.240,50955,172.217.24.68,443,80,14045,36,3893,44,10152,211.717794,396.680002,78.51164627,204.7393355,Benign
192.168.137.97,40882,103.211.218.251,80,14,5078,8,2677,6,2401,609.9130107,11.50302903,1861.77049,1669.821048,Benign
192.168.137.97,60232,172.217.161.4,443,13,1801,7,1249,6,552,4210.017059,55.34973111,180.5248156,79.78358542,Benign
10.0.2.15,51560,119.254.87.201,80,11,1579,6,705,5,874,20612.00637,3.545724,1590.648341,1971.952696,Malicious
172.30.6.255,57414,103.243.221.109,80,16,5471,9,4245,7,1226,2769.888982,23.141872,1467.469875,423.8205103,Benign
192.168.43.233,50712,172.217.166.206,443,22,7469,11,1663,11,5806,1843.41307,10.414155,1277.492029,4460.083415,Benign
192.168.43.233,51268,49.44.170.2,443,14,1594,7,1009,7,585,1969.340699,20.453064,394.659695,228.8165724,Benign
10.0.2.15,47292,119.254.87.201,80,11,1582,6,705,5,877,4723.260589,0.888715,6346.241483,7894.54437,Malicious
172.30.1.136,50442,157.240.16.17,443,15,4922,7,971,8,3951,855.430625,0.214839,36157.3085,147124.1255,Benign
192.168.43.224,39062,103.37.200.184,443,29,11353,16,2186,13,9167,2510.286801,5.957699616,2935.361151,12309.44907,Benign
172.30.6.255,58292,52.84.110.11,443,11,1405,7,958,4,447,5320.978593,2.971188,2579.439605,1203.55898,Benign
192.168.215.49,35518,103.231.98.48,443,43,17734,20,6744,23,10990,620.1263389,105.6240883,510.7925745,832.3858829,Benign
10.0.2.15,56550,119.254.87.201,80,11,1582,6,705,5,877,8961.928756,1.286054,4385.507918,5455.447438,Malicious
172.30.15.853,50157,158.85.224.180,443,24,7272,11,2604,13,4668,3354.259815,1.146554,18169.22709,32570.64212,Benign
10.0.2.15,55141,119.254.87.201,80,11,1582,6,705,5,877,3524.284964,1.623747,3473.447526,4320.870185,Malicious
192.168.43.224,49636,52.218.204.96,443,40,10420,21,1869,19,8551,2280.070473,17.34551147,862.0097495,3943.844498,Benign
192.168.215.49,36482,157.240.16.52,443,27,6100,13,1851,14,4249,142.3166455,65.1380256,227.3326504,521.845722,Benign
172.30.15.199,49482,52.114.88.28,443,19,7475,11,2835,8,4640,0,1.51064,15013.50421,24572.36668,Benign
172.30.15.1347,50655,52.221.149.123,443,15,3390,8,1888,7,1502,3492.168618,4.923612,3067.666583,2440.48475,Benign
172.30.6.255,56059,103.243.221.87,80,51,33289,21,9342,30,23947,284.902713,19.212596,3889.948032,9971.375029,Benign
172.30.15.742,50031,157.240.16.52,443,6,348,4,228,2,120,2545.776,0.434618,4196.788904,2208.836265,Benign
172.30.6.255,56540,23.198.119.247,443,23,10431,12,1698,11,8733,832.153515,41.433259,327.8525592,1686.181625,Benign
172.30.15.1338,50646,104.20.90.77,443,26,7507,13,1768,13,5739,3491.275174,5.751002,2459.39751,7983.304475,Benign
10.0.2.15,43828,119.254.87.201,80,11,1513,6,705,5,808,23315.52504,0.787331,7163.442059,8210.015864,Malicious
172.30.6.255,56874,103.15.158.152,80,5,294,3,174,2,120,1383.819569,20.540172,67.76963698,46.73768068,Benign
10.0.2.15,55760,119.254.87.201,80,11,1582,6,705,5,877,25718.24719,2.024595,2785.742334,3465.384435,Malicious
192.168.43.224,39072,103.37.200.184,443,17,1902,9,1182,8,720,2514.01518,27.93833964,338.4596265,206.1683004,Benign
10.0.2.15,47024,119.254.87.201,80,11,1513,6,705,5,808,5536.350443,1.84451,3057.722647,3504.453757,Malicious
192.168.43.224,55388,34.200.202.18,443,23,7442,13,1485,10,5957,3093.009511,17.12958467,693.5369556,2782.087303,Benign
172.30.6.255,56989,103.231.98.53,80,22,15521,15,15083,7,438,1452.843276,6.903989,17477.43225,507.5326742,Benign
172.30.6.255,58359,172.217.166.206,443,18,1887,11,1246,7,641,5462.403134,97.767904,101.9557502,52.45075112,Benign
192.168.215.49,36620,52.221.139.158,443,28,10893,16,3657,12,7236,612.6041687,113.1461133,258.5683161,511.6216394,Benign
172.30.6.255,58338,103.231.98.53,80,19,6478,10,5744,9,734,5419.839835,9.253918,4965.680483,634.5420394,Benign
172.30.6.255,56573,173.241.248.220,80,67,35002,35,15022,32,19980,888.11878,262.12275,458.4722234,609.790642,Benign
192.168.137.97,51738,198.252.206.25,443,118,14240,58,6026,60,8214,10.42500098,1956.864874,24.6353239,33.58024402,Benign
172.30.6.255,57849,103.243.221.109,80,7,406,5,294,2,112,4223.862217,14.195063,165.6914098,63.12053705,Benign
192.168.43.224,39084,103.37.200.184,443,160,107615,81,7649,79,99966,2542.331907,28.66924835,2134.412429,27894.97619,Benign
172.30.1.136,51910,13.107.4.52,80,1,66,1,66,0,0,5743.82126,0,0,0,Benign
172.30.6.255,56535,23.198.119.247,443,19,9837,9,1170,10,8667,832.138985,41.447638,225.8271026,1672.857691,Benign
172.30.6.255,55982,157.240.16.39,443,27,5369,14,3220,13,2149,179.108612,61.014771,422.192849,281.7678362,Benign
172.30.15.1698,51009,184.29.25.7,443,7,402,4,228,3,174,3609.707298,7.419204,245.8484765,187.6212057,Benign
172.30.1.136,51861,74.125.24.188,5228,9,535,5,295,4,240,4082.016129,57.727566,40.88168207,33.25967355,Benign
172.30.15.1436,50744,202.58.9.200,443,20,8435,11,1919,9,6516,3501.206936,5.846839,2625.692276,8915.586696,Benign
172.30.6.255,56908,210.176.156.55,80,29,9117,15,5758,14,3359,1385.59905,310.32039,148.4401331,86.59437429,Benign
10.0.2.15,58037,119.254.87.201,80,11,1569,6,705,5,864,6016.74308,1.217037,4634.205862,5679.367184,Malicious
192.168.137.97,56106,172.217.161.14,443,104,25188,50,9565,54,15623,281.1469463,75.37541491,1015.185125,1658.153393,Benign
10.0.2.15,60524,119.254.87.201,80,11,1582,6,705,5,877,2410.779947,1.511032,3732.548351,4643.184261,Malicious
172.30.1.136,50280,52.94.220.15,443,29,7638,13,1393,16,6245,483.806043,27.880335,399.7082531,1791.944035,Benign
192.168.43.233,51343,52.77.26.194,443,28,8461,15,2074,13,6387,3383.407442,81.420918,203.7805567,627.5537203,Benign
10.0.2.15,34606,119.254.87.201,80,11,1513,6,705,5,808,20819.71091,1.827019,3086.995811,3538.00371,Malicious
172.30.6.255,58162,103.243.221.17,80,32,18365,19,15252,13,3113,4958.879925,13.336043,9149.340625,1867.420493,Benign
172.30.15.741,50030,157.240.16.52,443,241,173021,116,8908,125,164113,2545.747993,10.451601,6818.476901,125617.5011,Benign
172.30.15.1148,50456,87.248.118.22,443,20,7306,10,1195,10,6111,3458.536717,8.408562,1136.936375,5814.073798,Benign
172.30.1.136,50246,23.58.57.98,443,8,456,5,282,3,174,438.199623,40.836592,55.24457085,34.08707563,Benign
172.30.6.255,57376,172.217.166.206,443,39,6836,22,4057,17,2779,2620.406634,80.025116,405.5726705,277.8127807,Benign
172.30.1.136,50542,172.217.161.14,443,42,8254,20,4957,22,3297,1336.121244,67.523003,587.2961545,390.6224372,Benign
10.0.2.15,57542,119.254.87.201,80,11,1582,6,705,5,877,9923.095878,1.817172,3103.723808,3860.944369,Malicious
172.30.15.1052,50358,157.240.16.39,443,248,220722,85,6505,163,214217,3448.548907,8.599551,6051.478734,199282.0323,Benign
192.168.43.233,51337,104.16.50.161,443,9,534,5,294,4,240,3371.334772,13.270315,177.2376918,144.68383,Benign
10.0.2.15,37932,124.95.142.227,80,17,6479,9,730,8,5749,19.465569,33.751141,173.0311873,1362.679857,Malicious
10.0.2.15,33601,119.254.87.201,80,11,1579,6,705,5,874,13131.51638,1.740459,3240.524482,4017.33106,Malicious
172.30.6.255,58368,103.243.221.109,80,17,7537,10,6336,7,1201,5484.885626,4.334739,11693.4376,2216.511767,Benign
192.168.43.233,50937,54.239.35.198,443,44,17546,20,3807,24,13739,451.207065,6.742327,4517.134811,16301.79017,Benign
172.30.6.255,56083,103.243.221.46,80,25,14033,15,11877,10,2156,305.079048,19.751632,4810.5392,873.244297,Benign
172.30.15.576,49860,104.113.219.221,443,25,7481,12,2376,13,5105,2260.727559,5.362275,3544.764116,7616.170375,Benign
10.0.2.15,42998,119.254.87.201,80,11,1582,6,705,5,877,18783.19857,5.220502,1080.355874,1343.932059,Malicious
192.168.43.233,51255,52.84.108.242,443,50,22854,24,4102,26,18752,2295.288827,217.593316,150.8134561,689.432942,Benign
172.30.15.941,50247,208.100.17.187,80,12,2814,7,1037,5,1777,3441.042575,1.002748,8273.265068,14177.04149,Benign
192.168.43.224,34374,52.84.110.254,443,240,143297,115,10831,125,132466,360.0842899,212.0183934,408.6815234,4998.283323,Benign
10.0.2.15,59287,119.254.87.201,80,11,1513,6,705,5,808,18329.70427,1.352233,4170.878835,4780.241275,Malicious
172.30.15.2502,51836,14.139.45.128,80,10,1412,5,678,5,734,5475.731014,0.185826,29188.59578,31599.45325,Benign
10.0.2.15,33523,119.254.87.201,80,12,1656,7,779,5,877,7788.681229,7.407704,841.2863149,947.1220772,Malicious
192.168.43.224,34268,52.220.246.153,443,26,9898,14,2585,12,7313,2302.669096,103.5563892,199.6979632,564.9482418,Benign
172.30.15.634,49921,23.198.105.137,443,19,6145,11,1285,8,4860,2392.889557,3.210783,3201.711234,12109.19579,Benign
192.168.43.224,51244,18.210.21.97,443,32,3912,18,2399,14,1513,935.6779683,65.53976761,292.8298452,184.6817656,Benign
172.30.6.255,55648,151.139.104.15,80,7,402,4,228,3,174,36.877302,14.793134,123.3004447,94.09770776,Benign
10.0.2.15,36077,119.254.87.201,80,11,1582,6,705,5,877,13972.60496,1.7143,3289.972584,4092.632561,Malicious
192.168.137.97,52272,172.217.161.3,443,21,2610,11,1886,10,724,9517.438205,37.89315482,398.1721783,152.8508256,Benign
172.30.1.136,50488,172.217.161.3,443,52,6126,28,3788,24,2338,949.233162,77.964364,388.6904022,239.9044774,Benign
192.168.137.97,35366,104.17.38.113,443,1622,739981,826,56602,796,683379,3514.990513,8883.315286,50.9737621,615.4269914,Benign
192.168.137.97,39790,172.217.167.10,443,19,5129,11,1529,8,3600,151.9175791,22.99263978,531.9963308,1252.574749,Benign
10.0.2.15,60326,119.254.87.201,80,11,1582,6,705,5,877,22832.04147,0.822803,6854.617691,8526.94995,Malicious
10.0.2.15,53567,119.254.87.201,80,12,1587,7,779,5,808,2500.894773,4.394396,1418.169869,1470.964383,Malicious
10.0.2.15,43789,119.254.87.201,80,11,1582,6,705,5,877,18237.09898,5.338511,1056.474361,1314.224135,Malicious
172.30.6.255,57748,103.243.221.87,80,30,20659,13,5437,17,15222,3844.927995,1.480531,29378.64861,82251.57055,Benign
192.168.137.97,58586,223.165.30.126,443,148,98174,57,5924,91,92250,1.210752525,315.723756,150.1059046,2337.486445,Benign
192.168.43.224,51234,54.236.156.42,443,6,412,4,272,2,140,44.55962511,11.7868649,184.6122798,95.02102636,Benign
192.168.215.49,38456,158.85.224.176,443,9,604,5,338,4,266,1863.073113,120.1483917,22.50550308,17.71143142,Benign
172.30.15.1429,50737,103.231.98.48,443,37,17231,15,9136,22,8095,3500.725669,6.34457,11519.77203,10207.15352,Benign
10.0.2.15,60408,119.254.87.201,80,11,1569,6,705,5,864,19203.64159,3.138089,1797.272161,2202.614394,Malicious
10.0.2.15,39541,119.254.87.201,80,12,1656,7,779,5,877,18239.53689,5.189621,1200.858406,1351.929168,Malicious
192.168.43.233,50740,172.217.166.197,443,40,21715,17,4060,23,17655,1871.419404,1.901348,17082.61717,74284.13946,Benign
192.168.43.233,50999,104.244.42.1,443,784,472217,364,99837,420,372380,520.661004,1528.901796,522.3984968,1948.483551,Benign
172.30.15.1915,51227,13.56.57.63,443,23,9526,12,2143,11,7383,3985.18248,2.354687,7280.79783,25083.5886,Benign
172.30.6.255,58028,172.217.166.206,443,17,1783,10,1154,7,629,4780.430666,91.050993,101.3937322,55.26573444,Benign
172.30.1.136,50529,52.84.103.186,443,113,61144,53,4852,60,56292,1069.816333,58.399699,664.66096,7711.272621,Benign
10.0.2.15,47200,119.254.87.201,80,11,1579,6,705,5,874,4637.428788,1.486561,3793.991636,4703.473319,Malicious
172.30.1.136,50498,157.240.16.39,443,27,6360,9,1596,18,4764,964.302224,145.167383,87.95364176,262.5383141,Benign
192.168.137.97,40008,117.18.237.29,80,23,3886,14,1720,9,2166,23.21963884,270.2309429,50.91940935,64.12293061,Benign
10.0.2.15,52066,119.254.87.201,80,11,1582,6,705,5,877,16047.03376,4.151341,1358.597138,1690.056297,Malicious
172.30.15.1410,50718,207.244.67.99,443,20,6926,11,1986,9,4940,3500.068638,6.310365,2517.762443,6262.71222,Benign
172.30.15.593,49878,23.56.25.241,443,19,7963,11,1273,8,6690,2321.315706,4.744491,2146.489476,11280.45137,Benign
10.0.2.15,41992,119.254.87.201,80,11,1579,6,705,5,874,14515.43974,0.844013,6682.361528,8284.232589,Malicious
172.30.15.2279,51598,104.121.241.30,443,22,9010,11,1074,11,7936,4541.727779,60.500112,142.016266,1049.386487,Benign
172.30.6.255,56870,184.29.25.41,80,36,16214,16,1246,20,14968,1379.010969,301.700703,33.03936617,396.8966556,Benign
10.0.2.15,46607,119.254.87.201,80,11,1582,6,705,5,877,4397.198129,2.480599,2273.64439,2828.349121,Malicious
10.0.2.15,46087,119.254.87.201,80,11,1579,6,705,5,874,9562.656798,1.422909,3963.710961,4913.877135,Malicious
192.168.137.97,45564,192.168.121.7,8080,35,15098,18,4356,17,10742,2904.424115,91.11487355,382.462255,943.1610521,Benign
192.168.43.233,51130,192.82.211.131,443,7,402,4,228,3,174,922.379116,17.032858,107.0871371,81.72439411,Benign
192.168.43.233,51650,204.79.197.200,443,9,534,6,348,3,186,855.818917,28.15355,98.8862861,52.85301498,Benign
192.168.43.233,51234,172.217.160.227,443,20,4217,12,3360,8,857,1631.690991,40.075514,670.7337553,171.0770322,Benign
192.168.43.224,42052,157.240.16.20,443,9,626,6,412,3,214,934.3398809,13.9363442,236.5039175,122.8442678,Benign
10.0.2.15,53685,119.254.87.201,80,11,1582,6,705,5,877,1752.33337,1.048439,5379.425985,6691.853317,Malicious
10.0.2.15,38279,119.254.87.201,80,11,1579,6,705,5,874,4697.452312,1.62738,3465.693323,4296.476545,Malicious
10.0.2.15,56876,119.254.87.201,80,11,1582,6,705,5,877,15569.26079,1.715172,3288.299949,4090.551851,Malicious
172.30.15.1193,50501,72.21.206.140,80,6,344,4,228,2,116,3465.345537,2.307858,790.3432534,402.1044622,Benign
10.0.2.15,51848,119.254.87.201,80,11,1513,6,705,5,808,21420.42196,2.013825,2800.640572,3209.812173,Malicious
172.30.1.136,50816,172.217.161.3,443,24,2845,12,1693,12,1152,1956.370958,24.833882,545.3839235,371.1058948,Benign
192.168.43.224,40074,13.107.21.200,443,46,12276,23,3095,23,9181,106.252564,124.7618518,198.4580994,588.7055932,Benign
192.168.137.97,51886,172.217.161.3,443,160,83128,82,9994,78,73134,5227.497112,241.6636455,330.839998,2421.017852,Benign
172.30.15.1633,50943,152.195.60.249,443,201,164347,79,5395,122,158952,3575.061475,1.951011,22121.864,651772.8501,Benign
10.0.2.15,55504,119.254.87.201,80,11,1582,6,705,5,877,3105.68526,1.695801,3325.861938,4137.2779,Malicious
192.168.43.224,45468,54.173.101.22,443,22,6157,12,1984,10,4173,44.40686744,12.44966591,1274.893649,2681.517741,Benign
172.30.6.255,56424,205.180.87.204,80,7,398,4,228,3,170,678.979428,19.178039,95.10878563,70.91444542,Benign
172.30.15.233,49502,52.229.174.29,443,27,9277,15,1465,12,7812,52.018772,0.693301,16904.63449,90142.66531,Benign
10.0.2.15,39765,119.254.87.201,80,11,1582,6,705,5,877,18119.3892,2.156563,2615.272542,3253.324851,Malicious
172.30.15.438,49712,59.63.81.183,443,90,50661,42,4904,48,45757,1623.845432,7.063015,5554.56841,51827.1588,Benign
172.30.1.136,51505,13.107.21.200,443,1,54,0,0,1,54,106.229574,0,0,0,Benign
172.30.6.255,55950,54.236.156.42,443,6,348,4,228,2,120,159.14797,13.899337,131.2292809,69.0680426,Benign
172.30.1.136,50277,104.17.37.113,443,8,492,4,252,4,240,482.65299,8.548975,235.8177442,224.5883278,Benign
10.0.2.15,60035,119.254.87.201,80,11,1513,6,705,5,808,10398.75872,0.820257,6875.893775,7880.456979,Malicious
192.168.43.224,54948,54.85.227.48,443,6,412,4,272,2,140,362.8838763,43.07464396,50.51695847,26.00137568,Benign
192.168.43.233,51452,49.44.178.248,80,9,534,5,294,4,240,3810.60457,18.673253,125.9555579,102.8208636,Benign
10.0.2.15,39211,119.254.87.201,80,11,1582,6,705,5,877,22504.27618,1.88353,2994.377578,3724.92076,Malicious
10.0.2.15,37069,119.254.87.201,80,12,1653,7,779,5,874,16200.01884,5.178781,1203.37199,1350.124672,Malicious
172.30.15.1166,50474,210.176.156.62,80,17,10924,7,3553,10,7371,3460.540079,7.137995,3982.070595,8261.14336,Benign
10.0.2.15,58582,119.254.87.201,80,11,1582,6,705,5,877,23642.89303,2.149851,2623.437624,3263.481981,Malicious
172.30.6.255,56202,103.243.221.17,80,15,4983,7,2509,8,2474,466.978799,24.058407,834.3029528,822.6646095,Benign
172.30.15.951,50257,103.243.221.108,443,6,348,4,228,2,120,3441.452798,5.809149,313.9874705,165.2565634,Benign
172.30.6.255,57535,216.58.221.40,443,16,5184,8,1219,8,3965,3135.525947,12.942095,753.5101543,2450.91695,Benign
172.30.1.136,50422,52.84.103.186,443,3,198,3,198,0,0,833.10469,8.999533,176.0091329,0,Benign
172.30.6.255,58497,157.240.16.17,443,423,363342,167,12437,256,350905,5721.672326,7.391439,13460.9783,379796.1398,Benign
192.168.43.224,45520,172.217.166.196,443,18,5974,10,1467,8,4507,1249.03101,30.77662751,381.3283309,1171.538369,Benign
172.30.6.255,57142,103.243.221.75,80,31,18279,18,15142,13,3137,1875.843717,46.19945,2622.022557,543.20993,Benign
172.30.15.1831,51143,104.16.121.145,443,202,119443,90,7856,112,111587,3864.634834,2.541429,24729.39437,351257.5012,Benign
192.168.137.97,45556,192.168.121.7,8080,2680,2334591,1094,86939,1586,2247652,2901.869145,104.5061692,6655.224333,172058.8951,Benign
10.0.2.15,58720,119.254.87.201,80,11,1582,6,705,5,877,4392.963132,1.223508,4609.696054,5734.33112,Malicious
192.168.215.49,33270,54.87.224.116,443,75,9859,42,5195,33,4664,1533.310715,49.79434099,834.6329959,749.3220968,Benign
10.0.2.15,58040,119.254.87.201,80,11,1582,6,705,5,877,16737.78641,2.149578,2623.770805,3263.896449,Malicious
172.30.15.653,49940,45.56.120.142,80,6,348,4,228,2,120,2395.815079,10.640155,171.4260742,90.22424955,Benign
192.168.43.224,51338,209.167.231.17,443,32,3935,16,2192,16,1743,107.7364212,304.7394866,57.54423293,45.75711587,Benign
10.0.2.15,60008,119.254.87.201,80,11,1558,6,705,5,853,19588.43998,1.742589,3236.563527,3916.012324,Malicious
172.30.1.136,50445,157.240.16.17,443,27,6482,7,983,20,5499,855.435521,155.837779,50.4627315,282.2935509,Benign
172.30.15.401,49673,62.210.213.13,80,1452,1436552,465,25667,987,1410885,1486.635247,3.935731,52172.26482,2867848.438,Benign
192.168.43.224,34862,172.217.166.197,443,1191,804291,446,54402,745,749889,53.1536617,307.0524813,1417.399391,19537.74148,Benign
172.30.6.255,57480,103.243.220.231,80,31,15749,15,8287,16,7462,3005.845896,36.182735,1832.25508,1649.847641,Benign
172.30.6.255,56933,54.169.196.206,80,6,348,4,228,2,120,1387.519025,16.924453,107.7730548,56.7226604,Benign
172.30.6.255,57410,157.240.16.39,443,28,5595,15,3417,13,2178,2741.096393,61.02977,447.9125515,285.5000109,Benign
172.30.6.255,57431,52.213.19.114,443,18,6378,9,1141,9,5237,2796.745332,33.998507,268.4823778,1232.289406,Benign
192.168.43.233,51233,172.217.160.227,443,21,4271,12,3360,9,911,1631.690738,40.347615,666.210382,180.6302553,Benign
172.30.1.136,50254,104.17.161.9,443,1,66,1,66,0,0,460.704742,0,0,0,Benign
172.30.6.255,56512,23.198.119.247,443,20,8977,10,1396,10,7581,831.967943,41.616413,268.3556605,1457.309644,Benign
192.168.137.97,33694,104.17.162.9,443,19,7025,11,1207,8,5818,3519.297557,12.85630867,751.0709524,3620.323779,Benign
10.0.2.15,56612,119.254.87.201,80,11,1582,6,705,5,877,17101.10761,1.392679,4049.748722,5037.772523,Malicious
172.30.6.255,56436,103.243.221.75,80,87,71631,31,19966,56,51665,697.839504,49.230452,3244.495907,8395.616599,Benign
10.0.2.15,42814,119.254.87.201,80,11,1582,6,705,5,877,3401.987559,1.689274,3338.71237,4153.263473,Malicious
192.168.137.97,59068,173.241.248.220,443,11,644,5,282,6,362,7.968004858,16.74414182,134.7336892,172.9560123,Benign
172.30.6.255,58085,122.15.34.40,80,20,11601,9,913,11,10688,4857.691534,14.82574,492.6566903,5767.266929,Benign
172.30.6.255,58281,157.240.16.39,443,4,264,1,66,3,198,5303.100163,15.066986,35.04350505,105.1305152,Benign
10.0.2.15,45109,119.254.87.201,80,11,1579,6,705,5,874,15594.34216,1.428449,3948.338373,4894.819486,Malicious
172.30.6.255,57251,151.101.65.69,443,16,5714,10,1186,6,4528,2252.128327,20.100201,472.0350806,1802.171033,Benign
10.0.2.15,47456,119.254.87.201,80,11,1579,6,705,5,874,17969.23755,126.959641,44.42356607,55.07261949,Malicious
172.30.6.255,55893,52.69.18.116,443,33,9031,16,2107,17,6924,113.433179,60.676316,277.8019681,912.9097422,Benign
172.30.15.611,49898,104.31.90.207,80,193,140338,90,18792,103,121546,2388.973137,7.316064,20548.75408,132908.6241,Benign
172.30.1.136,50489,172.217.161.3,443,14,864,8,492,6,372,950.226853,15.278915,257.6099154,194.7782287,Benign
172.30.6.255,57554,103.243.220.231,80,22,13002,9,4216,13,8786,3218.853835,35.176958,958.809457,1998.12616,Benign
192.168.43.233,51357,139.59.72.43,443,29,4911,15,3059,14,1852,3137.069418,134.945164,181.3477362,109.7927451,Benign
10.0.2.15,59144,119.254.87.201,80,11,1554,6,705,5,849,12050.41527,2.555755,2206.784297,2657.531727,Malicious
172.30.1.136,50379,157.240.16.20,443,28,6944,9,2125,19,4819,690.137277,127.667296,133.1586125,301.9724018,Benign
172.30.15.1341,50649,104.244.42.195,443,6,348,4,228,2,120,3491.552505,5.587872,326.4212208,171.8006425,Benign
172.30.15.2503,51837,14.139.45.128,80,10,1422,5,683,5,739,5475.8508,0.146654,37257.76317,40312.57245,Benign
192.168.43.233,51208,52.216.228.96,80,67,43054,30,2186,37,40868,1154.497468,62.037187,281.895438,5270.12935,Benign
192.168.43.224,47660,54.82.135.50,443,6,412,4,272,2,140,1158.587384,15.80230919,137.7013937,70.87571736,Benign
10.0.2.15,46636,119.254.87.201,80,11,1582,6,705,5,877,14307.99412,1.580804,3567.804737,4438.247879,Malicious
172.30.15.2174,51486,104.19.198.151,443,261,184398,106,10661,155,173737,4248.99143,9.159964,9310.953624,151735.9675,Benign
192.168.43.233,50945,54.83.70.244,443,17,7232,9,1141,8,6091,455.233725,21.416729,426.2088762,2275.230732,Benign
172.30.6.255,55851,209.191.163.208,443,21,8943,12,2404,9,6539,103.447322,17.791538,1080.963321,2940.274191,Benign
172.30.6.255,56871,115.114.126.194,443,12,1404,6,904,6,500,1379.292261,11.590079,623.9819418,345.1227554,Benign
172.30.6.255,56658,103.243.221.109,80,31,17254,17,14873,14,2381,1091.099863,31.050373,3831.966849,613.4547884,Benign
10.0.2.15,36737,119.254.87.201,80,11,1513,6,705,5,808,6529.438165,2.112747,2669.510358,3059.523928,Malicious
192.168.137.97,39328,172.217.160.238,443,140,26501,66,10848,74,15653,7408.81681,378.1803201,229.4778321,331.1224656,Benign
172.30.6.255,56854,103.243.220.231,80,16,5537,9,4309,7,1228,1352.883274,23.175929,1487.405316,423.888078,Benign
192.168.137.97,54406,122.15.34.26,80,19,4041,10,1442,9,2599,84.23520906,94.52735163,122.0387518,219.9575006,Benign
172.30.15.764,50055,209.197.3.15,443,6,348,4,228,2,120,2617.680404,8.683658,210.0497279,110.5524884,Benign
172.30.6.255,57357,103.243.221.17,80,31,18720,16,9346,15,9374,2527.857711,7.301084,10240.67111,10271.35149,Benign
10.0.2.15,45409,119.254.87.201,80,11,1582,6,705,5,877,17035.98157,2.213257,2548.280656,3169.988844,Malicious
172.30.6.255,62078,172.30.13.95,50872,3,198,0,0,3,198,3607.843744,8.98329,0,176.3273812,Benign
172.30.15.2358,51692,14.139.45.128,80,161,150328,55,3357,106,146971,5332.441989,0.879492,30535.80931,1336871.74,Benign
192.168.43.233,51018,157.240.16.39,443,7,402,4,228,3,174,698.817598,40.991993,44.49649472,33.95785123,Benign
172.30.6.255,57993,184.29.26.80,80,13,2660,7,617,6,2043,4722.266708,60.987394,80.93475842,267.9898079,Benign
172.30.15.1011,50317,35.203.66.107,443,29,7131,15,2430,14,4701,3443.959677,3.32439,5847.689351,11312.75211,Benign
172.30.15.1101,50407,180.149.59.136,80,11,3066,6,905,5,2161,3456.467921,0.636479,11375.08072,27161.93307,Benign
172.30.6.255,57413,103.243.221.109,80,21,11073,9,4498,12,6575,2769.888691,23.142257,1554.904519,2272.898447,Benign
10.0.2.15,57255,119.254.87.201,80,11,1582,6,705,5,877,5988.876014,0.823421,6849.473113,8520.550241,Malicious
192.168.42.240,51027,54.182.215.114,443,10634,9155549,4032,241895,6602,8913654,501.982433,115.565694,16745.10777,617044.9857,Benign
10.0.2.15,43373,119.254.87.201,80,11,1513,6,705,5,808,2022.561037,1.857012,3037.137078,3480.860651,Malicious
192.168.137.97,38456,54.85.133.68,443,87,12388,47,5519,40,6869,6969.02012,1019.210188,43.31981815,53.91625854,Benign
172.30.15.1385,50693,184.29.24.49,443,42,30563,16,1998,26,28565,3495.662568,1.355383,11792.9766,168601.79,Benign
172.30.6.255,56749,74.125.24.188,5228,17,2183,9,1282,8,901,1244.342484,2.100227,4883.281664,3432.009968,Benign
172.30.6.255,56285,95.142.20.29,80,7,609,5,282,2,327,569.021713,19.820972,113.8188379,131.9814185,Benign
172.30.6.255,58374,35.190.43.164,80,10,1573,6,1119,4,454,5484.91586,4.154794,2154.619459,874.1708975,Benign
192.168.215.49,46404,223.31.160.67,443,169,110668,76,12830,93,97838,310.2589149,24.74828093,4147.358771,31626.60074,Benign
10.0.2.15,54746,119.254.87.201,80,11,1582,6,705,5,877,9652.912471,2.020358,2791.584462,3472.651877,Malicious
172.30.1.136,50666,74.125.68.188,5228,14,1994,7,1174,7,820,1798.133477,0.341481,27503.72642,19210.43923,Benign
172.30.1.136,50217,13.107.4.52,80,15,2768,7,710,8,2058,380.256373,1.31159,4330.621612,12552.70321,Benign
192.168.43.233,51052,49.44.170.52,443,28,9741,14,1423,14,8318,889.510401,18.397824,618.7688283,3616.949483,Benign
192.168.43.233,51269,49.44.170.2,443,9,534,5,294,4,240,1969.592998,21.489222,109.4502165,89.3471155,Benign
172.30.6.255,56561,172.217.166.195,443,83,13444,39,4709,44,8735,875.99771,274.112853,137.4324465,254.9314971,Benign
172.30.6.255,55619,157.240.16.20,443,12,1688,6,917,6,771,3.43013,0.096315,76166.74454,64039.86918,Benign
172.30.1.136,50458,157.240.16.39,443,2,132,2,132,0,0,857.946677,3.000633,351.9257437,0,Benign
10.0.2.15,54567,119.254.87.201,80,9,907,5,651,4,256,18542.91506,131.515345,39.59994174,15.57232732,Malicious
172.30.15.1042,50348,4.78.226.234,443,24,8751,11,1791,13,6960,3447.577355,9.824485,1458.397056,5667.472646,Benign
172.30.6.255,58224,172.217.167.2,80,44,11665,23,6529,21,5136,5174.949883,84.069328,621.2967469,488.7394842,Benign
192.168.43.224,54308,52.206.154.207,443,44,9236,24,3360,20,5876,21.00919841,13.22120647,2033.097362,3555.500029,Benign
172.30.6.255,55673,35.201.68.17,80,87,80799,27,1829,60,78970,41.156677,17.47471,837.324339,36152.81741,Benign
172.30.6.255,57235,192.168.240.1,7680,3,198,3,198,0,0,2198.917495,9.004735,175.9074531,0,Benign
192.168.137.97,56424,172.217.161.14,443,13,1887,8,1320,5,567,985.9224628,55.7929748,189.271141,81.30055829,Benign
172.30.6.255,55786,172.217.166.202,443,47,9594,25,4209,22,5385,69.428643,100.754424,334.1987246,427.574277,Benign
10.0.2.15,38239,119.254.87.201,80,11,1582,6,705,5,877,10969.33563,1.833449,3076.169558,3826.667663,Malicious
172.30.15.2235,51552,87.250.251.119,443,14,3021,8,1921,6,1100,4459.172924,8.579188,1791.311719,1025.7381,Benign
172.30.1.136,50350,13.107.4.52,80,16,3481,7,568,9,2913,628.013569,2.505943,1813.289448,9299.493245,Benign
172.30.6.255,57184,103.243.221.109,80,40,24281,23,20135,17,4146,2043.845376,29.184386,5519.389718,1136.498126,Benign
10.0.2.15,59425,119.254.87.201,80,11,1582,6,705,5,877,26201.23031,0.816508,6907.464471,8592.689845,Malicious
192.168.137.97,34360,172.217.161.3,443,9,638,8,572,1,66,220.1460013,66.00969559,69.32314956,7.99882495,Benign
172.30.15.1605,50915,54.201.247.66,443,45,12582,26,7182,19,5400,3573.72705,13.777529,4170.268849,3135.540488,Benign
172.30.15.1331,50639,104.244.42.133,443,25,7017,13,1824,12,5193,3489.854824,7.285306,2002.935772,5702.437207,Benign
192.168.43.224,49710,34.227.238.173,443,9,635,4,240,5,395,27.65142349,14.90462163,128.8191037,212.0147749,Benign
192.168.43.224,38494,140.98.193.112,443,22,8552,12,4037,10,4515,3265.894357,9.490100306,3403.125252,3806.071468,Benign
192.168.43.224,37872,103.37.200.180,80,8,552,5,338,3,214,2459.055371,17.69967412,152.7711743,96.72494467,Benign
192.168.43.233,50981,49.44.170.2,443,819,630033,356,55719,463,574314,502.158402,660.751087,674.6141002,6953.468697,Benign
10.0.2.15,58940,118.26.228.168,80,13,1775,7,906,6,869,185.315453,76.034214,95.32550701,91.43252273,Malicious
10.0.2.15,35932,119.254.87.201,80,11,1593,6,705,5,888,26526.26826,2.088996,2699.86156,3400.676689,Malicious
172.30.6.255,58064,103.243.221.51,80,16,5551,9,4317,7,1234,4826.853594,12.349414,2796.569943,799.3901573,Benign
172.30.6.255,56601,103.243.221.109,80,40,28528,21,13381,19,15147,951.840429,9.551772,11207.13518,12686.23246,Benign
192.168.43.233,51284,23.9.140.60,80,18,4406,9,3608,9,798,2770.968843,9.428743,3061.277627,677.0785883,Benign
192.168.137.97,60176,198.252.206.25,443,27,6790,15,2453,12,4337,73.50335304,103.0619818,190.40969,336.6517837,Benign
10.0.2.15,56087,119.254.87.201,80,12,1656,7,779,5,877,25447.93111,4.308419,1446.470271,1628.439574,Malicious
192.168.43.233,51416,13.107.246.10,443,19,4992,8,1056,11,3936,3649.367519,124.221891,68.00733697,253.4818923,Benign
192.168.43.224,46910,157.240.16.16,443,16,1216,8,632,8,584,12.41599459,4.542811409,1112.967179,1028.438026,Benign
192.168.43.233,51259,52.84.108.242,443,59,30424,30,3629,29,26795,2300.636567,214.648485,135.2536916,998.6560119,Benign
192.168.43.224,40148,104.16.44.54,80,941,807489,383,21654,558,785835,1174.339041,101.5196461,1706.388927,61925.74778,Benign
172.30.15.1536,50844,162.247.242.19,443,22,5799,10,2009,12,3790,3528.819649,8.386821,1916.339934,3615.195793,Benign
10.0.2.15,50751,119.254.87.201,80,11,1579,6,705,5,874,12683.57555,2.08698,2702.469597,3350.295643,Malicious
172.30.6.255,56920,35.201.85.114,80,7,414,5,294,2,120,1386.160161,19.243598,122.2224659,49.88672077,Benign
10.0.2.15,39676,119.254.87.201,80,11,1582,6,705,5,877,24453.88527,0.981235,5747.858566,7150.172996,Malicious
192.168.43.233,51480,104.131.222.33,80,11,655,6,349,5,306,3816.682523,74.774714,37.33882553,32.73833986,Benign
10.0.2.15,60710,119.254.87.201,80,11,1582,6,705,5,877,24849.80177,1.547914,3643.613276,4532.55155,Malicious
192.168.43.224,37022,104.197.3.80,80,10,911,5,425,5,486,689.5418878,1.106469259,3072.837291,3513.879819,Benign
10.0.2.15,50354,119.254.87.201,80,11,1582,6,705,5,877,19804.22209,1.769383,3187.551819,3965.224036,Malicious
10.0.2.15,45979,119.254.87.201,80,11,1579,6,705,5,874,1754.29115,1.081702,5214.005336,6463.887466,Malicious
192.168.137.97,45560,192.168.121.7,8080,970,893868,355,27631,615,866237,2904.422158,101.9529099,2168.138215,67971.53714,Benign
192.168.137.97,56428,52.216.165.221,443,7,417,4,236,3,181,1042.306501,12.35962697,152.7554193,117.1556394,Benign
172.30.15.1036,50342,119.81.211.112,443,14,2721,8,1448,6,1273,3447.531365,9.687943,1195.713063,1051.203542,Benign
172.30.15.481,49756,172.217.166.196,443,23,5877,12,1428,11,4449,1730.057509,1.443224,7915.611159,24661.45241,Benign
172.30.6.255,57721,103.243.221.87,80,25,15121,16,13017,9,2104,3738.835226,23.279957,4473.204139,723.0253905,Benign
10.0.2.15,35426,119.254.87.201,80,12,1653,7,779,5,874,19443.89499,7.469311,834.3473715,936.097051,Malicious
10.0.2.15,34222,119.254.87.201,80,11,1579,6,705,5,874,25600.49776,0.822219,6859.486341,8503.81711,Malicious
10.0.2.15,38511,119.254.87.201,80,11,1579,6,705,5,874,18327.19973,2.834774,1989.576594,2466.510558,Malicious
172.30.6.255,56541,23.198.119.247,443,22,9830,11,1632,11,8198,832.251918,41.335581,315.8537919,1586.623398,Benign
10.0.2.15,43495,119.254.87.201,80,11,1593,6,705,5,888,4663.255617,1.874253,3009.198865,3790.31006,Malicious
192.168.215.49,57500,74.125.130.188,5228,78,5280,40,2706,38,2574,10.51838413,1665.044305,13.00145584,12.36723848,Benign
172.30.15.2300,51628,172.217.166.196,443,18,3185,9,1424,9,1761,4923.379013,1.173232,9709.929494,12007.85522,Benign
172.30.6.255,56925,115.114.126.213,443,17,6922,10,1207,7,5715,1386.864719,13.974342,690.9806558,3271.710396,Benign
10.0.2.15,42624,119.254.87.201,80,11,1582,6,705,5,877,17008.07942,1.308739,4309.491809,5360.885555,Malicious
10.0.2.15,36452,119.254.87.201,80,3,222,3,222,0,0,8361.38771,9.103366,195.0926723,0,Malicious
10.0.2.15,38641,119.254.87.201,80,11,1582,6,705,5,877,2353.017767,1.486886,3793.162354,4718.586361,Malicious
192.168.43.233,51320,104.19.195.151,443,51,12254,25,2395,26,9859,3365.087432,403.135577,47.52743517,195.6463396,Benign
172.30.15.1612,50922,54.201.247.66,443,6,348,4,228,2,120,3573.946832,3.367579,541.6354004,285.0712634,Benign
192.168.137.97,52200,172.217.161.3,443,51,11700,24,4860,27,6840,8325.68977,246.2025647,157.9187449,222.2560113,Benign
172.30.6.255,56903,54.169.115.222,443,111,82383,45,6007,66,76376,1385.47725,62.766306,765.6337144,9734.64967,Benign
172.30.6.255,58407,103.243.221.51,80,3,198,3,198,0,0,5550.877754,9.001274,175.9750897,0,Benign
192.168.137.97,37386,185.199.108.153,80,27,2700,15,1503,12,1197,5243.628622,423.4423253,28.39583878,22.61465004,Benign
10.0.2.15,44779,119.254.87.201,80,11,1579,6,705,5,874,16860.84187,1.823895,3092.283273,3833.554015,Malicious
10.0.2.15,39975,119.254.87.201,80,11,1579,6,705,5,874,5503.947928,1.818356,3101.702857,3845.231627,Malicious
172.30.6.255,58246,176.34.147.227,443,22,8291,11,2814,11,5477,5222.603076,36.545685,615.9961155,1198.937713,Benign
172.30.1.136,50812,172.217.161.14,443,27,3864,15,2321,12,1543,1952.395716,12.517481,1483.365543,986.1409017,Benign
10.0.2.15,47832,119.254.87.201,80,11,1568,6,705,5,863,20942.38556,1.484101,3800.280439,4651.974495,Malicious
192.168.43.224,51254,209.167.231.17,443,4,268,2,140,2,128,93.57022253,12.01101252,93.24775893,85.25509388,Benign
10.0.2.15,44254,119.254.87.201,80,11,1579,6,705,5,874,11242.15767,2.656666,2122.961637,2631.870171,Malicious
172.30.6.255,56557,74.125.68.188,5228,32,1759,17,937,15,822,859.216094,367.418397,20.40180911,17.89785175,Benign
172.30.1.136,50159,180.149.59.201,80,21,18315,6,515,15,17800,148.077866,1.097463,3754.112895,129753.8049,Benign
172.30.1.136,51485,74.125.68.188,5228,32,1910,18,986,14,924,40.753871,654.972446,12.04325472,11.28597095,Benign
192.168.137.97,39726,192.168.125.6,80,31,17885,16,1655,15,16230,8292.894098,4.535666721,2919.08573,28626.44193,Benign
192.168.43.224,51156,23.251.156.28,443,60,39436,30,4623,30,34813,3316.038592,44.98983847,822.0522958,6190.375638,Benign
192.168.43.224,50982,18.210.21.97,443,9,610,5,338,4,272,112.8067903,62.14818227,43.50891532,35.01309162,Benign
10.0.2.15,41852,119.254.87.201,80,3,222,3,222,0,0,19801.37032,9.107153,195.0115475,0,Malicious
10.0.2.15,52041,119.254.87.201,80,11,1582,6,705,5,877,14398.11172,2.948389,1912.90905,2379.604591,Malicious
172.30.1.136,51766,204.79.197.213,443,42,18655,21,4960,21,13695,2952.576361,70.41974,563.4783656,1555.813753,Benign
192.168.43.233,50699,52.230.84.217,443,27,10564,14,5041,13,5523,1838.337953,1.457499,27669.31573,30314.94361,Benign
172.30.15.2148,51460,104.16.123.127,443,41,11690,21,2825,20,8865,4179.023729,8.695501,2599.045184,8155.941791,Benign
172.30.6.255,57466,103.243.221.17,80,17,5526,9,4245,8,1281,2950.850176,41.180882,824.6545084,248.8533393,Benign
192.168.43.233,51196,157.240.16.20,443,423,314947,191,14001,232,300946,1142.783065,89.272004,1254.682263,26968.90282,Benign
172.30.6.255,58425,172.217.166.206,443,17,1795,10,1166,7,629,5579.414324,63.037438,147.975557,79.82557921,Benign
172.30.6.255,55688,172.217.161.2,80,111,109493,31,2619,80,106874,44.001325,14.576928,1437.339884,58653.78494,Benign
172.30.1.136,50401,157.240.16.39,443,428,209592,187,36990,241,172602,777.691169,122.906734,2407.679306,11234.66514,Benign
10.0.2.15,43194,119.254.87.201,80,11,1569,6,705,5,864,14217.84436,1.122611,5024.002081,6157.074891,Malicious
192.168.43.233,50725,157.240.16.16,443,7,402,4,228,3,174,1846.439813,11.742023,155.3395015,118.548567,Benign
10.0.2.15,49211,219.234.85.243,80,11,1671,6,803,5,868,182.572999,1.038831,6183.873989,6684.436641,Malicious
10.0.2.15,57849,119.254.87.201,80,11,1579,6,705,5,874,10731.57622,1.557396,3621.429617,4489.545369,Malicious
172.30.6.255,58325,35.190.41.40,443,151,34878,68,10475,83,24403,5373.017338,26.026928,3219.742261,7500.846815,Benign
172.30.1.136,50569,157.240.16.16,443,35,6076,17,4306,18,1770,1561.644431,105.102341,327.7567338,134.7258288,Benign
192.168.137.97,56454,52.84.110.226,443,35,9633,18,2333,17,7300,345.7855502,180.3767847,103.4722957,323.7667204,Benign
192.168.43.233,51447,151.101.154.2,80,7,402,4,228,3,174,3803.933126,14.073831,129.6022384,98.90697139,Benign
172.30.6.255,56393,144.76.83.254,80,6,348,4,228,2,120,651.413968,25.637672,71.14530524,37.44489749,Benign
172.30.6.255,57681,157.240.16.39,443,30,5781,15,2415,15,3366,3624.876535,65.233694,296.165966,412.7928123,Benign
172.30.15.465,49739,172.217.166.206,443,34,10237,17,4668,17,5569,1682.660153,2.902618,12865.62682,15348.90227,Benign
192.168.43.233,51144,172.217.24.234,443,24,7640,12,2234,12,5406,475.047685,12.955965,1379.441825,3338.076322,Benign
172.30.6.255,57492,35.190.43.164,80,234,69917,119,51811,115,18106,3057.839497,1227.065607,337.7879696,118.044218,Benign
172.30.15.1601,50910,104.244.43.80,443,18,2507,10,1526,8,981,3573.001142,4.213686,2897.225849,1862.502332,Benign
192.168.137.97,35368,104.17.38.113,443,27,10618,15,1559,12,9059,3514.990606,15.34077614,812.9966752,4724.141681,Benign
192.168.43.224,44736,157.240.16.52,443,18,5156,10,1261,8,3895,366.8635373,23.19761162,434.8723552,1343.241732,Benign
172.30.1.136,50671,151.101.1.181,443,21,9119,10,1186,11,7933,1802.016657,1.759487,5392.480877,36069.60438,Benign
172.30.15.464,49738,162.125.82.2,443,45,18130,26,13530,19,4600,1659.164387,1.437466,75299.17229,25600.60551,Benign
10.0.2.15,37379,119.254.87.201,80,11,1579,6,705,5,874,22922.18845,9.11208,618.9585693,767.3330348,Malicious
172.30.15.816,50113,34.232.42.95,443,6,348,4,228,2,120,3037.855766,9.185406,198.5758713,104.5136165,Benign
10.0.2.15,48876,119.254.87.201,80,11,1513,6,705,5,808,9502.581725,1.504552,3748.624175,4296.295509,Malicious
10.0.2.15,46826,119.254.87.201,80,12,1656,7,779,5,877,7340.304295,8.367362,744.7986594,838.4960517,Malicious
172.30.6.255,57745,103.243.221.46,80,55,36233,33,30202,22,6031,3844.91181,37.155399,6502.850366,1298.546141,Benign
172.30.6.255,58236,173.241.248.220,80,11,2548,7,1354,4,1194,5221.84959,37.7272,287.1138065,253.1860302,Benign
10.0.2.15,59552,119.254.87.201,80,11,1579,6,705,5,874,24639.56902,0.900778,6261.25416,7762.178916,Malicious
10.0.2.15,44372,119.254.87.201,80,11,1513,6,705,5,808,8991.954344,1.816245,3105.307929,3558.991215,Malicious
172.30.6.255,55884,54.149.211.44,80,14,3580,8,2130,6,1450,110.428793,62.706297,271.7430436,184.9893959,Benign
10.0.2.15,36020,119.254.87.201,80,11,1582,6,705,5,877,282.719777,1.579194,3571.442141,4442.772706,Malicious
10.0.2.15,40037,119.254.87.201,80,11,1582,6,705,5,877,26288.98225,2.179706,2587.50492,3218.782717,Malicious
192.168.43.224,44760,172.82.254.215,443,4,268,2,140,2,128,2280.238493,12.12450661,92.37489293,84.45704496,Benign
10.0.2.15,54539,119.254.87.201,80,11,1593,6,705,5,888,3616.270088,1.879727,3000.435702,3779.272203,Malicious
192.168.43.224,46324,52.20.114.147,443,10,700,6,412,4,288,63.60081434,24.15509525,136.4515422,95.38360234,Benign
172.30.1.136,50355,52.84.103.186,443,11,1405,7,958,4,447,640.174202,10.76069,712.2219858,332.3206969,Benign
10.0.2.15,44216,119.254.87.201,80,11,1587,6,705,5,882,21125.58892,1.984965,2841.359923,3554.722627,Malicious
192.168.137.97,40014,172.217.161.14,443,21,5960,11,1352,10,4608,6776.974456,13.96079065,774.7412216,2640.538128,Benign
10.0.2.15,55208,119.254.87.201,80,11,1513,6,705,5,808,15626.55937,1.617917,3485.963742,3995.260573,Malicious
10.0.2.15,39196,119.254.87.201,80,11,1579,6,705,5,874,8146.498899,2.08416,2706.126209,3354.828804,Malicious
192.168.137.97,44262,140.98.193.112,443,49,32036,23,4835,26,27201,78.55412881,18.66555388,2072.266392,11658.26642,Benign
10.0.2.15,34986,119.254.87.201,80,12,1625,7,779,5,846,5508.475877,4.908578,1269.614133,1378.810727,Malicious
172.30.15.318,49583,52.229.175.79,443,28,10083,15,2234,13,7849,767.445428,123.473002,144.7441927,508.5484194,Benign
192.168.137.97,34190,192.229.237.96,443,6,412,4,272,2,140,144.6132348,10.7706289,202.0309139,103.9864998,Benign
192.168.43.233,51478,54.81.94.76,80,11,655,6,349,5,306,3816.616862,75.834473,36.81702911,32.28083355,Benign
172.30.15.1322,50630,52.85.51.33,443,60,35570,30,2667,30,32903,3488.537885,8.602394,2480.239803,30598.92397,Benign
172.30.6.255,58111,103.243.221.87,80,15,5499,9,4317,6,1182,4891.849152,7.247958,4764.928274,1304.643322,Benign
172.30.6.255,58518,157.240.16.17,443,1902,1570997,831,62999,1071,1507998,5761.103304,7.990948,63070.36412,1509706.233,Benign
10.0.2.15,33581,119.254.87.201,80,11,1513,6,705,5,808,18840.23847,1.612812,3496.99779,4007.906687,Malicious
192.168.215.49,56104,104.197.3.80,80,10,911,5,425,5,486,2062.768719,0.785425522,4328.86366,4950.182915,Benign
172.30.15.1153,50461,180.149.59.136,80,150,126209,60,5692,90,120517,3459.394813,7.637382,5962.25251,126239.0699,Benign
172.30.15.2143,51455,52.218.208.184,443,7,409,4,228,3,181,4178.68447,8.999147,202.6858768,160.904139,Benign
192.168.137.97,46616,103.229.206.27,443,12,1513,7,1038,5,475,376.408466,14.54690275,570.8431645,261.2239915,Benign
172.30.6.255,56095,35.186.202.217,443,38,9886,18,2331,20,7555,305.96108,105.691827,176.4374837,571.851218,Benign
192.168.137.97,40236,210.176.156.55,443,6,412,4,272,2,140,375.0108323,15.94449439,136.4734401,70.24368242,Benign
192.168.137.97,59354,157.240.16.20,443,22,5596,12,1381,10,4215,466.7441044,101.5986588,108.741593,331.8941451,Benign
172.30.15.2375,51709,14.139.45.128,80,10,1390,5,660,5,730,5334.549053,0.186403,28325.72437,31329.96787,Benign
192.168.137.97,57066,104.113.214.101,443,22,6611,12,2128,10,4483,24.74184787,17.79747213,956.5403378,2015.117638,Benign
172.30.15.782,50074,52.84.108.93,443,37,24317,17,2930,20,21387,2674.64732,1.667658,14055.63971,102596.5756,Benign
10.0.2.15,45815,119.254.87.201,80,11,1579,6,705,5,874,1960.203541,1.823127,3093.58591,3835.168916,Malicious
192.168.43.224,60964,54.243.243.77,443,10,664,6,404,4,260,14.42099316,15.47670785,208.8299418,134.3955071,Benign
192.168.43.233,51217,172.217.160.238,443,9,511,5,283,4,228,1510.676327,59.149363,38.27598279,30.83718755,Benign
172.30.6.255,55621,157.240.16.17,443,349,329094,100,9295,249,319799,5.265445,53.337801,1394.133215,47965.83196,Benign
172.30.6.255,56679,74.125.24.188,5228,19,2304,10,1337,9,967,1154.11464,88.084998,121.4281687,87.82426265,Benign
10.0.2.15,39040,119.254.87.201,80,10,981,6,725,4,256,2443.184769,180.368156,32.15645227,11.35455418,Malicious
192.168.43.224,39036,144.2.1.1,443,17,5640,9,1245,8,4395,114.726835,25.61499612,388.834726,1372.63343,Benign
192.168.43.224,34396,52.84.108.195,443,28,8728,15,2242,13,6486,1465.151224,169.9945291,105.5092778,305.2333524,Benign
172.30.15.1067,50373,144.217.255.209,80,11,1348,7,929,4,419,3452.69526,6.359097,1168.719395,527.1188661,Benign
10.0.2.15,54572,119.254.87.201,80,12,1653,7,779,5,874,1331.868077,3.90321,1596.634565,1791.346097,Malicious
172.30.15.2150,51462,104.16.120.145,443,65,22279,32,3494,33,18785,4181.846591,5.782063,4834.260713,25990.72338,Benign
172.30.15.1934,51246,34.201.201.2,443,14,4699,8,1087,6,3612,3991.669269,5.529864,1572.552236,5225.444966,Benign
192.168.215.49,49876,35.171.73.174,443,31,6746,16,2122,15,4624,251.9451869,60.88041439,278.8417288,607.6174148,Benign
172.30.15.957,50263,64.124.217.61,443,18,6082,9,1605,9,4477,3442.138191,1.493909,8594.901028,23974.68654,Benign
172.30.1.136,50606,157.240.16.20,443,29,5683,13,3347,16,2336,1613.035406,103.710131,258.1811414,180.1945463,Benign
192.168.43.233,51258,52.84.108.242,443,90,53621,44,5019,46,48602,2300.549897,219.308781,183.0843244,1772.915787,Benign
172.30.15.2448,51782,14.139.45.128,80,11,1438,6,713,5,725,5420.426238,0.514588,11084.59583,11271.15284,Benign
192.168.137.97,37484,172.217.160.227,443,203,112305,99,103769,104,8536,16.25332347,259.1434557,3203.445743,263.5142756,Benign
172.30.15.492,49770,23.9.250.106,443,24,7259,13,2568,11,4691,1841.353901,4.418729,4649.300738,8492.939938,Benign
172.30.15.918,50224,184.29.24.49,443,46,32864,19,2311,27,30553,3440.030584,6.970467,2652.33305,35065.65629,Benign
172.30.15.946,50252,52.0.136.218,80,7,402,4,228,3,174,3441.195014,6.068411,300.5729177,229.3845951,Benign
192.168.43.233,51109,52.84.110.8,443,50,16170,24,2548,26,13622,918.93895,208.660079,97.68998506,522.2656894,Benign
192.168.43.224,42022,23.251.156.28,443,16,1816,9,1178,7,638,1358.660083,20.34482921,463.2135223,250.8745562,Benign
10.0.2.15,39137,119.254.87.201,80,11,1582,6,705,5,877,9590.738901,1.795422,3141.322764,3907.716403,Malicious
10.0.2.15,60346,119.254.87.201,80,11,1582,6,705,5,877,21966.60784,1.024452,5505.38239,6848.539512,Malicious
192.168.215.49,42256,111.119.15.1,443,1147,923168,500,34532,647,888636,509.963103,183.3098581,1507.043881,38781.80951,Benign
192.168.43.224,43088,66.228.33.150,443,19,8414,11,1377,8,7037,2618.811539,20.74371222,531.0524888,2713.882617,Benign
192.168.43.224,33128,54.243.243.77,443,20,2805,11,1858,9,947,730.078622,11.50511109,1291.947543,658.4899477,Benign
10.0.2.15,33644,119.254.87.201,80,11,1582,6,705,5,877,14368.07843,1.410938,3997.340776,4972.578526,Malicious
172.30.6.255,57950,157.240.16.39,443,25,5381,12,3235,13,2146,4571.083538,61.064871,423.8115888,281.1436382,Benign
192.168.137.97,44264,140.98.193.112,443,71,48361,34,5560,37,42801,78.80460244,18.48388138,2406.420983,18524.68066,Benign
10.0.2.15,46976,119.254.87.201,80,11,1513,6,705,5,808,15476.4218,1.091003,5169.554987,5924.823305,Malicious
172.30.15.609,49896,104.31.90.207,80,220,164072,106,21311,114,142761,2388.962568,7.326679,23269.47857,155880.7203,Benign
10.0.2.15,56337,119.254.87.201,80,11,1582,6,705,5,877,25688.18728,1.958745,2879.394714,3581.88534,Malicious
10.0.2.15,55310,119.254.87.201,80,11,1513,6,705,5,808,11455.32811,1.41211,3994.023129,4577.547075,Malicious
10.0.2.15,34002,119.254.87.201,80,12,1667,7,779,5,888,7790.779998,3.82996,1627.171041,1854.849659,Malicious
172.30.6.255,57120,72.247.218.17,443,25,8812,14,1377,11,7435,1856.130741,108.642582,101.3967065,547.4833063,Benign
172.30.6.255,57754,103.229.205.254,80,6,348,4,228,2,120,3855.718296,26.303867,69.34341631,36.4965349,Benign
172.30.15.2099,51411,34.196.221.221,443,18,2503,9,1640,9,863,4146.074291,1.556593,8428.664397,4435.327668,Benign
10.0.2.15,38482,119.254.87.201,80,11,1582,6,705,5,877,9022.015753,2.062574,2734.447346,3401.574925,Malicious
192.168.43.224,42222,18.211.245.141,443,38,8444,19,3115,19,5329,2926.962203,65.51820432,380.3523045,650.6893838,Benign
172.30.6.255,56656,103.243.221.17,80,47,33950,25,13687,22,20263,1090.86953,31.280705,3500.432615,5182.236142,Benign
172.30.15.1600,50909,152.195.61.116,443,37,12205,19,2369,18,9836,3572.960366,4.052525,4676.590521,19417.03012,Benign
10.0.2.15,42166,119.254.87.201,80,12,1656,7,779,5,877,17458.63556,5.161979,1207.28891,1359.168644,Malicious
10.0.2.15,35059,119.254.87.201,80,11,1582,6,705,5,877,15143.88799,2.083354,2707.173145,3367.646593,Malicious
172.30.15.1971,51283,104.113.220.53,443,16,7052,9,1141,7,5911,4076.504465,0.744592,12259.06268,63508.60606,Benign
192.168.43.224,38552,34.236.23.199,443,45,19513,24,10215,21,9298,930.7408479,79.83643878,1023.592751,931.7048849,Benign
172.30.15.2064,51376,54.236.156.42,443,6,348,4,228,2,120,4104.867953,2.670441,683.0332518,359.4911852,Benign
172.30.15.2277,51596,87.250.251.119,443,11,1342,6,904,5,438,4538.026079,9.707764,744.9707265,360.948206,Benign
172.30.6.255,58105,216.58.196.194,80,38,10281,20,5761,18,4520,4890.918208,8.00226,5759.372977,4518.723461,Benign
172.30.15.2394,51728,14.139.45.128,80,11,2707,5,640,6,2067,5340.416678,0.104229,49122.60503,158650.6634,Benign
192.168.215.49,42252,111.119.15.1,443,8,544,4,272,4,272,509.9589189,20.5435623,105.9212598,105.9212598,Benign
172.30.1.136,50124,23.8.187.10,443,34,10479,15,2289,19,8190,102.451696,9.986164,1833.737159,6561.077907,Benign
10.0.2.15,36502,119.254.87.201,80,12,1653,7,779,5,874,10403.61478,4.261371,1462.44014,1640.786498,Malicious
172.30.1.136,50160,180.149.59.201,80,21,18305,6,505,15,17800,149.240718,0.195559,20658.72703,728168.9925,Benign
172.30.6.255,58409,180.149.59.232,80,12,4896,8,3669,4,1227,5551.043345,7.966807,3684.286565,1232.112187,Benign
172.30.1.136,50440,104.113.230.86,443,8,468,4,228,4,240,855.378659,24.607742,74.12301381,78.02422506,Benign
192.168.137.97,46558,151.101.193.170,443,8,552,5,338,3,214,383.0410153,16.80822322,160.873637,101.8549062,Benign
172.30.1.136,50264,172.217.161.5,443,17,1026,9,546,8,480,474.460287,21.750028,200.8273277,176.5514969,Benign
172.30.6.255,56281,157.240.16.20,443,34,9102,18,2090,16,7012,566.962362,65.335097,255.911459,858.5890674,Benign
172.30.15.1466,50774,103.231.98.244,443,8,973,5,799,3,174,3506.142702,0.327926,19492.20251,4244.860121,Benign
172.30.6.255,56558,74.125.68.188,5228,29,2909,15,1612,14,1297,859.299202,292.690791,44.06014947,35.45038081,Benign
192.168.43.233,51232,172.217.160.227,443,277,31392,126,17032,151,14360,1631.690439,329.346224,413.7166,348.8122578,Benign
10.0.2.15,38446,119.254.87.201,80,11,1579,6,705,5,874,20675.1753,1.55123,3635.824475,4507.390909,Malicious
172.30.1.136,50380,157.240.16.20,443,29,7032,10,2179,19,4853,690.1375,100.886333,172.7885183,384.8291324,Benign
192.168.43.233,51167,52.70.107.220,443,9,534,5,294,4,240,1010.231748,27.884617,84.34758132,68.85516842,Benign
172.30.1.136,50441,157.240.16.17,443,24,5758,6,917,18,4841,855.425633,141.544891,51.82808046,273.6093103,Benign
192.168.43.233,51678,54.172.100.225,443,37,12796,17,4054,20,8742,894.609532,9.191855,3528.341124,7608.475112,Benign
172.30.6.255,56999,103.243.221.51,80,24,13944,10,5275,14,8669,1483.851699,14.176709,2976.713425,4891.967522,Benign
10.0.2.15,57857,119.254.87.201,80,11,1582,6,705,5,877,11424.77964,1.54996,3638.803582,4526.568428,Malicious
172.30.15.1227,50535,72.247.228.146,80,8,468,5,282,3,186,3467.538668,9.969349,226.2936126,149.2574891,Benign
10.0.2.15,49267,119.254.87.201,80,11,1579,6,705,5,874,13914.85189,1.640049,3438.921642,4263.287255,Malicious
172.30.1.136,50525,172.217.161.14,443,37,6145,19,3849,18,2296,1039.501856,88.611651,347.4938076,207.2865113,Benign
10.0.2.15,36021,119.254.87.201,80,11,1582,6,705,5,877,1391.896484,0.826132,6826.99617,8492.589562,Malicious
172.30.15.1327,50635,52.84.110.244,443,8,480,5,294,3,186,3488.604764,8.40762,279.7462302,176.9823089,Benign
172.30.15.1114,50422,68.232.44.114,80,6,348,4,228,2,120,3458.273331,8.759409,208.2332267,109.5964351,Benign
192.168.137.97,48498,172.217.161.8,443,93,40272,44,4179,49,36093,120.9850897,247.504854,135.0761388,1166.619545,Benign
10.0.2.15,36702,119.254.87.201,80,12,1653,7,779,5,874,2745.216608,249.696873,24.95826209,28.00195259,Malicious
172.30.15.812,50107,34.200.202.18,443,6,348,4,228,2,120,2856.856454,9.787919,186.3521756,98.08009241,Benign
172.30.1.136,50156,172.217.194.189,443,9,534,5,294,4,240,146.142593,21.297419,110.4359171,90.15176909,Benign
172.30.6.255,56960,54.201.177.109,80,14,3365,8,2195,6,1170,1390.925061,13.741647,1277.867202,681.1410597,Benign
10.0.2.15,42291,119.254.87.201,80,11,1582,6,705,5,877,22116.77922,2.185609,2580.51646,3210.08927,Malicious
192.168.137.97,44838,103.102.166.224,443,18,6033,10,1270,8,4763,19.44543766,11.13336886,912.5719387,3422.50405,Benign
192.168.43.224,32926,172.217.166.195,443,33,6871,17,1752,16,5119,15.18565159,263.2477077,53.24262887,155.5645075,Benign
192.168.43.233,51021,49.44.170.2,443,347,278780,140,18681,207,260099,704.113622,456.784876,327.1737044,4555.299681,Benign
192.168.137.97,39764,192.168.125.6,80,22,5415,12,1408,10,4007,8315.280851,10.4025676,1082.809594,3081.546904,Benign
172.30.6.255,58047,35.190.43.247,443,31,9458,15,2116,16,7342,4818.453962,54.097878,312.9143069,1085.735747,Benign
192.168.43.224,43116,117.18.232.205,443,22,6347,13,2028,9,4319,879.9084007,32.92240833,492.7950543,1049.497949,Benign
192.168.43.233,51484,31.13.79.26,443,13,751,7,403,6,348,3818.410551,72.879832,44.23720406,38.19986852,Benign
172.30.15.442,49716,23.9.250.106,443,366,331547,128,9187,238,322360,1629.656222,0.850864,86378.08157,3030895.654,Benign
10.0.2.15,52290,119.254.87.201,80,11,1582,6,705,5,877,5057.839404,1.48059,3809.292242,4738.651484,Malicious
192.168.43.233,50896,54.239.25.120,443,98,68267,56,60769,42,7498,169.194437,12.723379,38209.34675,4714.470896,Benign
172.30.1.136,50429,172.217.161.3,443,3,198,3,198,0,0,834.994234,9.001321,175.9741709,0,Benign
192.168.137.97,37444,172.217.161.3,443,2,132,1,66,1,66,1.170094021,0.011592372,45547.19258,45547.19258,Benign
10.0.2.15,38991,119.254.87.201,80,11,1582,6,705,5,877,4455.238475,4.847649,1163.450572,1447.299505,Malicious
192.168.215.49,46408,223.31.160.67,443,13,1606,7,1038,6,568,318.8583725,16.1489753,514.2121929,281.3800824,Benign
192.168.137.97,54066,140.98.193.112,443,30,14034,16,4361,14,9673,15.7991463,19.23914698,1813.386011,4022.215749,Benign
10.0.2.15,45079,119.254.87.201,80,11,1513,6,705,5,808,6164.560829,1.68662,3343.966039,3832.517105,Malicious
192.168.43.233,50860,74.125.130.188,443,156,9597,79,4479,77,5118,35.644324,3236.544016,11.07106834,12.65053087,Benign
10.0.2.15,34723,119.254.87.201,80,11,1582,6,705,5,877,1574.088705,1.412081,3994.105154,4968.553504,Malicious
172.30.6.255,55752,13.228.141.18,80,6,348,4,228,2,120,58.378876,0.280149,6510.821027,3426.747909,Benign
192.168.137.97,50636,192.168.121.7,443,30,8892,16,3373,14,5519,2924.027069,18.30961902,1473.760867,2411.410087,Benign
172.30.6.255,55706,173.241.248.220,80,10,2492,6,1342,4,1150,53.40579,5.327749,2015.109946,1726.808076,Benign
192.168.43.224,50900,23.251.156.28,443,6,412,4,272,2,140,2443.389975,24.9513276,87.20978838,44.88739108,Benign
10.0.2.15,42895,119.254.87.201,80,11,1579,6,705,5,874,14693.35505,1.749746,3223.324985,3996.008564,Malicious
192.168.43.224,45470,104.237.191.1,443,12,780,6,380,6,400,110.5533903,14.26739829,213.0731853,224.2875635,Benign
172.30.6.255,55852,52.84.110.71,443,45,14683,23,2540,22,12143,103.532372,180.189705,112.7700387,539.1207006,Benign
192.168.215.49,59228,223.31.160.61,443,20,5224,10,2441,10,2783,478.5930807,30.25227255,645.5052251,735.9447118,Benign
192.168.137.97,47700,13.228.225.25,443,9,598,5,338,4,260,377.1603842,14.04009302,192.5913167,148.1471667,Benign
192.168.43.233,51304,104.244.42.194,443,103,10868,56,5942,47,4926,2532.246089,739.782212,64.25674912,53.26973177,Benign
10.0.2.15,38123,119.254.87.201,80,11,1582,6,705,5,877,100.565166,1.820669,3097.762416,3853.528566,Malicious
172.30.6.255,55789,180.149.59.80,443,82,78774,23,3659,59,75115,79.9748,32.572517,898.6717238,18448.68175,Benign
10.0.2.15,35943,119.254.87.201,80,11,1568,6,705,5,863,16855.73806,1.855613,3039.426863,3720.60338,Malicious
172.30.1.136,50556,184.29.24.13,443,119,62221,55,8117,64,54104,1472.19151,98.950396,656.2480053,4374.232115,Benign
172.30.15.1060,50366,157.240.16.20,443,411,336512,169,10772,242,325740,3449.981348,7.167173,12023.70865,363591.0561,Benign
192.168.43.224,51648,54.197.248.134,443,6,412,4,272,2,140,1274.865645,11.43726844,190.255218,97.92547987,Benign
10.0.2.15,54124,119.254.87.201,80,11,1579,6,705,5,874,6709.644921,1.228118,4592.392588,5693.264002,Malicious
172.30.15.404,49676,162.125.82.3,443,6,348,4,228,2,120,1533.531023,0.244112,7471.980075,3932.621092,Benign
172.30.15.1871,51183,54.201.241.25,443,6,348,4,228,2,120,3951.049166,6.590864,276.7467209,145.6561689,Benign
192.168.43.233,51286,23.9.140.60,80,20,4802,10,3938,10,864,2778.993151,6.459129,4877.437809,1070.113323,Benign
172.30.15.257,49520,172.217.166.197,443,208,148498,70,7097,138,141401,73.719972,5.767565,9844.015629,196132.6834,Benign
192.168.43.224,35066,34.232.42.95,443,17,1874,10,1220,7,654,3042.775237,15.88183821,614.5384349,329.4328987,Benign
172.30.15.1127,50435,54.231.114.138,443,27,7001,14,1459,13,5542,3458.29777,9.381362,1244.169024,4725.96623,Benign
192.168.43.233,51263,52.84.110.78,443,42,11622,19,2687,23,8935,2307.2726,182.252084,117.9465251,392.20402,Benign
10.0.2.15,40138,119.254.87.201,80,11,1579,6,705,5,874,21906.52158,1.44838,3894.005717,4827.462406,Malicious
192.168.43.233,51237,172.217.194.189,443,202,78584,98,9524,104,69060,1632.950144,456.545138,166.8882081,1210.132261,Benign
172.30.6.255,56353,139.162.146.37,80,14,1434,8,857,6,577,607.828387,69.593169,98.51541607,66.32834898,Benign
172.30.1.136,50407,172.217.161.3,443,29,3601,15,2128,14,1473,808.954806,18.533826,918.5367339,635.8104365,Benign
172.30.15.1552,50861,180.179.41.214,443,17,4015,9,2856,8,1159,3551.763864,1.005026,22733.74022,9225.631974,Benign
172.30.6.255,56212,139.99.8.179,80,13,1520,7,763,6,757,469.888248,60.536504,100.831723,100.0388129,Benign
172.30.6.255,55717,151.101.130.49,80,10,1622,5,950,5,672,57.599179,0.552246,13761.98288,9734.792104,Benign
192.168.215.49,50008,172.217.161.14,443,1,66,1,66,0,0,17.80540697,0,0,0,Benign
172.30.6.255,56267,103.243.223.145,443,19,7650,11,1273,8,6377,530.275489,35.897766,283.6945341,1421.146932,Benign
172.30.15.2022,51334,52.218.248.232,443,32,7862,15,2098,17,5764,4090.051845,7.565098,2218.609726,6095.360562,Benign
172.30.6.255,57154,103.243.220.231,80,18,6306,9,4498,9,1808,1921.879975,20.203238,1781.100633,715.9248433,Benign
192.168.42.240,50958,13.35.130.15,443,13,1533,8,1024,5,509,224.216222,47.535297,172.3350966,85.66266032,Benign
192.168.137.97,33334,172.217.194.157,443,11,766,6,412,5,354,39.52987877,18.80286506,175.2924349,150.6153446,Benign
10.0.2.15,37359,119.254.87.201,80,11,1582,6,705,5,877,25508.03851,2.035321,2771.061665,3447.1221,Malicious
10.0.2.15,36924,119.254.87.201,80,11,1513,6,705,5,808,9440.47404,1.087856,5184.509715,5941.962907,Malicious
172.30.6.255,56725,103.243.221.46,80,26,12710,15,10498,11,2212,1195.443934,27.027656,3107.335686,654.736763,Benign
172.30.6.255,56517,23.198.119.247,443,14,3363,8,1243,6,2120,831.967943,41.617122,238.940117,407.5245761,Benign
192.168.43.224,35158,35.171.73.174,443,20,5292,11,1398,9,3894,1252.132294,27.67525623,404.1154997,1125.626435,Benign
172.30.6.255,56583,13.107.136.254,443,35,9418,17,1799,18,7619,897.796922,128.24281,112.2246152,475.2859049,Benign
10.0.2.15,54201,119.254.87.201,80,11,1582,6,705,5,877,1542.081574,2.01449,2799.716057,3482.767351,Malicious
192.168.43.233,51043,104.237.191.1,443,29,4210,14,2099,15,2111,868.182225,92.468058,181.5978443,182.6360407,Benign
172.30.15.1909,51221,34.255.159.221,443,18,5698,9,1507,9,4191,3984.936099,2.443274,4934.362663,13722.57062,Benign
172.30.6.255,57073,35.190.43.164,80,179,51690,90,37760,89,13930,1679.902053,1030.010038,293.2786952,108.1931203,Benign
192.168.43.224,54944,52.84.108.83,443,51,25976,27,3329,24,22647,152.3708585,147.9202601,180.04295,1224.822076,Benign
10.0.2.15,36284,119.254.87.201,80,11,1582,6,705,5,877,11029.37302,1.836591,3070.906914,3820.121083,Malicious
10.0.2.15,42169,119.254.87.201,80,13,1727,8,853,5,874,12263.14213,10.399901,656.1600923,672.3140922,Malicious
172.30.15.962,50268,54.173.180.162,80,11,1566,6,786,5,780,3442.314341,4.949242,1270.497583,1260.799128,Benign
172.30.1.136,50252,172.217.161.14,443,3,198,3,198,0,0,452.167346,9.000747,175.9853932,0,Benign
172.30.6.255,58113,173.241.248.220,80,10,2494,6,1300,4,1194,4891.851802,7.221039,1440.235955,1322.801331,Benign
192.168.43.224,48536,49.44.150.17,443,57,24561,27,5895,30,18666,3250.856955,95.94419312,491.5357404,1556.404772,Benign
172.30.15.1469,50777,184.29.25.122,443,18,5955,10,5008,8,947,3507.183956,9.82202,4078.998007,771.3280975,Benign
172.30.15.263,49526,13.107.4.50,80,1089,1110160,322,18270,767,1091890,93.216564,11.936813,12244.4743,731779.9148,Benign
192.168.43.224,55184,23.66.246.24,443,6,412,4,272,2,140,1904.846395,11.49529707,189.2948035,97.43114886,Benign
10.0.2.15,34805,119.254.87.201,80,11,1559,6,705,5,854,20939.85931,1.416287,3982.243712,4823.881035,Malicious
192.168.43.233,50903,172.217.166.195,443,20,5798,10,1339,10,4459,295.062492,39.936308,268.227098,893.2222778,Benign
192.168.43.233,51198,157.240.16.39,443,131,65483,65,10784,66,54699,1160.906813,109.110038,790.6880208,4010.556756,Benign
10.0.2.15,35427,119.254.87.201,80,11,1579,6,705,5,874,25267.70241,0.97599,5778.747733,7164.007828,Malicious
10.0.2.15,49770,119.254.87.201,80,11,1582,6,705,5,877,4813.346784,0.818592,6889.879207,8570.814276,Malicious
10.0.2.15,41675,119.254.87.201,80,11,1513,6,705,5,808,13434.29616,1.280694,4403.862281,5047.263437,Malicious
172.30.6.255,56802,172.217.166.206,443,18,2279,11,1638,7,641,1265.462078,86.992734,150.6332701,58.94745186,Benign
172.30.6.255,57081,172.217.166.206,443,28,4433,16,3202,12,1231,1684.43931,135.747612,188.7031353,72.54639588,Benign
172.30.6.255,56942,34.233.6.212,80,7,402,4,228,3,174,1387.889158,16.694051,109.2604785,83.38299673,Benign
192.168.43.233,51098,162.247.242.20,443,57,17996,29,12188,28,5808,917.908994,401.050404,243.1215604,115.8557616,Benign
172.30.15.1845,51157,52.6.46.142,443,60,35123,35,32848,25,2275,3872.872192,4.474971,58723.06212,4067.065463,Benign
192.168.137.97,50648,192.168.121.7,443,14,1653,8,1081,6,572,2942.337943,11.26659687,767.5787195,406.1563622,Benign
10.0.2.15,60004,119.254.87.201,80,11,1582,6,705,5,877,3976.584684,1.222333,4614.127247,5739.843398,Malicious
172.30.15.2403,51737,14.139.45.128,80,628,565093,241,14428,387,550665,5343.606958,10.405412,11092.68907,423368.1473,Benign
192.168.137.97,55730,5.101.152.77,80,15,3206,8,994,7,2212,3917.10111,96.28905596,82.58467093,183.7799719,Benign
172.30.15.1275,50583,50.23.131.235,443,11,1405,7,958,4,447,3469.549121,7.401389,1035.481313,483.1525542,Benign
172.30.1.136,50366,52.94.220.16,443,57,22388,28,6343,29,16045,653.370727,174.568245,290.6828788,735.299825,Benign
172.30.6.255,55802,185.84.60.59,443,51,9999,26,3048,25,6951,90.759348,321.045819,75.95177559,173.2089213,Benign
10.0.2.15,40387,119.254.87.201,80,11,1582,6,705,5,877,15116.01295,1.746645,3229.047689,4016.84372,Malicious
172.30.15.2318,51648,52.84.108.208,443,73,52087,32,4819,41,47268,5040.853543,6.830162,5644.375639,55363.84056,Benign
172.30.6.255,55967,159.127.41.108,443,6,344,4,228,2,116,166.09417,10.702899,170.4211167,86.70548045,Benign
192.168.215.49,54290,18.210.21.97,443,42,8742,22,3272,20,5470,639.0586869,123.2558714,212.3712217,355.0337967,Benign
172.30.1.136,50795,74.125.68.188,443,20,1140,12,672,8,468,1931.835722,31.327854,171.604477,119.5102607,Benign
172.30.6.255,58044,143.204.192.51,80,6,348,4,228,2,120,4816.434581,12.029982,151.6211745,79.80061816,Benign
172.30.1.136,50615,52.94.220.15,443,6,384,3,198,3,186,1618.366238,34.602505,45.77703262,43.002667,Benign
10.0.2.15,40841,119.254.87.201,80,11,1582,6,705,5,877,16825.70608,1.95284,2888.101432,3592.716249,Malicious
192.168.137.97,46542,172.217.161.14,443,21,6164,11,1517,10,4647,314.5411955,19.75065778,614.4605479,1882.266425,Benign
10.0.2.15,33466,119.254.87.201,80,11,1579,6,705,5,874,21300.30103,1.05687,5336.512532,6615.761636,Malicious
192.168.43.233,51277,34.225.100.237,443,185,80797,99,64378,86,16419,2001.681405,436.918446,1178.764606,300.6327639,Benign
10.0.2.15,36288,119.254.87.201,80,11,1582,6,705,5,877,3706.34336,1.751466,3220.159569,4005.787152,Malicious
10.0.2.15,48866,119.254.87.201,80,11,1579,6,705,5,874,6344.671675,2.09499,2692.136955,3337.486098,Malicious
192.168.43.224,49070,172.217.166.206,443,17,5877,9,1377,8,4500,33.26416807,10.68671764,1030.812301,3368.667649,Benign
172.30.6.255,58255,172.217.194.189,443,96,14863,49,6042,47,8821,5243.530572,620.694812,77.87401967,113.6919443,Benign
10.0.2.15,51285,119.254.87.201,80,13,1727,8,853,5,874,6737.474871,9.882024,690.5467949,707.5473607,Malicious
192.168.43.224,38162,18.205.91.83,443,6,412,4,272,2,140,42.75394941,12.91266806,168.5166837,86.7365284,Benign
10.0.2.15,59722,119.254.87.201,80,12,1656,7,779,5,877,5388.327177,5.902564,1055.812355,1188.635989,Malicious
172.30.6.255,57641,103.243.221.46,80,36,20690,16,8593,20,12097,3496.853159,20.217319,3400.253021,4786.787012,Benign
10.0.2.15,58768,119.254.87.201,80,11,1582,6,705,5,877,17822.038,1.165857,4837.643039,6017.890702,Malicious
192.168.43.233,50703,125.56.235.100,443,17,6383,8,1318,9,5065,1841.276459,0.702279,15013.97593,57697.86652,Benign
172.30.1.136,50292,119.81.119.12,443,31,3867,16,2481,15,1386,492.254352,138.911602,142.8822338,79.82054659,Benign
172.30.15.1635,50945,184.29.25.7,443,343,310190,127,23078,216,287112,3575.550533,11.948656,15451.44492,192230.4902,Benign
192.168.137.97,45548,192.168.121.7,8080,718,585705,311,37912,407,547793,2901.844922,104.5303184,2901.512255,41924.14282,Benign
192.168.43.224,34378,52.84.110.254,443,14,2256,8,1621,6,635,360.3856499,10.46431499,1239.259331,485.4593926,Benign
192.168.43.224,56748,54.85.133.68,443,132,17799,71,7630,61,10169,378.9096707,612.5578802,99.64772632,132.8070418,Benign
10.0.2.15,57562,119.254.87.201,80,11,1582,6,705,5,877,14845.85267,1.049673,5373.101909,6683.986346,Malicious
172.30.15.1869,51181,184.29.26.80,80,13,2851,8,878,5,1973,3943.048782,60.772861,115.5779057,259.7211936,Benign
192.168.215.49,54070,13.126.254.0,443,32,15289,17,5427,15,9862,281.2423127,1.692821988,25647.11488,46606.19992,Benign
172.30.6.255,55919,52.69.18.116,80,13,1674,7,996,6,678,121.806246,61.180333,130.2379312,88.65594112,Benign
172.30.15.1481,50789,139.59.82.147,443,22,3067,13,1874,9,1193,3520.886852,6.150989,2437.331623,1551.620398,Benign
10.0.2.15,60203,119.254.87.201,80,11,1582,6,705,5,877,17011.02101,1.388195,4062.82979,5054.045001,Malicious
10.0.2.15,44475,119.254.87.201,80,11,1582,6,705,5,877,25930.9691,1.388459,4062.057288,5053.084031,Malicious
172.30.6.255,57273,103.243.220.231,80,32,16578,15,8822,17,7756,2285.862856,13.17799,5355.596718,4708.457056,Benign
172.30.6.255,56555,157.240.16.39,443,19,1933,10,1125,9,808,850.099465,61.061317,147.3928248,105.8608022,Benign
172.30.15.1846,51158,35.161.208.104,443,15,2806,8,1990,7,816,3877.223938,10.227457,1556.594176,638.2818329,Benign
172.30.15.569,49853,52.11.15.218,443,6,348,4,228,2,120,2254.847245,1.484801,1228.447449,646.5512887,Benign
10.0.2.15,55360,119.254.87.201,80,11,1579,6,705,5,874,1119.23582,2.424545,2326.20966,2883.840061,Malicious
172.30.15.2122,51434,54.165.220.76,443,23,8823,11,1249,12,7574,4178.221533,9.131177,1094.272951,6635.727245,Benign
172.30.6.255,56032,172.217.166.206,443,32,5656,18,3623,14,2033,250.409939,116.048254,249.7581739,140.1485972,Benign
192.168.42.240,51015,172.217.166.206,443,34,12488,17,2551,17,9937,417.296678,37.721639,541.0157284,2107.43759,Benign
172.30.6.255,58023,103.243.221.46,80,38,24182,23,20142,15,4040,4763.961046,10.087488,15973.848,3203.969115,Benign
172.30.15.469,49744,172.217.166.197,443,39,11248,19,3928,20,7320,1695.749818,9.915927,3169.043096,5905.650576,Benign
10.0.2.15,40467,119.254.87.201,80,11,1582,6,705,5,877,7545.797699,1.749709,3223.393147,4009.809631,Malicious
172.30.15.549,49833,23.56.26.150,443,24,11012,12,1718,12,9294,2252.609726,3.548447,3873.243704,20953.39172,Benign
192.168.137.97,55732,5.101.152.77,80,6,412,4,272,2,140,3917.24945,17.12397573,127.0732939,65.40537185,Benign
172.30.1.136,51554,52.84.110.227,443,1,66,1,66,0,0,735.983204,0,0,0,Benign
172.30.6.255,58319,52.213.19.114,443,12,1416,6,904,6,512,5354.777033,4.362059,1657.932641,939.0060978,Benign
172.30.1.136,51908,157.240.16.39,443,27,3657,14,2175,13,1482,5587.927966,68.02723,255.7799281,174.283151,Benign
172.30.1.136,50304,54.239.35.198,443,11,641,6,348,5,293,512.682365,18.894651,147.3432878,124.0562739,Benign
172.30.15.903,50209,104.20.15.243,80,19,8567,10,1061,9,7506,3438.568638,8.448555,1004.668846,7107.487612,Benign
172.30.6.255,55921,185.84.60.59,80,6,344,4,228,2,116,121.806034,30.238904,60.31964651,30.68894296,Benign
192.168.43.224,48196,151.101.153.2,443,803,689840,291,22257,512,667583,301.3255892,640.2232412,278.1154893,8341.877733,Benign
172.30.6.255,57616,52.229.172.155,443,32,11643,17,2305,15,9338,3408.581888,104.632791,176.235383,713.9635604,Benign
10.0.2.15,34423,119.254.87.201,80,11,1579,6,705,5,874,12230.59768,0.961463,5866.060368,7272.250726,Malicious
192.168.137.97,40786,103.102.166.224,443,62,25264,29,4014,33,21250,1165.521267,181.4103348,177.0130684,937.1020684,Benign
192.168.137.97,60800,23.57.218.60,443,21,1393,11,702,10,691,42.27208532,361.6994694,15.52670235,15.28340644,Benign
10.0.2.15,49142,219.234.85.216,80,11,1857,6,795,5,1062,36786.26533,1.660762,3829.567391,5115.723987,Malicious
10.0.2.15,39689,119.254.87.201,80,11,1513,6,705,5,808,5478.443743,1.873967,3009.658121,3449.367038,Malicious
192.168.137.97,40072,172.217.161.14,443,24,6141,13,1476,11,4665,7221.262437,132.7861069,88.92496572,281.0534994,Benign
172.30.6.255,56435,103.243.221.75,80,22,13321,10,5137,12,8184,697.838402,11.227644,3660.251429,5831.321335,Benign
192.168.42.240,50937,216.58.221.67,443,41,8282,22,2611,19,5671,160.588372,50.952983,409.946558,890.3894793,Benign
192.168.43.233,51651,35.241.16.233,443,93,35965,42,5382,51,30583,855.881794,285.041399,151.0517425,858.3454925,Benign
192.168.43.233,51000,192.229.237.96,443,8275,6082936,3883,274452,4392,5808484,520.727161,415.939766,5278.687395,111717.7914,Benign
10.0.2.15,46439,119.254.87.201,80,11,1579,6,705,5,874,10974.31944,4.666808,1208.534827,1498.240339,Malicious
192.168.43.224,42726,107.21.25.13,443,18,5191,10,1323,8,3868,57.02027115,13.38827573,790.5424281,2311.275973,Benign
172.30.6.255,56023,34.234.151.4,443,12,1408,6,904,6,504,232.188384,21.450628,337.1463064,187.9665248,Benign
192.168.43.224,46276,52.20.114.147,443,19,5753,11,1926,8,3827,41.1137326,46.32213168,332.6271793,660.936768,Benign
10.0.2.15,56609,119.254.87.201,80,11,1579,6,705,5,874,1179.289349,1.73635,3248.193049,4026.837907,Malicious
172.30.15.2281,51600,146.185.29.13,443,40,18929,20,2344,20,16585,4560.509135,8.590696,2182.82663,15444.6159,Benign
172.30.15.977,50283,77.238.185.37,80,16,5759,9,2274,7,3485,3442.554319,4.686126,3882.097921,5949.477244,Benign
192.168.43.224,48208,104.237.191.1,443,35,8039,18,2548,17,5491,1355.434497,93.91191893,217.0544509,467.7574529,Benign
172.30.15.2292,51619,52.229.175.79,443,31,10258,17,2354,14,7904,4891.598648,115.778697,162.6551385,546.1453759,Benign
192.168.43.233,51151,103.243.221.51,443,20,6572,10,2147,10,4425,926.762976,12.464444,1377.999693,2840.078547,Benign
192.168.43.224,48540,49.44.150.17,443,53,23815,24,5684,29,18131,3250.857013,95.93970266,473.9643624,1511.866266,Benign
172.30.1.136,50563,184.29.24.13,443,3,198,3,198,0,0,1474.495342,9.001164,175.9772403,0,Benign
192.168.43.233,51198,172.217.160.227,443,13,1552,8,1033,5,519,724.356377,77.345095,106.8458187,53.68149073,Benign
192.168.43.224,45818,54.173.101.22,443,6,412,4,272,2,140,705.8097838,21.66264509,100.4494138,51.70190415,Benign
10.0.2.15,56493,119.254.87.201,80,11,1579,6,705,5,874,4482.990044,0.825718,6830.419102,8467.781979,Malicious
172.30.1.136,50308,104.17.162.9,443,9,522,5,282,4,240,552.514731,16.363456,137.8681863,117.3346266,Benign
192.168.137.97,36488,52.84.110.135,443,5697,4959066,2325,166061,3372,4793005,1754.519707,249.7290915,5319.716627,153542.544,Benign
10.0.2.15,58495,119.254.87.201,80,11,1593,6,705,5,888,26346.09268,3.610679,1562.033069,1967.496972,Malicious
10.0.2.15,47942,119.254.87.201,80,11,1582,6,705,5,877,23645.82337,2.282572,2470.896865,3073.725604,Malicious
172.30.15.1384,50692,184.29.24.49,443,103,78052,45,3852,58,74200,3495.661491,1.356864,22711.19287,437479.3642,Benign
172.30.1.136,51920,52.84.110.171,443,44,8425,22,6129,22,2296,5965.34003,191.20754,256.4334022,96.06315734,Benign
172.30.1.136,50282,52.84.103.186,443,33,9939,17,2288,16,7651,484.003102,23.375075,783.056311,2618.515663,Benign
192.168.43.224,41864,23.251.156.28,443,1391,1114414,592,60005,799,1054409,478.2212777,409.6705905,1171.770713,20590.37723,Benign
172.30.6.255,58433,157.240.16.39,443,29,5493,16,3341,13,2152,5608.085966,61.055675,437.7643847,281.9721508,Benign
192.168.43.233,51006,104.244.42.2,443,182,49755,89,10191,93,39564,533.370324,1124.206761,72.52046761,281.542516,Benign
192.168.43.224,32806,54.243.243.77,443,19,1978,11,1254,8,724,31.25553118,15.5293231,646.0036882,372.9718264,Benign
172.30.15.2309,51638,87.250.251.119,443,43,25228,27,21156,16,4072,5008.00076,9.866912,17153.087,3301.539529,Benign
172.30.1.136,50768,74.125.68.188,443,20,2450,11,1510,9,940,1917.589923,42.518697,284.1103056,176.8633691,Benign
10.0.2.15,59993,119.254.87.201,80,11,1582,6,705,5,877,7157.971672,1.821626,3096.134991,3851.504096,Malicious
172.30.15.1251,50559,68.232.44.114,80,9,522,5,282,4,240,3469.52124,7.986766,282.4672715,240.3976779,Benign
172.30.6.255,55955,103.243.221.75,80,35,20933,16,7582,19,13351,162.849098,20.198362,3003.015789,5287.953548,Benign
192.168.43.233,51035,13.228.138.206,443,7,395,4,229,3,166,819.958313,48.37556,37.87036264,27.45187859,Benign
10.0.2.15,44847,119.254.87.201,80,12,1653,7,779,5,874,12385.6157,4.713033,1322.290763,1483.545734,Malicious
192.168.137.97,35424,172.217.161.10,443,44,15059,22,4142,22,10917,148.9907226,232.135648,142.7441252,376.2282991,Benign
172.30.6.255,56104,103.243.221.87,443,22,8887,11,3303,11,5584,306.239935,18.575521,1422.517301,2404.88544,Benign
10.0.2.15,44498,119.254.87.201,80,11,1582,6,705,5,877,8691.695288,2.026396,2783.266449,3462.304505,Malicious
192.168.137.97,54592,52.91.99.99,443,25,5867,13,1521,12,4346,349.4661837,13.7073141,887.7012604,2536.456067,Benign
192.168.43.224,55818,172.217.167.10,443,17,5041,9,1389,8,3652,88.06823973,22.60171509,491.6441056,1292.645266,Benign
172.30.6.255,58548,103.243.221.46,80,16,6556,9,5356,7,1200,5813.917057,5.312028,8066.222543,1807.21939,Benign
172.30.6.255,57555,157.240.16.39,443,21,2091,11,1191,10,900,3229.098277,61.031429,156.1162856,117.9720042,Benign
172.30.6.255,58562,157.240.16.39,443,23,5213,13,3303,10,1910,5852.087534,0.316044,83608.61146,48347.69842,Benign
172.30.6.255,56165,103.243.221.17,80,14,4124,8,2950,6,1174,434.85981,30.169813,782.2388558,311.304548,Benign
172.30.1.136,50464,52.94.220.15,443,14,832,2,120,12,712,877.266049,116.559481,8.236138251,48.86775362,Benign
172.30.6.255,57275,103.243.220.231,80,16,5481,9,4245,7,1236,2286.113087,12.928366,2626.78207,764.8298323,Benign
172.30.6.255,57312,104.36.113.23,443,39,13092,19,6009,20,7083,2453.682596,317.285841,151.5100701,178.5897531,Benign
172.30.6.255,58373,35.190.43.164,80,6,348,4,228,2,120,5484.915589,4.148003,439.7296723,231.4366696,Benign
172.30.6.255,57353,103.243.221.51,80,16,5441,9,4215,7,1226,2510.849246,17.181917,1962.528395,570.8326958,Benign
10.0.2.15,55024,119.254.87.201,80,11,1582,6,705,5,877,24273.65597,0.909484,6201.31855,7714.264352,Malicious
172.30.15.616,49903,198.58.102.214,80,33,18484,18,1910,15,16574,2391.20175,5.184971,2946.978874,25572.37061,Benign
172.30.6.255,55819,103.229.206.27,80,6,348,4,228,2,120,90.877971,11.12733,163.9207249,86.27406575,Benign
172.30.15.915,50221,184.29.26.86,443,24,8947,13,2170,11,6777,3439.973033,7.017679,2473.752362,7725.631224,Benign
172.30.1.136,51780,172.217.160.243,443,44,7817,19,2483,25,5334,2974.295425,37.668703,527.3343231,1132.823713,Benign
192.168.137.97,58596,223.165.30.126,443,14,1552,8,1044,6,508,4.188954618,10.58222137,789.2482787,384.0403502,Benign
192.168.43.233,51288,23.9.140.60,80,29,13284,16,12270,13,1014,2784.753195,152.896274,642.0038725,53.05557675,Benign
10.0.2.15,36802,119.254.87.201,80,12,1656,7,779,5,877,21095.55113,3.985112,1563.82054,1760.552777,Malicious
10.0.2.15,36758,119.254.87.201,80,11,1579,6,705,5,874,9167.448843,0.959857,5875.875261,7284.418408,Malicious
172.30.15.2253,51570,52.220.171.90,443,37,16045,21,11278,16,4767,4478.975529,8.657898,10421.00519,4404.764297,Benign
192.168.215.49,57006,108.179.217.142,443,82,64804,37,4142,45,60662,1292.881235,1.467068626,22586.53713,330792.9782,Benign
192.168.43.233,51704,204.79.197.200,443,35,11774,19,3602,16,8172,2027.864793,60.607538,475.4524099,1078.677705,Benign
192.168.137.97,41158,104.244.42.193,443,365,204452,195,50702,170,153750,22.09458065,272.9839679,1485.860152,4505.759109,Benign
10.0.2.15,58234,119.254.87.201,80,11,1582,6,705,5,877,26018.65944,1.347094,4186.790231,5208.248274,Malicious
192.168.43.233,51179,151.101.153.170,443,24,8796,12,1892,12,6904,1050.643432,24.938287,606.9382392,2214.747148,Benign
10.0.2.15,38951,119.254.87.201,80,11,1582,6,705,5,877,6467.18617,0.965266,5842.94899,7268.462786,Malicious
172.30.15.305,49568,131.247.120.10,443,8,456,4,228,4,228,670.508527,4.64142,392.9831819,392.9831819,Benign
192.168.215.249,47812,74.125.68.188,5228,11,3157,0,0,11,3157,688.6800945,482.3061367,0,52.36508118,Benign
192.168.43.224,57280,139.59.82.147,443,22,7375,12,1418,10,5957,2583.732904,19.01304101,596.6431144,2506.49015,Benign
172.30.6.255,56674,173.241.248.220,80,6,535,4,228,2,307,1134.901875,15.352025,118.8116877,159.9788953,Benign
172.30.6.255,58267,103.243.221.75,80,40,24330,23,20183,17,4147,5287.835809,28.041203,5758.098181,1183.116145,Benign
192.168.43.233,51411,23.100.69.251,443,24,9443,11,2072,13,7371,3647.787267,127.122708,130.393698,463.8667704,Benign
172.30.6.255,57460,157.240.16.39,443,19,1933,10,1125,9,808,2924.091806,61.024753,147.4811377,105.9242305,Benign
172.30.6.255,57292,103.243.220.231,80,27,17013,11,4324,16,12689,2369.836036,33.225516,1041.127548,3055.242242,Benign
192.168.137.97,35828,103.102.166.240,443,76,21572,40,4552,36,17020,5424.445742,223.3744607,163.0266947,609.55939,Benign
172.30.1.136,50776,34.225.100.237,443,5,330,1,66,4,264,1921.366819,15.334162,34.43292173,137.7316869,Benign
192.168.215.49,34168,52.84.110.12,443,66,15122,34,4342,32,10780,476.9283353,308.9853732,112.419561,279.1070629,Benign
172.30.1.136,50202,52.95.120.67,80,18,3670,10,2282,8,1388,358.142245,25.141748,726.122941,441.6558467,Benign
192.168.137.97,48468,172.217.194.189,443,24,3294,18,2649,6,645,3758.015369,89.79777803,235.9969307,57.46244633,Benign
172.30.1.136,51515,52.84.110.12,443,36,9075,18,2133,18,6942,8.949177,180.186232,94.70201919,308.2144478,Benign
172.30.15.2471,51805,14.139.45.128,80,10,1821,5,684,5,1137,5423.706444,0.502118,10897.83676,18115.26374,Benign
192.168.43.224,60174,151.101.153.2,443,19,5827,11,1352,8,4475,912.8381247,13.49649301,801.3933685,2652.54092,Benign
172.30.6.255,57839,103.243.221.109,80,35,22334,15,8601,20,13733,4162.896427,43.143847,1594.850825,2546.458131,Benign
10.0.2.15,51261,119.254.87.201,80,11,1582,6,705,5,877,25720.64755,1.949147,2893.573445,3599.523279,Malicious
172.30.15.1939,51251,52.6.46.142,443,22,4314,12,2849,10,1465,4026.5918,10.87558,2095.704321,1077.643675,Benign
172.30.6.255,56709,172.217.166.210,443,38,7814,18,2637,20,5177,1170.044012,71.445267,295.274983,579.6885048,Benign
172.30.15.1990,51302,52.218.248.232,443,7,409,4,228,3,181,4077.453902,5.189998,351.4452221,278.9981807,Benign
172.30.1.136,51837,74.125.24.188,5228,10,589,5,295,5,294,3320.787,63.103471,37.39889364,37.27211773,Benign
172.30.15.974,50280,54.173.180.162,80,6,348,4,228,2,120,3442.51235,4.749838,384.0130969,202.1121562,Benign
172.30.15.1426,50734,52.45.111.226,443,7,402,4,228,3,174,3500.409581,6.001015,303.948582,231.96076,Benign
172.30.15.309,49572,52.44.218.214,443,25,7578,13,2370,12,5208,712.396728,2.792692,6789.148248,14918.93843,Benign
192.168.43.233,51295,23.9.140.60,80,25,10728,14,9822,11,906,2815.861244,142.004871,553.3331318,51.04050269,Benign
192.168.215.28,62293,157.240.16.53,443,1,102,0,0,1,102,282.5722767,0,0,0,Benign
192.168.43.233,51333,172.217.160.238,443,23,6518,11,1922,12,4596,3370.752203,13.109679,1172.873874,2804.645331,Benign
172.30.15.1272,50580,104.16.87.26,80,9,522,5,282,4,240,3469.545776,7.96224,283.3373523,241.1381722,Benign
192.168.137.97,60742,23.57.218.60,443,31,2899,15,1080,16,1819,0.800062382,403.1716786,21.43007671,36.09380513,Benign
172.30.1.136,50779,157.240.16.16,443,46,9870,24,4543,22,5327,1925.107504,67.096055,541.6711907,635.1491157,Benign
10.0.2.15,37588,119.254.87.201,80,11,1513,6,705,5,808,4933.460948,1.832111,3078.4161,3528.170509,Malicious
192.168.137.97,38052,172.217.161.2,443,20,5359,10,1455,10,3904,147.7016,59.1043334,196.9398744,528.4214913,Benign
192.168.43.233,51636,172.217.163.68,443,28,4089,13,2433,15,1656,835.731392,1.114868,17458.56909,11883.02113,Benign
192.168.43.224,35052,34.232.42.95,443,44,27749,23,5529,21,22220,3040.47241,3.721239721,11886.36135,47769.02681,Benign
172.30.6.255,55724,151.101.130.49,80,10,1825,5,1069,5,756,57.750491,0.599274,14270.60076,10092.21158,Benign
192.168.43.224,43188,185.199.109.153,80,90,49658,46,3967,44,45691,2601.75634,319.6745592,99.27596392,1143.437879,Benign
192.168.137.97,47196,157.240.16.20,443,19,5323,11,1279,8,4044,225.2773916,1.150117559,8896.48186,28129.29839,Benign
172.30.6.255,58161,176.34.147.227,443,7,402,5,282,2,120,4958.863053,13.57316,166.210374,70.72781872,Benign
10.0.2.15,46608,119.254.87.201,80,11,1579,6,705,5,874,8239.279105,2.191079,2574.074235,3191.121817,Malicious
172.30.6.255,57679,103.243.220.231,80,14,6072,9,4498,5,1574,3617.866299,3.556403,10118.08842,3540.656107,Benign
172.30.1.136,51921,52.84.110.171,443,16,950,9,536,7,414,5965.383925,127.23981,33.70014463,26.02958932,Benign
10.0.2.15,57543,119.254.87.201,80,11,1579,6,705,5,874,4995.79038,1.446145,3900.023857,4834.923192,Malicious
192.168.43.233,51437,104.16.3.35,443,9,534,5,294,4,240,3800.073319,13.753696,171.0085783,139.5988395,Benign
10.0.2.15,40102,119.254.87.201,80,11,1579,6,705,5,874,21786.46636,1.500875,3757.807945,4658.615807,Malicious
10.0.2.15,35861,119.254.87.201,80,11,1579,6,705,5,874,7067.826399,1.476893,3818.827769,4734.263078,Malicious
192.168.43.233,51377,52.216.18.144,443,39,11609,18,2136,21,9473,3477.148313,100.888095,169.3757821,751.1689065,Benign
172.30.6.255,56460,157.240.16.39,443,19,1933,10,1125,9,808,728.102235,61.054594,147.4090549,105.872459,Benign
172.30.15.1941,51253,52.204.146.6,443,29,7115,16,5768,13,1347,4027.128685,10.332365,4465.966891,1042.936443,Benign
192.168.43.233,51374,52.212.88.15,443,31,6861,17,3793,14,3068,3473.719214,151.718773,200.0016175,161.772993,Benign
172.30.15.1631,50941,202.79.210.118,443,20,8331,10,1920,10,6411,3574.760435,2.409693,6374.255974,21284.03909,Benign
10.0.2.15,51060,119.254.87.201,80,11,1513,6,705,5,808,12650.96105,1.822722,3094.27329,3546.344423,Malicious
10.0.2.15,51174,119.254.87.201,80,11,1579,6,705,5,874,12951.28037,6.758592,834.4933383,1034.535004,Malicious
172.30.15.2497,51831,14.139.45.128,80,10,1412,5,678,5,734,5475.718447,0.181214,29931.46225,32403.67742,Benign
192.168.137.97,36318,52.84.103.186,443,17,1715,11,1291,6,424,3743.793626,173.1333388,59.6534444,19.59183611,Benign
192.168.43.224,37958,103.37.200.180,80,240,182225,114,9060,126,173165,2578.616687,17.56805898,4125.669209,78854.47114,Benign
192.168.43.233,51161,172.217.160.238,443,9,534,5,294,4,240,480.711627,20.779376,113.1891545,92.39930978,Benign
10.0.2.15,34659,119.254.87.201,80,11,1582,6,705,5,877,7518.372069,2.197592,2566.445455,3192.585339,Malicious
172.30.6.255,57399,103.243.221.75,80,15,7864,10,6771,5,1093,2709.839654,12.194105,4442.146431,717.0677963,Benign
172.30.15.1479,50787,23.8.189.227,443,286,205542,119,11133,167,194409,3520.884419,6.153382,14473.9917,252750.7637,Benign
172.30.6.255,56907,54.169.115.222,443,6,348,4,228,2,120,1385.544915,18.893043,96.5434737,50.81235458,Benign
172.30.6.255,57397,103.243.221.17,80,27,17347,11,4606,16,12741,2709.837429,12.196479,3021.199807,8357.166031,Benign
172.30.6.255,58071,210.176.156.41,80,9,520,7,392,2,128,4827.109336,133.244613,23.53566069,7.685113694,Benign
172.30.15.2070,51382,54.236.156.42,443,28,6231,15,3241,13,2990,4121.368247,6.211472,4174.211845,3850.939037,Benign
192.168.137.97,53864,74.125.68.188,443,7,466,4,272,3,194,342.6714714,56.02308618,38.84113048,27.70286512,Benign
172.30.6.255,55637,35.186.249.84,80,6,348,4,228,2,120,36.44837,14.914893,122.293871,64.36519524,Benign
172.30.15.2069,51381,52.207.90.113,443,6,348,4,228,2,120,4120.785428,6.79541,268.4164752,141.2718291,Benign
192.168.43.224,45702,209.197.3.15,80,10,604,6,364,4,240,807.3236989,27.06337806,107.5992802,70.94458036,Benign
172.30.6.255,57783,103.243.221.51,80,27,16843,12,4367,15,12476,3994.837574,47.221978,739.8250027,2113.592107,Benign
10.0.2.15,53336,119.254.87.201,80,11,1582,6,705,5,877,5085.878883,1.477691,3816.765481,4747.947981,Malicious
172.30.6.255,58401,103.231.98.53,80,16,7695,11,7177,5,518,5550.843829,8.253072,6956.924646,502.1160605,Benign
10.0.2.15,53763,216.52.203.13,80,11,1130,6,697,5,433,21.282948,3.482192,1601.290222,994.7757045,Malicious
172.30.6.255,56334,13.107.3.128,443,34,21698,12,1583,22,20115,600.856182,66.540974,190.3188252,2418.359551,Benign
192.168.43.224,35386,54.152.213.221,443,30,5711,17,2508,13,3203,3268.375848,102.7294648,195.3091067,249.4318456,Benign
172.30.15.830,50130,52.229.170.171,443,31,10730,19,2447,12,8283,3161.135299,110.641061,176.9325043,598.909658,Benign
172.30.15.472,49747,172.217.194.188,5228,76,9403,40,3028,36,6375,1725.24431,1371.438252,17.66320865,37.1872375,Benign
10.0.2.15,52410,119.254.87.201,80,11,1513,6,705,5,808,5806.573235,1.750976,3221.060711,3691.655397,Malicious
192.168.43.224,47350,54.236.156.42,443,11,742,6,404,5,338,33.79418474,13.7839069,234.476337,196.1707968,Benign
10.0.2.15,43511,119.254.87.201,80,12,1656,7,779,5,877,14843.5003,12.941185,481.563319,542.1450972,Malicious
192.168.43.224,36318,52.20.136.189,443,112,67869,58,18062,54,49807,2844.567575,143.9084453,1004.082837,2768.815959,Benign
192.168.215.49,52658,104.198.143.177,80,10,911,5,425,5,486,658.7172863,0.793166524,4286.615606,4901.871022,Benign
10.0.2.15,56776,119.254.87.201,80,11,1513,6,705,5,808,18149.44525,2.21213,2549.578913,2922.070584,Malicious
172.30.15.996,50302,8.41.222.241,443,30,12910,14,2304,16,10606,3443.089194,4.172855,4417.119694,20333.32095,Benign
172.30.6.255,56811,172.30.20.1,445,6,360,3,198,3,162,1274.649974,1.113291,1422.808592,1164.116121,Benign
172.30.15.2361,51695,14.139.45.128,80,16,7920,7,759,9,7161,5332.710812,0.261125,23253.23121,219389.1814,Benign
192.168.137.97,47202,157.240.16.20,443,15,4857,9,1183,6,3674,225.2781244,1.149700484,8231.709155,25564.91922,Benign
10.0.2.15,51488,119.254.87.201,80,11,1579,6,705,5,874,879.011052,1.835678,3072.434272,3808.946885,Malicious
10.0.2.15,40811,119.254.87.201,80,11,1513,6,705,5,808,2504.954127,0.971222,5807.117219,6655.532927,Malicious
10.0.2.15,33517,119.254.87.201,80,11,1513,6,705,5,808,10794.14192,0.964147,5849.730383,6704.371844,Malicious
10.0.2.15,50967,119.254.87.201,80,11,1534,6,705,5,829,19621.15802,3.125276,1804.640614,2122.05258,Malicious
192.168.43.233,50907,128.135.53.136,80,11,690,6,372,5,318,335.115155,36.936117,80.57154465,68.87567526,Benign
172.30.6.255,57318,103.243.221.17,80,22,12174,13,10071,9,2103,2467.873074,1.231822,65405.55372,13657.81744,Benign
172.30.6.255,58051,35.190.41.40,443,7,402,4,228,3,174,4819.982689,19.090007,95.54737198,72.91773125,Benign
192.168.43.224,48480,35.171.73.174,443,8,556,5,338,3,218,30.1520229,14.87714698,181.755279,117.2267776,Benign
192.168.43.224,58386,172.217.166.206,443,9,606,5,338,4,268,857.1722821,35.81845896,75.49180168,59.85740488,Benign
10.0.2.15,36348,119.254.87.201,80,11,1582,6,705,5,877,14668.43262,1.557678,3620.773998,4504.140137,Malicious
172.30.6.255,57482,172.217.166.206,443,30,4596,17,3265,13,1331,3013.409602,62.049915,420.9514227,171.6037806,Benign
192.168.43.224,55346,52.84.110.71,443,130,45126,67,17657,63,27469,0.526872693,195.573922,722.2639837,1123.626288,Benign
172.30.6.255,57217,157.240.16.39,443,26,5399,14,3344,12,2055,2131.088548,61.073758,438.0277369,269.1827151,Benign
192.168.137.97,38618,157.240.16.16,443,9,626,6,412,3,214,53.30145636,14.64793868,225.0145958,116.8765133,Benign
192.168.43.233,51495,35.177.33.121,443,37,10312,19,3072,18,7240,3828.395701,174.636893,140.7262783,331.6595881,Benign
192.168.43.224,51528,23.213.88.167,443,41,10295,22,3547,19,6748,1635.255965,75.11162391,377.7844031,718.7169867,Benign
192.168.215.49,39154,107.22.42.44,443,18,6389,11,2053,7,4336,479.7919341,29.02319327,565.8922452,1195.182063,Benign
172.30.15.1068,50374,23.237.44.42,80,9,1871,5,1269,4,602,3452.706072,0.954451,10636.48108,5045.83263,Benign
192.168.43.233,51093,172.217.160.229,443,583,306955,284,91574,299,215381,16.0079,829.962319,882.6810365,2076.055696,Benign
172.30.15.2168,51480,31.24.224.56,443,22,8235,11,1252,11,6983,4244.216545,0.958495,10449.71544,58283.03747,Benign
172.30.1.136,50403,157.240.16.16,443,40,8669,19,2792,21,5877,783.495566,68.051069,328.2240871,690.892894,Benign
192.168.43.233,51669,49.44.149.244,443,11,666,6,360,5,306,870.357093,26.02285,110.6719671,94.07117207,Benign
172.30.15.1912,51224,52.86.72.168,443,6,340,4,228,2,112,3985.119959,2.348676,776.6077569,381.4915297,Benign
172.30.15.319,49584,172.25.10.63,7680,3,198,3,198,0,0,792.775957,9.012292,175.759951,0,Benign
10.0.2.15,34322,119.254.87.201,80,11,1582,6,705,5,877,20762.20848,2.195055,2569.4117,3196.275264,Malicious
172.30.15.1181,50489,52.86.241.228,80,12,2082,7,1459,5,623,3464.492442,3.554014,3284.173895,1402.35801,Benign
10.0.2.15,48071,119.254.87.201,80,11,1579,6,705,5,874,24909.83566,2.195459,2568.938887,3184.755443,Malicious
172.30.15.2116,51428,52.7.89.176,443,6,348,4,228,2,120,4178.063324,9.566798,190.6594035,100.3470545,Benign
172.30.6.255,56089,72.247.228.146,80,19,3776,10,1981,9,1795,305.824855,105.821306,149.7619014,135.7004609,Benign
192.168.137.97,49524,217.12.15.54,443,15,5889,9,1245,6,4644,375.5630895,14.52076615,685.9142207,2558.542684,Benign
172.30.6.255,57219,103.243.220.231,80,30,22391,11,5327,19,17064,2138.89324,19.172101,2222.813243,7120.346382,Benign
192.168.137.97,34592,172.217.161.3,443,247,28763,123,11989,124,16774,363.1745281,865.6252303,110.8008369,155.0232079,Benign
10.0.2.15,55109,119.254.87.201,80,11,1582,6,705,5,877,21185.64021,1.510151,3734.725865,4645.893027,Malicious
172.30.15.2056,51368,52.69.95.24,443,6,340,4,228,2,112,4094.564199,3.028704,602.2377888,295.8361068,Benign
172.30.1.136,50269,52.94.220.15,443,31,7838,14,1447,17,6391,481.779512,28.447551,406.9243078,1797.272461,Benign
172.30.6.255,57337,172.217.166.206,443,40,6418,21,3848,19,2570,2473.414317,63.034612,488.3666136,326.1700096,Benign
10.0.2.15,58530,119.254.87.201,80,11,1582,6,705,5,877,25144.58797,4.4826,1258.198367,1565.163075,Malicious
10.0.2.15,52482,119.254.87.201,80,11,1593,6,705,5,888,9170.179066,1.667567,3382.17295,4260.098695,Malicious
10.0.2.15,59160,119.254.87.201,80,11,1579,6,705,5,874,8481.495561,1.822234,3095.101946,3837.04837,Malicious
192.168.215.49,48674,169.44.82.118,443,9,604,5,338,4,266,338.0726486,121.429745,22.26802008,17.52453651,Benign
172.30.15.676,49963,104.31.90.207,80,162,121447,79,11438,83,110009,2397.787244,8.486636,10782.12851,103700.9246,Benign
10.0.2.15,53528,119.254.87.201,80,11,1582,6,705,5,877,11780.18138,1.428407,3948.454467,4911.765344,Malicious
10.0.2.15,59426,119.254.87.201,80,11,1513,6,705,5,808,22687.55234,1.447522,3896.313838,4465.562527,Malicious
172.30.1.136,51858,52.84.110.227,443,212,64104,102,43291,110,20813,3983.042861,191.455779,1808.919019,869.673409,Benign
10.0.2.15,51624,119.254.87.201,80,12,1653,7,779,5,874,6106.81659,3.91081,1593.531775,1787.864918,Malicious
192.168.137.97,33410,172.217.161.5,443,49,8706,26,4704,23,4002,4160.031869,241.3928757,155.8952388,132.6302606,Benign
192.168.42.240,50540,52.230.84.217,443,12,1064,9,642,3,422,124.403928,486.36246,10.56002554,6.9413252,Benign
172.30.1.136,50243,172.217.161.3,443,25,1446,14,804,11,642,437.228338,44.598411,144.2203849,115.1610536,Benign
192.168.43.233,51227,49.44.168.241,443,42,7310,21,1788,21,5522,1304.717976,500.664827,28.57001177,88.23467841,Benign
172.30.15.1914,51226,64.74.232.52,443,19,6870,11,2082,8,4788,3985.151948,2.35412,7075.255297,16271.0482,Benign
192.168.43.224,43996,205.185.208.52,80,7,410,4,236,3,174,804.4753987,29.88030591,63.18543076,46.58586844,Benign
10.0.2.15,50648,119.254.87.201,80,11,1582,6,705,5,877,26466.18356,1.292352,4364.136087,5428.861487,Malicious
192.168.43.224,57224,139.59.82.147,443,21,7301,12,1418,9,5883,2493.238255,20.75342315,546.6086207,2267.770462,Benign
172.30.6.255,57220,103.243.220.231,80,16,5527,9,4299,7,1228,2138.893559,19.172062,1793.860254,512.4122799,Benign
10.0.2.15,49387,119.254.87.201,80,11,1513,6,705,5,808,11209.5726,2.487097,2267.704074,2599.014031,Malicious
192.168.43.224,33364,174.129.238.218,443,472,355700,228,93266,244,262434,473.1079581,205.7585801,3626.230312,10203.56964,Benign
172.30.15.955,50261,54.169.236.196,80,15,3090,10,2178,5,912,3442.050456,5.011022,3477.135004,1455.990415,Benign
172.30.6.255,56879,103.231.98.53,80,9,522,6,348,3,174,1383.111331,21.904545,127.0969107,63.54845535,Benign
10.0.2.15,39437,119.254.87.201,80,11,1582,6,705,5,877,10040.98825,1.621507,3478.245854,4326.839169,Malicious
192.168.215.49,35260,205.185.208.52,443,13,1625,7,1038,6,587,1292.777277,12.89262852,644.0889837,364.2391459,Benign
10.0.2.15,38297,119.254.87.201,80,11,1582,6,705,5,877,17909.13027,1.192521,4729.476462,5883.334549,Malicious
192.168.42.240,51038,172.217.161.5,443,2,132,2,132,0,0,613.865835,3.000029,351.9965974,0,Benign
172.30.15.323,49589,184.85.113.82,443,22,9010,11,1074,11,7936,813.762971,61.686556,139.2848062,1029.203187,Benign
192.168.43.233,51499,198.252.206.25,443,38,6009,22,4397,16,1612,3836.416664,239.580858,146.8230822,53.82733874,Benign
172.30.15.1203,50511,72.247.228.146,80,6,348,4,228,2,120,3465.630367,1.570521,1161.398033,611.2621226,Benign
192.168.42.240,51026,54.239.25.128,443,174,92496,87,77408,87,15088,495.707575,20.521358,30176.56044,5881.87195,Benign
172.30.15.222,49401,52.230.84.0,443,72,8545,47,4298,25,4247,25.093544,5070.199171,6.781587634,6.701117422,Benign
172.30.15.613,49900,151.139.104.40,80,61,50607,23,1593,38,49014,2389.51379,4.589701,2776.651464,85433.01622,Benign
192.168.43.224,32924,172.217.166.195,443,201,161197,76,6145,125,155052,15.18561371,240.6960889,204.2409589,5153.453078,Benign
10.0.2.15,55214,119.254.87.201,80,11,1559,6,705,5,854,10638.99371,2.655813,2123.643494,2572.470276,Malicious
10.0.2.15,41445,119.254.87.201,80,11,1582,6,705,5,877,9017.242856,2.092427,2695.434536,3353.044097,Malicious
10.0.2.15,49018,119.254.87.201,80,11,1582,6,705,5,877,20789.69716,2.024995,2785.192062,3464.699913,Malicious
172.30.15.532,49816,172.217.166.198,443,29,7451,14,2371,15,5080,2247.611121,8.435302,2248.64504,4817.84766,Benign
172.30.15.2419,51753,14.139.45.128,80,638,597831,227,13375,411,584456,5351.628968,3.820352,28007.89037,1223878.847,Benign
172.30.6.255,57352,103.243.221.51,80,26,16743,10,4270,16,12473,2510.846306,17.184856,1987.796697,5806.507776,Benign
10.0.2.15,33293,119.254.87.201,80,11,1582,6,705,5,877,23042.27965,0.84843,6647.572575,8269.3917,Malicious
192.168.137.97,52828,184.29.25.201,443,7,478,4,272,3,206,376.2317544,14.5895448,149.1479021,112.9576023,Benign
192.168.43.224,51244,209.167.231.17,443,20,5273,10,1311,10,3962,93.31974904,13.65045246,768.3261804,2321.974315,Benign
172.30.6.255,55750,209.15.36.33,80,5,330,1,66,4,264,58.374894,7.410987,71.24557093,284.9822837,Benign
192.168.215.49,60630,52.204.146.6,443,35,7434,18,2374,17,5060,555.723202,60.93160677,311.6937335,664.3514285,Benign
192.168.43.224,57084,172.217.166.197,443,3,186,2,132,1,54,9.425995184,3.497288632,301.9481979,123.5242628,Benign
172.30.6.255,56037,103.243.221.75,80,24,15233,9,2612,15,12621,252.851002,29.174832,716.233773,3460.791137,Benign
172.30.6.255,56380,103.243.221.75,80,50,35839,21,10604,29,25235,648.896632,28.168653,3011.574604,7166.831868,Benign
172.30.15.650,49937,45.56.120.142,80,16,6078,9,2135,7,3943,2395.567644,7.36588,2318.799655,4282.448261,Benign
172.30.6.255,55792,172.217.166.206,443,18,6559,9,1285,9,5274,80.058286,10.563505,973.1618435,3994.128843,Benign
172.30.15.1752,51064,184.29.25.7,443,112,69386,44,4672,68,64714,3637.741523,9.436872,3960.634414,54860.55125,Benign
10.0.2.15,52614,219.234.85.243,80,11,1344,6,792,5,552,17.888686,2.14441,2954.658857,2059.307688,Malicious
172.30.15.2244,51561,104.121.244.70,443,13,2006,7,1475,6,531,4468.148438,9.58339,1231.297067,443.2669442,Benign
192.168.137.97,52504,172.217.163.142,443,16,1068,8,536,8,532,19.92054064,18.05087487,237.550813,235.7780458,Benign
192.168.43.224,43848,52.84.110.11,443,32,7429,17,2296,15,5133,1210.319391,232.4001237,79.03610252,176.6952588,Benign
192.168.43.224,44584,192.168.121.2,443,7,518,7,518,0,0,2461.522586,64.80169787,63.94894172,0,Benign
172.30.6.255,57031,172.217.166.206,443,17,1779,10,1150,7,629,1570.434119,114.011376,80.693702,44.13594657,Benign
192.168.43.224,53576,151.101.1.69,443,18,6535,10,1795,8,4740,1898.233253,16.47721732,871.5063786,2301.359462,Benign
192.168.43.224,49824,34.205.118.138,443,29,7284,14,2438,15,4846,364.0694193,13.87283568,1405.912998,2794.526,Benign
10.0.2.15,37499,119.254.87.201,80,11,1513,6,705,5,808,15264.05123,1.482688,3803.902102,4359.649501,Malicious
192.168.43.233,51146,52.29.202.17,443,7,402,4,228,3,174,925.561576,14.235221,128.1328895,97.78562623,Benign
172.30.15.306,49569,54.86.32.187,80,6,348,4,228,2,120,710.494759,4.707953,387.4295262,203.9102769,Benign
10.0.2.15,44733,119.254.87.201,80,11,1579,6,705,5,874,10941.76892,2.388505,2361.30969,2927.35414,Malicious
10.0.2.15,57665,119.254.87.201,80,11,1582,6,705,5,877,23948.67493,2.048954,2752.624022,3424.186195,Malicious
172.30.6.255,56395,54.175.180.42,80,6,348,4,228,2,120,650.889478,26.224953,69.55207889,36.60635731,Benign
192.168.43.224,58514,172.217.166.206,443,19,5804,10,1278,9,4526,1710.268005,48.31529921,211.6099904,749.4106545,Benign
172.30.6.255,58262,172.217.167.2,80,70,20201,36,11311,34,8890,5268.979168,55.014562,1644.80088,1292.748636,Benign
172.30.6.255,56362,54.72.26.137,80,6,348,4,228,2,120,607.828864,24.266846,75.16427969,39.56014721,Benign
172.30.6.255,56771,23.198.126.238,443,19,6483,8,1310,11,5173,1245.55445,0.876625,11954.94082,47208.32739,Benign
10.0.2.15,39906,119.254.87.201,80,11,1579,6,705,5,874,18930.3266,1.62789,3464.607559,4295.130506,Malicious
192.168.137.97,42328,35.194.103.20,443,17,3189,10,2158,7,1031,374.5537954,12.40200468,1392.033018,665.0537727,Benign
172.30.15.2259,51576,104.121.244.70,443,31,18723,14,3350,17,15373,4486.767124,0.808553,33145.63176,152103.82,Benign
10.0.2.15,51468,119.254.87.201,80,11,1579,6,705,5,874,20885.29189,2.917561,1933.121535,2396.522301,Malicious
172.30.15.2349,51683,192.168.121.37,443,22,9290,11,1936,11,7354,5321.472252,6.298604,2458.957572,9340.482431,Benign
172.30.6.255,56261,202.241.208.4,80,7,402,4,228,3,174,529.951984,36.425584,50.07469475,38.21489863,Benign
172.30.15.1572,50881,52.84.108.216,443,14,2673,8,1671,6,1002,3560.266226,6.716611,1990.289448,1193.459023,Benign
172.30.6.255,56314,63.251.88.56,80,10,1747,5,936,5,811,590.941735,0.748644,10002.08377,8666.335401,Benign
192.168.43.224,42834,172.217.166.197,443,50,10058,26,4481,24,5577,131.4781528,240.3566029,149.1450602,185.6241912,Benign
10.0.2.15,48283,119.254.87.201,80,11,1579,6,705,5,874,22324.06831,1.028227,5485.170103,6800.054852,Malicious
172.30.6.255,55760,103.231.98.48,80,68,37123,33,29094,35,8029,61.584397,104.338395,2230.741617,615.6123065,Benign
192.168.43.224,33534,172.217.166.195,443,121,85953,46,4831,75,81122,2081.219719,241.2309046,160.2116448,2690.268898,Benign
172.30.1.136,50306,172.217.161.14,443,11,642,5,294,6,348,518.17244,13.411237,175.3753215,207.5871152,Benign
10.0.2.15,37290,119.254.87.201,80,11,1579,6,705,5,874,2861.337285,0.827127,6818.783573,8453.357223,Malicious
192.168.137.97,46554,103.229.206.27,443,6,412,4,272,2,140,349.7368991,14.02042709,155.2021194,79.88344381,Benign
172.30.15.2052,51364,35.172.175.129,443,6,348,4,228,2,120,4093.543924,4.049421,450.4347659,237.0709294,Benign
172.30.15.2474,51808,14.139.45.128,80,57,43225,25,2094,32,41131,5423.991626,8.452094,1981.994048,38930.94421,Benign
10.0.2.15,48082,119.254.87.201,80,11,1579,6,705,5,874,2414.889151,1.615927,3490.256676,4326.928135,Malicious
172.30.15.1364,50672,72.247.218.153,443,21,8576,11,4395,10,4181,3493.278238,3.7406,9399.561568,8941.880982,Benign
172.30.15.1924,51236,52.84.108.203,443,72,44034,30,3186,42,40848,3991.509713,5.704231,4468.262243,57288.00254,Benign
10.0.2.15,48184,119.254.87.201,80,11,1582,6,705,5,877,8119.103099,1.6244,3472.051219,4319.133218,Malicious
172.30.6.255,56310,147.75.111.32,80,17,5978,9,4775,8,1203,590.816576,15.2701,2501.620815,630.2512754,Benign
172.30.15.1728,51039,157.240.16.39,443,33,7355,18,4620,15,2735,3622.154284,4.926873,7501.715591,4440.95068,Benign
192.168.43.224,42684,107.21.25.13,443,22,5939,12,1980,10,3959,40.17755805,30.23082622,523.968478,1047.672325,Benign
172.30.6.255,57676,172.30.13.95,7680,3,198,3,198,0,0,3609.18563,9.004055,175.9207379,0,Benign
172.30.15.550,49834,157.240.16.39,443,30,7433,15,2619,15,4814,2252.760992,3.333091,6286.056996,11554.44001,Benign
172.30.15.1235,50543,77.238.185.35,443,29,8188,14,1934,15,6254,3468.556376,9.067859,1706.246204,5517.509701,Benign
172.30.15.968,50274,52.187.52.94,80,9,1340,6,779,3,561,3442.41691,4.622787,1348.104509,970.8429136,Benign
172.30.15.508,49790,52.229.170.171,443,28,10033,15,2183,13,7850,2021.846117,126.799995,137.7287121,495.2681583,Benign
192.168.215.49,54230,157.240.16.20,443,18,5377,10,1261,8,4116,118.5948443,23.71908833,425.3114562,1388.248972,Benign
172.30.6.255,57157,23.8.190.108,80,13,5510,6,549,7,4961,1939.042273,60.120572,73.05319717,660.1400931,Benign
172.30.6.255,57724,103.243.221.87,80,21,10668,10,4552,11,6116,3738.841612,23.273571,1564.693274,2102.298783,Benign
192.168.43.233,51643,52.84.110.227,443,9,534,5,294,4,240,842.891047,13.964445,168.4277463,137.4920378,Benign
172.30.15.1902,51214,52.204.146.6,443,16,4806,8,1099,8,3707,3983.871256,0.899085,9778.8307,32984.6455,Benign
10.0.2.15,55842,119.254.87.201,80,11,1582,6,705,5,877,4182.672273,0.82555,6831.809097,8498.576706,Malicious
172.30.1.136,51831,74.125.24.188,5228,22,2596,12,1468,10,1128,3304.9817,20.552941,571.402409,439.0612516,Benign
10.0.2.15,46751,119.254.87.201,80,12,1653,7,779,5,874,11842.71063,4.474621,1392.743654,1562.590441,Malicious
10.0.2.15,60105,119.254.87.201,80,11,1582,6,705,5,877,24366.6222,1.086306,5191.907253,6458.585334,Malicious
192.168.43.233,50716,172.217.166.206,443,24,8638,12,1729,12,6909,1843.414004,11.574147,1195.07727,4775.470711,Benign
172.30.6.255,56283,157.240.16.20,443,22,2123,12,1261,10,862,567.158285,65.309424,154.464691,105.5896619,Benign
192.168.43.233,51220,104.121.28.119,443,28,10477,15,1550,13,8927,1536.960293,325.08835,38.143477,219.6818188,Benign
192.168.43.224,48036,151.101.153.177,443,8,552,5,338,3,214,66.21326991,15.77730267,171.3854426,108.5103098,Benign
192.168.43.224,34414,172.217.166.194,443,17,5080,9,1377,8,3703,1905.774,12.49662782,881.517811,2370.559516,Benign
192.168.43.224,50582,49.44.150.71,443,67,18892,37,14803,30,4089,2283.136348,315.5692012,375.271096,103.6603061,Benign
172.30.15.2008,51320,52.26.114.97,443,138,105860,62,4846,76,101014,4081.567077,5.680959,6824.199928,142249.2224,Benign
172.30.1.136,50409,13.107.4.52,80,15,2626,7,568,8,2058,822.699992,2.778184,1635.60081,5926.173356,Benign
172.30.1.136,50659,52.94.220.15,443,7,405,4,228,3,177,1782.43479,12.884152,141.5692705,109.90246,Benign
192.168.43.233,51171,151.101.153.176,443,17,8346,9,1108,8,7238,1036.998999,13.643704,649.6769499,4244.008812,Benign
10.0.2.15,55617,119.254.87.201,80,3,222,3,222,0,0,9833.036323,9.047638,196.2943257,0,Malicious
10.0.2.15,53898,119.254.87.201,80,11,1579,6,705,5,874,5654.038023,1.3527,4169.4389,5168.921416,Malicious
192.168.137.97,46322,172.217.160.227,443,18,1264,13,938,5,326,3761.142915,127.6994699,58.76296907,20.42295087,Benign
192.168.43.224,46978,172.217.166.195,80,14,912,7,462,7,450,9.923434347,239.2809868,15.44627531,15.04507336,Benign
10.0.2.15,50849,119.254.87.201,80,11,1582,6,705,5,877,42.383889,1.507116,3742.246781,4655.248833,Malicious
172.30.6.255,57794,103.243.221.87,80,15,7857,10,6764,5,1093,4041.906612,23.160849,2336.356495,377.533656,Benign
192.168.43.224,40614,130.207.188.158,80,16,2264,9,1372,7,892,835.3293224,46.01864054,238.5120436,155.0675969,Benign
192.168.137.97,33456,52.94.216.31,443,11,1756,9,1640,2,116,3739.552611,61.87806404,212.0299043,14.99723714,Benign
192.168.43.233,51525,49.44.164.114,443,28,7928,15,1278,13,6650,3978.4601,24.732238,413.3875794,2151.038657,Benign
172.30.6.255,58397,216.58.196.162,80,10,1582,6,912,4,670,5541.838581,7.227129,1009.52951,741.6499692,Benign
172.30.1.136,51762,74.125.68.188,5228,9,534,5,294,4,240,2948.315688,61.84963,38.02771334,31.0430313,Benign
172.30.15.1662,50973,184.29.25.7,443,252,223161,93,21464,159,201697,3587.528129,19.516584,8798.261007,82677.17342,Benign
172.30.6.255,57215,52.114.6.46,443,20,7560,12,2917,8,4643,2120.081986,1.035522,22535.49418,35869.83183,Benign
10.0.2.15,38990,119.254.87.201,80,11,1582,6,705,5,877,6499.403695,2.087438,2701.876655,3361.057909,Malicious
10.0.2.15,38592,119.254.87.201,80,11,1579,6,705,5,874,10343.50398,2.290679,2462.152052,3052.370061,Malicious
172.30.15.2421,51755,14.139.45.128,80,10,1422,5,693,5,729,5352.049857,0.087655,63247.96076,66533.56911,Benign
172.30.15.2314,51643,52.55.184.84,443,6,348,4,228,2,120,5034.313846,3.5191,518.3143417,272.797022,Benign
172.30.6.255,55905,185.84.60.59,80,11,1560,6,975,5,585,121.805514,30.655258,254.4424842,152.6654905,Benign
192.168.137.97,56426,172.217.161.14,443,76,16471,37,7264,39,9207,989.7680893,453.1825866,128.2308759,162.5305168,Benign
172.30.15.1100,50406,54.37.85.231,443,6,360,3,198,3,162,3454.948042,1.749742,905.2763207,740.6806261,Benign
172.30.6.255,57741,103.243.221.87,80,20,10617,9,4498,11,6119,3800.089654,44.979707,800.0052112,1088.313003,Benign
192.168.43.233,51134,13.107.42.254,443,1,54,0,0,1,54,19.181299,0,0,0,Benign
192.168.43.224,40780,104.19.195.151,443,224,132087,108,8424,116,123663,804.3486121,407.2160373,165.4944644,2429.432806,Benign
172.30.6.255,56938,151.101.130.2,80,11,2791,6,1947,5,844,1387.754814,46.193429,337.1908156,146.1679755,Benign
172.30.6.255,58534,157.240.16.39,443,19,1933,10,1125,9,808,5791.086898,61.056181,147.4052234,105.8697071,Benign
172.30.6.255,56750,103.243.220.231,80,6,340,4,228,2,112,1244.347616,0.424934,4292.431295,2108.562742,Benign
172.30.6.255,56053,103.243.220.234,443,6,348,4,228,2,120,254.629168,27.39682,66.57706989,35.0405631,Benign
172.30.15.1609,50919,157.240.16.39,443,27,4526,14,2940,13,1586,3573.86996,3.246896,7243.841503,3907.732185,Benign
172.30.1.136,51509,13.107.246.10,443,1,54,0,0,1,54,116.093445,0,0,0,Benign
172.30.15.1396,50704,104.36.113.23,443,42,18642,20,9039,22,9603,3498.626956,8.644545,8365.044083,8886.991739,Benign
172.30.15.1797,51109,184.29.24.149,443,8,480,5,294,3,186,3649.093889,7.974407,294.9435613,186.596947,Benign
172.30.15.1324,50632,52.85.51.33,443,8,480,5,294,3,186,3488.591802,8.547605,275.1647976,174.0838516,Benign
192.168.43.233,51684,54.255.158.169,443,26,2894,13,1852,13,1042,894.861102,125.873444,117.7055265,66.22524764,Benign
172.30.15.2501,51835,14.139.45.128,80,10,1428,5,686,5,742,5475.723042,0.198234,27684.45373,29944.40913,Benign
192.168.215.49,58208,103.229.206.27,443,44,27160,20,2712,24,24448,480.1187102,62.04937879,349.6570058,3152.070235,Benign
172.30.15.2249,51566,184.29.25.145,443,80,57299,35,4287,45,53012,4468.15533,9.538538,3595.519565,44461.32101,Benign
192.168.43.233,51060,49.44.148.176,443,163,86160,75,18704,88,67456,891.997105,236.862408,631.7254024,2278.318474,Benign
10.0.2.15,50015,119.254.87.201,80,11,1579,6,705,5,874,19438.3198,1.402223,4022.184774,4986.368074,Malicious
172.30.6.255,58507,210.176.156.21,80,14,5524,8,3970,6,1554,5747.865928,1.28091,24794.8724,9705.599925,Benign
172.30.6.255,57034,157.240.16.39,443,28,5548,15,3399,13,2149,1582.088228,61.066266,445.2867644,281.5302314,Benign
10.0.2.15,37333,119.254.87.201,80,11,1582,6,705,5,877,4875.654857,0.81897,6886.699146,8566.858371,Malicious
192.168.43.224,39088,103.37.200.184,443,30,8882,18,7233,12,1649,2571.001423,15.93633874,3630.946916,827.7936493,Benign
192.168.43.233,51063,49.44.170.52,443,34,11271,17,2480,17,8791,896.185021,14.237374,1393.515405,4939.674971,Benign
192.168.215.49,48550,54.209.180.26,443,27,10823,15,3858,12,6965,480.1782047,61.98982486,497.8881626,898.8571935,Benign
172.30.15.1435,50743,103.231.98.244,443,17,6428,8,1087,9,5341,3501.170994,0.999057,8704.208068,42768.33054,Benign
192.168.215.49,59168,223.31.160.61,443,478,421310,178,22302,300,399008,279.7223135,13.14648113,13571.38829,242807.4836,Benign
10.0.2.15,36934,119.254.87.201,80,12,1656,7,779,5,877,17728.96156,3.99128,1561.40386,1757.832074,Malicious
10.0.2.15,40348,119.254.87.201,80,11,1582,6,705,5,877,18837.68162,1.456607,3872.012149,4816.673269,Malicious
172.30.6.255,55770,195.201.82.80,80,184,187613,50,6203,134,181410,62.532845,36.363279,1364.673411,39910.59222,Benign
172.30.1.136,50370,172.217.161.3,443,3,198,3,198,0,0,668.774615,9.00476,175.9069648,0,Benign
172.30.6.255,57511,103.243.221.51,80,71,48184,42,40162,29,8022,3072.837259,50.191998,6401.339114,1278.610188,Benign
192.168.43.224,41890,23.251.156.28,443,1051,858839,438,41896,613,816943,714.9336,172.9583091,1937.854282,37786.81714,Benign
172.30.1.136,50790,172.217.161.4,443,19,2686,11,1841,8,845,1925.545243,7.303795,2016.48595,925.54624,Benign
172.30.15.1808,51120,23.8.190.108,80,18,7196,9,735,9,6461,3712.23167,62.529856,94.03507982,826.6131302,Benign
10.0.2.15,59903,119.254.87.201,80,12,1653,7,779,5,874,12836.02594,3.915296,1591.705966,1785.816449,Malicious
172.30.15.1861,51173,35.161.208.104,443,15,2813,8,1989,7,824,3919.248414,8.253589,1927.888583,798.6828518,Benign
192.168.43.224,36106,107.21.25.13,443,35,8512,18,3723,17,4789,56.85675661,61.88183966,481.3043724,619.1154014,Benign
192.168.43.224,50940,23.251.156.28,443,9,610,5,338,4,272,2533.683063,85.38337578,31.66892823,25.48505467,Benign
172.30.15.602,49888,13.107.21.200,443,50,15055,24,4737,26,10318,2356.377892,9.767585,3879.771714,8450.809489,Benign
172.30.6.255,58443,35.190.43.164,80,10,1629,6,1175,4,454,5616.895263,2.150966,4370.129514,1688.543659,Benign
192.168.43.224,48430,104.237.191.1,443,9,618,5,338,4,280,2909.274254,15.08820648,179.2128179,148.4603225,Benign
172.30.6.255,57941,103.243.221.75,80,7,406,5,294,2,112,4558.844012,28.208037,83.38049188,31.76399691,Benign
10.0.2.15,38380,119.254.87.201,80,11,1582,6,705,5,877,7910.887325,2.013318,2801.345838,3484.794752,Malicious
172.30.6.255,58155,157.240.16.39,443,36,19528,15,2777,21,16751,4957.871044,1.068033,20800.8554,125471.7785,Benign
192.168.43.224,57266,139.59.82.147,443,22,7359,12,1410,10,5949,2571.002013,12.73033143,886.0727675,3738.472974,Benign
192.168.137.97,58902,104.244.42.193,443,1047,277949,578,136229,469,141720,12.84088989,1960.328073,555.9436785,578.3521726,Benign
172.30.15.1155,50463,180.149.59.136,80,87,70972,35,4188,52,66784,3459.397782,7.634382,4388.567405,69982.3509,Benign
192.168.215.49,40822,67.205.1.42,80,6,362,4,236,2,126,1268.584593,30.50994185,61.88146832,33.03841105,Benign
192.168.43.224,58214,162.213.83.13,443,35,11401,19,6916,16,4485,106.342671,101.9397794,542.7518121,351.9725097,Benign
172.30.15.2490,51824,14.139.45.128,80,10,1436,5,702,5,734,5434.520008,0.564545,9947.834096,10401.29662,Benign
192.168.43.224,58010,172.217.166.206,443,9,618,5,338,4,280,24.66198469,11.68589766,231.3900121,191.6840337,Benign
192.168.137.97,36960,52.22.149.115,443,7,478,4,272,3,206,347.680248,8.325855097,261.3545365,197.9376269,Benign
172.30.15.1913,51225,52.204.146.6,443,16,4806,9,1153,7,3653,3985.138275,2.059513,4478.728709,14189.76234,Benign
172.30.6.255,56827,103.243.220.231,80,24,11197,13,9796,11,1401,1313.613688,13.771358,5690.651568,813.8630918,Benign
192.168.137.97,60016,34.199.78.214,443,33,12355,18,2025,15,10330,1766.93252,50.79361891,318.9377002,1626.976021,Benign
10.0.2.15,56358,219.234.85.243,80,11,1857,6,795,5,1062,330.486157,36453.84852,0.174467176,0.233061812,Malicious
192.168.137.97,45338,23.57.214.252,443,34,5864,18,3645,16,2219,9.521293278,394.4503253,73.9256584,45.00439945,Benign
192.168.43.233,51218,52.175.28.154,443,26,11235,14,3072,12,8163,1247.39046,126.012768,195.0278562,518.2332,Benign
172.30.6.255,57137,117.18.232.200,443,47,24490,21,1918,26,22572,1865.62296,109.964974,139.5353397,1642.122882,Benign
172.30.15.1416,50724,52.4.175.160,443,21,7975,11,1843,10,6132,3500.207651,6.99791,2106.914779,7010.093013,Benign
172.30.6.255,56980,184.29.26.182,443,13,1477,7,958,6,519,1436.8976,17.824293,429.9749785,232.9405155,Benign
172.30.6.255,56149,103.243.221.87,80,15,4447,8,2866,7,1581,393.847372,12.181017,1882.273048,1038.336947,Benign
192.168.43.233,51505,13.107.54.254,443,55,17136,29,2872,26,14264,3897.41078,128.567979,178.7070169,887.5615911,Benign
172.30.15.914,50220,184.29.26.86,443,23,10140,12,2115,11,8025,3439.970791,7.019774,2410.334008,9145.593576,Benign
172.30.6.255,57177,54.194.27.245,443,19,6444,10,1207,9,5237,2008.662168,25.600687,377.1773781,1636.518582,Benign
10.0.2.15,43414,119.254.87.201,80,11,1579,6,705,5,874,3131.652076,1.357507,4154.674709,5150.618008,Malicious
172.30.15.1932,51244,34.201.201.2,443,11,1403,7,960,4,443,3991.668401,5.531482,1388.416341,640.6962908,Benign
192.168.43.233,51184,63.215.202.75,443,7,394,4,228,3,166,1052.226674,25.361318,71.92055239,52.3632092,Benign
192.168.43.224,58828,174.129.238.218,443,338,271418,150,32319,188,239099,3244.976587,122.642868,2108.169878,15596.43892,Benign
192.168.43.224,50266,172.217.160.234,443,13,921,6,396,7,525,14.0194264,163.2161699,19.40984157,25.73274451,Benign
192.168.137.97,42384,172.217.194.188,443,23,3399,13,1742,10,1657,12293.74818,104.2452821,133.684707,127.16163,Benign
10.0.2.15,57746,119.254.87.201,80,11,1587,6,705,5,882,14998.71654,1.725342,3268.917119,4089.62397,Malicious
172.30.15.2144,51456,184.29.26.27,443,16,5710,10,1219,6,4491,4178.813848,8.539771,1141.950996,4207.138575,Benign
172.30.15.1896,51208,104.113.220.53,443,28,9497,15,1876,13,7621,3982.714391,4.538665,3306.699217,13433.02491,Benign
192.168.43.233,50890,49.44.169.252,443,25,3708,13,2004,12,1704,125.491615,107.572729,149.0340549,126.7235676,Benign
10.0.2.15,52278,119.254.87.201,80,11,1544,6,705,5,839,19350.75831,1.612893,3496.82217,4161.466384,Malicious
172.30.15.1306,50614,52.220.14.37,443,26,8167,13,1728,13,6439,3486.383574,0.836976,16516.60263,61545.37287,Benign
10.0.2.15,53498,119.254.87.201,80,11,1579,6,705,5,874,24483.90785,0.951417,5928.000025,7349.038329,Malicious
172.30.1.136,50663,13.107.4.52,80,10,1519,5,436,5,1083,1792.013302,0.399167,8738.197296,21705.20108,Benign
172.30.1.136,51508,131.253.61.82,443,1,54,0,0,1,54,52.740683,0,0,0,Benign
172.30.15.1138,50446,50.23.131.235,443,11,1405,7,958,4,447,3458.307866,8.638899,887.1500871,413.9416377,Benign
172.30.15.2449,51783,14.139.45.128,80,11,1484,6,730,5,754,5420.427,2.088703,2795.993495,2887.916568,Benign
192.168.43.233,51220,157.240.16.39,443,50,19731,23,4283,27,15448,1282.594325,67.477078,507.7872518,1831.496023,Benign
192.168.137.97,46908,54.85.227.48,443,6,412,4,272,2,140,3028.462218,27.32469397,79.63492666,40.98856519,Benign
192.168.43.224,59308,91.189.92.40,443,7,524,4,307,3,217,4.914918826,1.792086688,1370.469418,968.703139,Benign
172.30.1.136,50319,157.240.16.20,443,35,8934,11,1804,24,7130,567.439653,157.105989,91.86155214,363.0669993,Benign
192.168.137.97,37772,117.18.237.70,443,34,10379,18,2530,16,7849,285.306646,28.98333103,698.3324305,2166.486659,Benign
192.168.43.233,50919,65.222.231.19,80,7,402,4,228,3,174,398.171382,33.473248,54.49127614,41.58544758,Benign
192.168.137.97,39078,157.240.16.16,443,432,37527,217,19799,215,17728,379.5603939,2700.551963,58.6517135,52.51667139,Benign
172.30.6.255,58151,103.231.98.53,80,19,6478,10,5744,9,734,4957.837747,1.165989,39410.32034,5036.068093,Benign
172.30.15.889,50195,192.229.237.25,443,32,15837,17,3074,15,12763,3438.46999,8.504921,2891.502461,12005.28494,Benign
192.168.42.240,50929,52.114.132.73,443,17,7032,9,2392,8,4640,25.907692,1.46308,13079.25746,25371.13487,Benign
172.30.15.1963,51275,35.171.73.174,443,16,4819,9,1153,7,3666,4075.706839,1.540999,5985.72744,19031.80988,Benign
172.30.15.1776,51088,161.202.1.35,443,16,4041,9,2426,7,1615,3641.803919,5.372875,3612.218784,2404.671614,Benign
192.168.43.233,51317,74.207.230.33,443,9,534,5,294,4,240,2939.74141,17.652255,133.2407673,108.7679733,Benign
10.0.2.15,55344,119.254.87.201,80,11,1582,6,705,5,877,2024.587824,1.826279,3088.246648,3841.69122,Malicious
172.30.15.1459,50767,13.228.208.99,443,15,2392,8,1513,7,879,3504.757235,2.306964,5246.722532,3048.162,Benign
172.30.15.2495,51829,104.19.199.151,443,12,2073,7,1007,5,1066,5475.086094,2.706342,2976.711739,3151.116895,Benign
172.30.6.255,58108,210.176.156.41,80,10,572,8,456,2,116,4891.845798,14.349832,254.2190041,64.66974666,Benign
10.0.2.15,59871,119.254.87.201,80,11,1579,6,705,5,874,17516.43432,1.415505,3984.443714,4939.579867,Malicious
10.0.2.15,58223,119.254.87.201,80,11,1579,6,705,5,874,19288.15053,2.048231,2753.595664,3413.677461,Malicious
172.30.15.1120,50428,180.149.59.139,80,14,4674,8,935,6,3739,3458.280627,8.7514,854.7203876,3417.967411,Benign
10.0.2.15,37133,119.254.87.201,80,11,1582,6,705,5,877,1874.426626,1.286004,4385.678427,5455.659547,Malicious
172.30.6.255,56470,52.220.16.13,443,26,9625,14,2650,12,6975,771.471941,73.369474,288.9485074,760.5342789,Benign
172.30.1.136,51785,52.220.54.9,443,31,9175,14,2440,17,6735,2974.55,123.830418,157.6349359,435.1111857,Benign
10.0.2.15,42132,115.182.31.2,80,8,860,4,604,4,256,185.757271,57.782135,83.62446282,35.44348093,Malicious
10.0.2.15,35985,119.254.87.201,80,11,1582,6,705,5,877,26409.15415,0.82845,6807.89426,8468.827328,Malicious
192.168.137.97,37874,172.217.160.227,443,7,466,4,272,3,194,1768.61644,55.64384433,39.10585306,27.89167461,Benign
172.30.6.255,55661,35.190.43.164,80,20,5366,10,3910,10,1456,37.639378,20.972294,1491.491584,555.3994236,Benign
172.30.15.848,50151,162.125.82.3,443,6,348,4,228,2,120,3334.537952,0.379933,4800.846465,2526.761297,Benign
172.30.15.1794,51106,104.244.42.195,443,11,1376,7,958,4,418,3643.535683,3.453025,2219.503189,968.426235,Benign
192.168.43.224,35992,34.224.176.220,443,88,10913,51,6000,37,4913,1144.250082,93.28931431,514.5283825,421.3129906,Benign
192.168.43.233,50975,104.244.42.1,443,9,534,5,294,4,240,496.94343,12.978332,181.2251374,147.9388877,Benign
172.30.15.1544,50852,180.179.41.214,443,17,4022,9,2863,8,1159,3536.658988,0.273427,83766.41663,33910.33073,Benign
172.30.6.255,56806,161.69.38.37,80,7,398,4,228,3,170,1267.073937,0.621284,2935.855422,2189.015008,Benign
10.0.2.15,41092,119.254.87.201,80,11,1554,6,705,5,849,26051.08387,0.86653,6508.718683,7838.159094,Malicious
10.0.2.15,58137,119.254.87.201,80,11,1582,6,705,5,877,21660.67109,2.018135,2794.659426,3476.477044,Malicious
192.168.43.233,51292,23.9.140.60,80,16,5290,9,4588,7,702,2801.824477,12.52798,2929.762021,448.2765777,Benign
192.168.137.97,44898,104.17.41.113,443,28,9534,15,2028,13,7506,26.41492514,12.86405862,1261.188282,4667.889175,Benign
192.168.43.224,49954,34.196.177.243,443,112,13610,65,7424,47,6186,2084.45333,106.0694093,559.9352387,466.5624174,Benign
192.168.43.233,51350,52.216.18.144,443,29,7845,13,1908,16,5937,3424.001005,10.611409,1438.451765,4475.937173,Benign
192.168.215.49,60648,52.204.146.6,443,22,5451,12,1443,10,4008,556.732396,77.54903048,148.8606618,413.4674515,Benign
192.168.215.49,41080,104.19.195.151,443,49,10883,24,2302,25,8581,1299.016589,400.3363926,46.00131375,171.475792,Benign
10.0.2.15,39083,119.254.87.201,80,12,1653,7,779,5,874,6947.686465,3.863086,1613.218033,1809.95194,Malicious
192.168.137.97,41162,104.244.42.193,443,12,808,6,404,6,404,22.29008746,18.9898032,170.1966032,170.1966032,Benign
192.168.43.224,42728,107.21.25.13,443,19,5408,11,1389,8,4019,57.07076339,13.33785816,833.1172719,2410.581941,Benign
192.168.137.97,56458,52.84.110.226,443,9,618,6,404,3,214,345.8609734,11.17094823,289.321903,153.2546714,Benign
192.168.42.240,50966,216.58.221.46,443,63,19208,26,11042,37,8166,278.289794,61.772315,1430.025732,1057.561142,Benign
172.30.15.1844,51156,34.234.132.222,443,6,348,4,228,2,120,3869.816029,7.531858,242.1713208,127.4585899,Benign
172.30.15.2138,51450,151.101.129.2,443,14,5404,8,1054,6,4350,4178.596497,8.75178,963.4611473,3976.333957,Benign
192.168.43.224,47712,184.50.97.22,443,33,7688,18,2267,15,5421,106.2521159,302.2322885,60.00682485,143.4922794,Benign
192.168.43.224,43090,66.228.33.150,443,50,24997,26,3575,24,21422,2618.811755,159.6867683,179.100625,1073.201004,Benign
192.168.43.233,51205,172.217.160.238,443,9,535,5,295,4,240,801.953808,58.900676,40.06745186,32.59724897,Benign
192.168.43.233,51404,172.217.161.14,443,9,534,5,294,4,240,3626.953717,19.597866,120.0130667,97.96985039,Benign
10.0.2.15,55938,119.254.87.201,80,11,1582,6,705,5,877,22711.92965,1.753813,3215.850265,4000.426499,Malicious
172.30.6.255,58314,180.149.59.232,80,12,4896,8,3669,4,1227,5353.88443,5.101824,5753.23649,1924.017763,Benign
172.30.6.255,56216,162.210.199.69,80,14,3360,8,1447,6,1913,470.031396,6.349581,1823.112423,2410.237778,Benign
172.30.15.673,49960,104.31.90.207,80,179,161131,67,5086,112,156045,2397.486805,8.786453,4630.765111,142077.81,Benign
192.168.137.97,50598,192.168.121.7,443,80,33688,46,13722,34,19966,2901.551106,21.17382033,5184.515515,7543.655208,Benign
172.30.15.566,49850,50.31.185.52,443,18,6639,11,1934,7,4705,2254.609242,1.668125,9275.084301,22564.25628,Benign
172.30.15.924,50230,104.16.87.26,80,19,8085,10,1059,9,7026,3440.35958,6.641556,1275.604693,8463.077026,Benign
192.168.43.224,42244,172.217.160.226,443,12,820,7,478,5,342,2808.567728,57.72107284,66.24963487,47.40036637,Benign
172.30.1.136,50334,172.217.161.3,443,34,3562,15,2180,19,1382,596.095865,19.065956,914.7194088,579.8817536,Benign
192.168.43.233,51490,52.84.110.163,443,7,402,4,228,3,174,3818.924727,72.364968,25.20556632,19.23582693,Benign
172.30.6.255,58444,180.149.59.232,80,12,4894,8,3668,4,1226,5617.007575,2.002538,14653.40483,4897.784711,Benign
10.0.2.15,46212,119.254.87.201,80,11,1579,6,705,5,874,23135.18999,2.181315,2585.596303,3205.405913,Malicious
172.30.15.2209,51524,104.24.0.12,443,6,348,4,228,2,120,4432.976309,6.866214,265.6485801,139.8150422,Benign
192.168.43.224,36078,136.146.210.117,443,45,11459,23,4267,22,7192,94.08366395,318.3860314,107.215759,180.7114456,Benign
172.30.6.255,57422,172.217.166.206,443,80,13681,39,8010,41,5671,2774.427154,145.749602,439.6581474,311.2735773,Benign
10.0.2.15,48461,119.254.87.201,80,11,1513,6,705,5,808,15444.17788,1.225286,4603.006971,5275.503025,Malicious
10.0.2.15,58154,119.254.87.201,80,11,1585,6,705,5,880,5268.255095,1.781676,3165.558721,3951.335709,Malicious
172.30.6.255,56058,34.234.151.4,443,22,5803,13,4892,9,911,284.848479,121.224848,322.8381033,60.11968767,Benign
10.0.2.15,42031,119.254.87.201,80,11,1579,6,705,5,874,19083.49125,1.589694,3547.852606,4398.330748,Malicious
10.0.2.15,44258,119.254.87.201,80,12,1587,7,779,5,808,4783.343729,3.810019,1635.687381,1696.579466,Malicious
172.30.6.255,57049,54.194.27.245,443,14,1537,7,959,7,578,1616.053827,48.622251,157.7878408,95.10049216,Benign
192.168.43.233,51520,13.107.18.11,443,34,7057,17,1631,17,5426,3916.382655,123.431915,105.7100994,351.6756586,Benign
192.168.137.97,45800,151.101.193.63,443,32501,29347140,12591,903218,19910,28443922,2387.204425,191.5647937,37719.5823,1187855.929,Benign
192.168.43.233,50997,163.53.79.200,443,28,8398,14,1948,14,6450,515.362175,68.507564,227.4785307,753.2015005,Benign
192.168.215.49,50802,172.217.161.3,443,6,459,2,132,4,327,19.68327887,13.70389079,77.05840747,190.8946912,Benign
172.30.6.255,57088,172.30.16.59,7680,3,198,3,198,0,0,1717.42546,9.004372,175.9145446,0,Benign
192.168.43.224,49012,104.198.143.177,80,11,977,6,491,5,486,389.5419657,1.24430108,3156.792245,3124.645685,Benign
172.30.15.2296,51624,172.217.166.196,443,19,3127,10,1478,9,1649,4923.377452,1.20651,9800.167425,10934.01629,Benign
172.30.15.899,50205,103.243.220.231,80,27,11563,14,6945,13,4618,3438.496682,8.76513,6338.753675,4214.883293,Benign
172.30.15.344,49612,172.25.10.63,7680,2,132,2,132,0,0,1089.043204,2.999791,352.0245244,0,Benign
192.168.43.224,47630,104.24.19.65,443,18,6456,10,1141,8,5315,1275.295546,10.69419779,853.5469588,3975.987805,Benign
172.30.6.255,57960,103.243.221.17,80,37,23575,16,9336,21,14239,4629.865225,17.165881,4350.956412,6635.954193,Benign
172.30.6.255,57765,157.240.16.39,443,19,1933,10,1125,9,808,3961.090409,61.073815,147.3626627,105.8391391,Benign
10.0.2.15,40576,119.254.87.201,80,11,1582,6,705,5,877,9918.273549,1.821338,3096.624569,3852.113117,Malicious
192.168.43.233,51140,210.176.156.55,443,34,8903,18,4460,16,4443,925.507651,354.338444,100.6946906,100.3108768,Benign
192.168.43.233,51214,52.84.108.135,443,12,696,7,402,5,294,1437.928283,75.720981,42.471716,31.06140424,Benign
192.168.43.224,51522,54.197.248.134,443,114,71676,59,8420,55,63256,542.4550572,72.17780345,933.2508996,7011.130511,Benign
192.168.43.233,51128,151.101.154.2,443,64,14061,31,4196,33,9865,922.176004,601.725766,55.78621009,131.1560921,Benign
192.168.215.49,46416,223.31.160.67,443,115,95220,42,3935,73,91285,335.7264432,124.8034048,252.2367082,5851.442926,Benign
192.168.43.224,54208,18.233.7.102,443,24,9157,13,3240,11,5917,89.93551983,3.761450975,6890.957817,12584.50537,Benign
10.0.2.15,35365,119.254.87.201,80,11,1582,6,705,5,877,6074.436296,0.878142,6422.651462,7989.596216,Malicious
172.30.6.255,58431,157.240.16.17,443,894,761614,359,26848,535,734766,5592.984796,6.048461,35510.52078,971838.6214,Benign
172.30.6.255,57128,13.67.76.139,443,26,11304,14,1558,12,9746,1861.605526,0.393015,31713.80227,198384.2856,Benign
172.30.15.1610,50920,104.244.42.195,443,24,3762,12,2040,12,1722,3573.878833,3.335858,4892.294576,4129.672186,Benign
172.30.15.2280,51599,87.250.251.119,443,476,345315,243,329488,233,15827,4560.415687,17.340802,152005.8876,7301.623074,Benign
172.30.1.136,50232,52.84.109.5,443,742,461827,315,39739,427,422088,431.611453,177.323453,1792.836732,19042.62489,Benign
172.30.6.255,57876,103.243.221.109,80,18,10223,9,4238,9,5985,4276.85015,1.171801,28933.24037,40860.18018,Benign
10.0.2.15,51861,119.254.87.201,80,11,1582,6,705,5,877,8719.659678,2.019693,2792.503613,3473.795275,Malicious
172.30.6.255,56368,103.243.221.46,443,22,8575,12,4253,10,4322,609.536375,23.264799,1462.466966,1486.193799,Benign
172.30.6.255,57920,103.243.221.46,80,38,24271,23,20231,15,4040,4465.832303,16.246573,9961.977828,1989.342614,Benign
172.30.15.1159,50467,103.243.220.231,80,11,2977,7,1963,4,1014,3460.51158,7.127603,2203.265249,1138.110526,Benign
172.30.6.255,56766,23.198.126.238,443,17,6697,8,1316,9,5381,1244.684909,0.78064,13486.37016,55144.49682,Benign
10.0.2.15,57900,119.254.87.201,80,11,1582,6,705,5,877,5444.071639,0.823262,6850.79598,8522.19585,Malicious
192.168.137.97,46554,151.101.193.170,443,19,7875,11,1368,8,6507,382.7904545,17.0242463,642.8478422,3057.756513,Benign
10.0.2.15,60243,119.254.87.201,80,12,1656,7,779,5,877,11124.44697,4.601952,1354.207953,1524.570443,Malicious
172.30.6.255,56103,35.186.202.217,443,7,402,4,228,3,174,305.961639,17.910796,101.8380199,77.71848889,Benign
192.168.43.224,50872,23.251.156.28,443,1792,1533553,729,65057,1063,1468496,1808.583929,334.9252525,1553.946727,35076.38768,Benign
172.30.1.136,50785,74.125.68.188,5228,1,66,1,66,0,0,1928.357053,0,0,0,Benign
10.0.2.15,60381,119.254.87.201,80,11,1579,6,705,5,874,5326.171462,1.890645,2983.108939,3698.208812,Malicious
192.168.137.97,55190,172.217.161.10,443,15,1053,7,462,8,591,28.80009212,193.794109,19.07178716,24.39702644,Benign
172.30.15.1825,51137,52.6.46.142,443,96,63893,44,4076,52,59817,3860.855529,6.470453,5039.523508,73957.10934,Benign
192.168.43.233,51170,172.217.160.238,443,27,6585,9,1287,18,5298,500.608716,274.278042,37.53855002,154.5293225,Benign
172.30.6.255,56985,103.243.221.51,80,39,24155,24,20106,15,4049,1452.832393,27.741535,5798.093004,1167.635461,Benign
172.30.15.751,50041,52.84.108.50,443,18,6915,10,1207,8,5708,2576.242993,9.920964,973.2925147,4602.77852,Benign
172.30.15.565,49849,151.101.2.2,443,39,16760,20,2392,19,14368,2254.60863,1.485573,12881.22495,77373.51177,Benign
172.30.15.2094,51406,52.204.146.6,443,6,348,4,228,2,120,4141.175359,6.515587,279.9440787,147.3389888,Benign
10.0.2.15,58216,119.254.87.201,80,11,1579,6,705,5,874,8211.240745,1.695897,3325.67367,4122.891897,Malicious
192.168.137.97,33690,104.17.162.9,443,310,193305,156,10804,154,182501,3519.130715,417.6963234,206.9254508,3495.381496,Benign
192.168.137.97,34184,192.229.237.96,443,21,7397,12,1479,9,5918,144.4497331,10.87236042,1088.264143,4354.528195,Benign
10.0.2.15,49816,119.254.87.201,80,13,1730,8,853,5,877,23672.94513,10.136672,673.1992512,692.140379,Malicious
192.168.137.97,44626,18.208.55.232,443,33,5262,19,2751,14,2511,4061.64216,61.35712005,358.6869785,327.3947666,Benign
172.30.6.255,57604,103.243.221.17,80,40,24161,20,13363,20,10798,3375.857801,26.205382,4079.46734,3296.422086,Benign
10.0.2.15,42633,119.254.87.201,80,12,1653,7,779,5,874,1719.890615,6.757665,922.2120363,1034.676919,Malicious
192.168.137.97,55194,172.217.161.10,443,2,120,1,66,1,54,31.61602181,0.046191005,11430.79697,9352.470248,Benign
172.30.15.389,49657,62.210.213.13,80,38,24754,17,1772,21,22982,1466.473188,4.033108,3514.907114,45586.67906,Benign
172.30.15.2039,51351,34.192.10.179,443,6,348,4,228,2,120,4090.827195,6.766496,269.5634491,141.8754995,Benign
172.30.15.1802,51114,52.37.171.77,443,13,810,8,492,5,318,3673.038058,4.696316,838.1037392,541.7011973,Benign
10.0.2.15,43567,219.234.85.243,80,9,994,5,738,4,256,182.603821,0.656042,8999.423817,3121.751351,Malicious
172.30.6.255,56632,103.243.221.17,80,34,26443,15,8110,19,18333,1011.893467,13.177668,4923.48115,11129.73859,Benign
172.30.6.255,57971,131.253.61.102,443,56,26881,16,6929,40,19952,4686.853632,65.039395,852.2834507,2454.14337,Benign
172.30.15.1319,50627,104.19.199.151,443,34,14928,17,1902,17,13026,3488.274468,8.759596,1737.066413,11896.43906,Benign
172.30.6.255,57538,103.243.220.231,80,21,10357,9,4216,12,6141,3147.860195,14.170827,2380.101034,3466.840714,Benign
10.0.2.15,44602,119.254.87.201,80,11,1579,6,705,5,874,21933.48685,0.978613,5763.258816,7144.805965,Malicious
10.0.2.15,55260,119.254.87.201,80,11,1579,6,705,5,874,6018.93664,1.358587,4151.371977,5146.523557,Malicious
10.0.2.15,34433,119.254.87.201,80,11,1579,6,705,5,874,6679.641779,2.082583,2708.175376,3357.36919,Malicious
172.30.15.1545,50854,180.179.41.214,443,17,4022,9,2863,8,1159,3543.534902,0.222608,102889.384,41651.69266,Benign
192.168.137.97,56144,52.205.114.175,443,7,478,4,272,3,206,374.1084826,8.346365911,260.7122697,197.4512042,Benign
192.168.137.97,60740,23.57.218.60,443,38,5306,19,2809,19,2497,0.868095512,403.1035977,55.7474558,49.55549916,Benign
172.30.1.136,50753,172.217.161.14,443,16,5047,7,943,9,4104,1900.328759,7.352545,1026.039283,4465.392595,Benign
172.30.6.255,56173,180.149.59.210,80,153,109920,96,86678,57,23242,435.051176,421.028072,1646.978067,441.6237595,Benign
10.0.2.15,38469,119.254.87.201,80,11,1513,6,705,5,808,8686.864935,2.062671,2734.318755,3133.800785,Malicious
192.168.43.224,49830,34.205.118.138,443,9,622,5,350,4,272,367.0521627,38.92019281,71.94208965,55.9092811,Benign
10.0.2.15,41351,119.254.87.201,80,11,1579,6,705,5,874,1722.191964,5.784263,975.0593982,1208.797041,Malicious
172.30.1.136,50505,104.113.230.86,443,54,11297,26,4897,28,6400,965.940624,60.71987,645.1924222,843.2165616,Benign
10.0.2.15,41671,119.254.87.201,80,11,1579,6,705,5,874,17431.62719,1.162781,4850.440453,6013.17015,Malicious
172.30.6.255,56787,103.243.220.231,80,16,6615,9,5414,7,1201,1253.84033,17.931353,2415.434017,535.8212512,Benign
172.30.15.2160,51472,52.42.237.125,443,6,348,4,228,2,120,4195.532963,2.142143,851.4837712,448.1493532,Benign
10.0.2.15,49410,119.254.87.201,80,11,1579,6,705,5,874,12801.13193,0.819389,6883.177587,8533.187534,Malicious
172.30.15.224,49452,122.15.34.26,80,3,162,2,108,1,54,33.483348,0.009351,92396.53513,46198.26756,Benign
192.168.43.233,51647,52.84.110.140,443,38,9455,19,2169,19,7286,855.704745,186.459424,93.06046124,312.604205,Benign
192.168.43.233,50706,172.217.166.206,443,162,45951,71,26208,91,19743,1843.191687,39.970862,5245.421027,3951.478454,Benign
192.168.42.240,51030,13.35.129.69,443,17,1015,13,751,4,264,502.205223,74.378503,80.77602745,28.39530126,Benign
172.30.6.255,58278,52.213.19.114,443,25,9669,13,4006,12,5663,5288.738447,35.380231,905.8165844,1280.489096,Benign
172.30.6.255,57707,103.243.221.87,80,26,16186,11,4324,15,11862,3712.841012,1.427242,24236.95491,66489.07473,Benign
192.168.43.224,58144,162.213.83.13,443,17,5055,10,1311,7,3744,93.42260845,13.46082226,779.1500253,2225.1241,Benign
172.30.6.255,57437,103.243.221.17,80,40,24411,23,20263,17,4148,2829.847916,31.183488,5198.392175,1064.152926,Benign
192.168.43.233,51422,23.100.69.251,443,8,482,4,230,4,252,3650.956042,126.517984,14.54338697,15.93449355,Benign
192.168.137.97,47608,157.240.16.39,443,9,598,5,338,4,260,96.09180604,106.1274169,25.47880725,19.5990825,Benign
10.0.2.15,50379,119.254.87.201,80,11,1579,6,705,5,874,14393.06665,1.092216,5163.813751,6401.66414,Malicious
172.30.6.255,57944,103.243.221.17,80,43,28150,20,12834,23,15316,4558.863436,28.188396,3642.349852,4346.753182,Benign
192.168.43.224,41894,23.251.156.28,443,843,671862,373,34114,470,637748,715.0087246,172.8830441,1578.593213,29511.18791,Benign
192.168.43.224,42010,23.251.156.28,443,1283,983221,603,58347,680,924874,1286.057781,472.5257165,987.8319502,15658.3901,Benign
192.168.43.224,46140,54.85.84.151,443,85,16490,44,3481,41,13009,32.96341278,950.4310503,29.30038953,109.4997896,Benign
10.0.2.15,33557,119.254.87.201,80,11,1579,6,705,5,874,21180.15131,1.373948,4104.958849,5088.984445,Malicious
192.168.43.224,33960,52.84.108.93,443,157,93244,81,10605,76,82639,2882.664635,175.6934175,482.8866169,3762.872903,Benign
192.168.43.224,35946,151.101.153.177,443,23,9368,13,1488,10,7880,2407.02834,16.36787786,727.2781544,3851.44614,Benign
192.168.43.233,51091,93.158.134.119,443,62,25884,32,12703,30,13181,916.719278,159.678733,636.4278955,660.3759813,Benign
172.30.15.2481,51815,14.139.45.128,80,235,209141,90,5495,145,203646,5424.714544,7.636911,5756.254067,213328.1375,Benign
192.168.137.97,52824,184.29.25.201,443,14,1667,8,1080,6,587,375.9811483,14.84014503,582.2045529,316.4389561,Benign
192.168.43.224,59914,172.217.166.194,443,11,754,6,412,5,342,1210.825807,39.21637973,84.0465138,69.76676631,Benign
192.168.137.97,53186,52.84.110.12,443,1693,1516044,654,44617,1039,1471427,355.9126942,193.6405712,1843.291402,60790.02933,Benign
172.30.15.672,49959,104.17.146.111,443,24,7212,12,1745,12,5467,2397.473161,8.714978,1601.839959,5018.486564,Benign
192.168.137.97,49526,217.12.15.54,443,5,334,3,206,2,128,375.802102,15.13575696,108.8812409,67.65436327,Benign
192.168.43.233,51175,151.101.153.170,443,25,8620,12,1880,13,6740,1038.721042,12.477212,1205.397488,4321.478228,Benign
172.30.15.2265,51582,104.121.244.70,443,365,316365,143,23588,222,292777,4487.747472,19.836025,9513.196318,118078.8994,Benign
10.0.2.15,39928,119.254.87.201,80,11,1513,6,705,5,808,16620.51353,3.079737,1831.325207,2098.880521,Malicious
172.30.6.255,56194,52.84.111.68,80,8,480,5,294,3,186,466.917745,23.934848,98.2667615,62.16876748,Benign
192.168.43.224,50538,23.251.156.28,443,1712,1435764,715,63953,997,1371811,479.1297177,325.1337228,1573.580235,33753.76723,Benign
192.168.43.224,37348,104.197.3.80,80,13,1109,6,503,7,606,1889.539961,1.955373448,2057.918913,2479.321791,Benign
172.30.15.2418,51752,14.139.45.128,80,486,444388,180,10803,306,433585,5351.022668,4.196041,20596.55756,826655.4116,Benign
172.30.15.747,50037,23.111.9.22,443,25,9087,14,1874,11,7213,2575.988768,10.175737,1473.308518,5670.744045,Benign
172.30.1.136,51550,204.79.197.213,443,17,1246,6,588,11,658,722.707945,18.021758,261.0178208,292.0913709,Benign
192.168.137.97,37122,52.206.174.32,443,23,7016,12,2582,11,4434,3030.626815,1.441537384,14329.14625,24607.06215,Benign
192.168.137.97,54696,172.217.161.3,443,15,1053,7,462,8,591,42.11201144,193.1506672,19.13532091,24.47830012,Benign
10.0.2.15,33822,119.254.87.201,80,11,1579,6,705,5,874,1243.73823,1.576944,3576.537911,4433.892389,Malicious
192.168.43.233,51196,52.175.18.194,443,40,12706,20,5243,20,7463,681.925025,75.283454,557.1476569,793.0560678,Benign
192.168.43.224,50938,23.251.156.28,443,282,205965,133,14266,149,191699,2533.432149,267.3613414,426.8679959,5736.027475,Benign
172.30.1.136,51826,172.217.160.227,443,36,4060,17,2257,19,1803,3098.894743,202.751961,89.05462572,71.14111217,Benign
192.168.215.49,36336,157.240.16.17,443,268,186631,119,10543,149,176088,119.2826647,75.17605142,1121.953048,18738.73359,Benign
172.30.6.255,57907,103.243.221.46,80,40,24340,23,20192,17,4148,4433.892964,13.169604,12265.8206,2519.741672,Benign
10.0.2.15,43529,119.254.87.201,80,11,1582,6,705,5,877,1123.624509,1.021896,5519.152634,6865.669305,Malicious
172.30.15.2531,51865,149.202.77.192,443,19,7793,10,1207,9,6586,5494.477948,3.521929,2741.679347,14959.98358,Benign
192.168.42.240,50907,172.217.161.14,80,5,283,3,163,2,120,7.234941,6.246954,208.7417324,153.674895,Benign
172.30.1.136,50270,104.17.161.9,443,8,492,4,252,4,240,481.958587,9.222856,218.5873877,208.1784645,Benign
172.25.29.44,60518,172.30.1.136,7680,9,585,6,411,3,174,1079.355361,0.310619,10585.31513,4481.374288,Benign
172.30.6.255,57125,172.217.166.206,443,17,1783,10,1154,7,629,1861.42382,68.748791,134.2859978,73.19401442,Benign
192.168.137.97,41570,54.210.3.254,443,32,8039,17,3218,15,4821,6806.424334,24.05591495,1070.173388,1603.264731,Benign
10.0.2.15,37918,119.254.87.201,80,11,1582,6,705,5,877,25985.68128,0.879619,6411.866956,7976.180596,Malicious
10.0.2.15,47224,119.254.87.201,80,11,1560,6,705,5,855,8391.38999,1.49275,3778.261598,4582.147044,Malicious
172.30.15.686,49973,184.29.32.107,443,23,10161,12,2849,11,7312,2399.271105,7.054953,3230.638106,8291.479759,Benign
192.168.43.224,37458,157.240.16.20,443,6,412,4,272,2,140,35.2722079,15.34182829,141.8344645,73.0030332,Benign
172.30.6.255,55818,18.207.56.96,80,7,402,4,228,3,174,90.877592,8.066094,226.131756,172.5742348,Benign
172.30.15.329,49597,52.175.23.79,443,30,10424,17,2375,13,8049,897.095709,92.029563,206.4553974,699.6882078,Benign
10.0.2.15,40301,119.254.87.201,80,11,1582,6,705,5,877,23017.73893,2.246545,2510.521712,3123.01779,Malicious
10.0.2.15,35435,119.254.87.201,80,11,1579,6,705,5,874,1453.934503,0.845501,6670.601218,8269.653141,Malicious
192.168.43.224,49800,172.217.166.195,443,41,7146,18,2246,23,4900,18.18651534,240.8167593,74.61274728,162.7793685,Benign
172.30.6.255,58463,172.217.166.206,80,10,886,6,542,4,344,5668.460208,60.758665,71.36430664,45.29395108,Benign
172.30.6.255,58034,35.190.43.164,80,35,10694,19,8224,16,2470,4811.481823,61.073845,1077.253282,323.5427539,Benign
172.30.6.255,57181,13.250.210.87,443,24,8880,12,1924,12,6956,2034.178165,65.652203,234.4475782,847.6181675,Benign
192.168.43.233,51179,13.107.4.52,80,10,1476,5,393,5,1083,632.333487,0.894642,3514.254864,9684.320656,Benign
172.30.6.255,58097,172.217.166.195,443,17,1779,11,1204,6,575,4873.073551,132.374074,72.76349295,34.75000701,Benign
172.30.15.575,49859,52.11.15.218,443,6,348,4,228,2,120,2256.483307,9.871344,184.7772705,97.25119497,Benign
172.30.6.255,56479,157.240.16.39,443,19,1933,10,1125,9,808,789.096771,61.064711,147.3846327,105.8549184,Benign
192.168.137.97,48996,172.217.194.189,443,30,6725,17,1909,13,4816,9491.514998,34.77113012,439.2149449,1108.045665,Benign
10.0.2.15,60774,119.254.87.201,80,11,1513,6,705,5,808,20699.5621,2.288066,2464.96386,2825.093332,Malicious
10.0.2.15,55976,119.254.87.201,80,11,1579,6,705,5,874,12383.28345,1.558319,3619.284627,4486.88619,Malicious
192.168.43.233,51127,182.161.72.84,443,4,240,2,120,2,120,921.387231,11.418307,84.07551137,84.07551137,Benign
192.168.137.97,39000,104.113.219.181,443,19,6436,11,2094,8,4342,1767.077517,3.038234983,5513.727573,11432.95374,Benign
172.30.6.255,58181,210.176.156.41,80,11,615,10,553,1,62,5024.097752,61.688978,71.71459381,8.040334207,Benign
192.168.215.49,50262,217.12.15.83,443,29,11837,16,3394,13,8443,612.5969904,26.46031702,1026.140389,2552.652712,Benign
10.0.2.15,60732,119.254.87.201,80,11,1582,6,705,5,877,11272.19061,1.749502,3223.774537,4010.284069,Malicious
10.0.2.15,57571,119.254.87.201,80,11,1582,6,705,5,877,1810.000481,1.679675,3357.79243,4176.998527,Malicious
172.30.6.255,58037,205.185.216.42,443,113,98011,39,3976,74,94035,4814.740746,4.150017,7664.546916,181271.5466,Benign
172.30.6.255,56900,217.12.15.54,443,25,9187,14,2856,11,6331,1384.954437,19.358461,1180.259113,2616.323684,Benign
10.0.2.15,39082,119.254.87.201,80,11,1582,6,705,5,877,12235.45222,1.632079,3455.715073,4298.811516,Malicious
10.0.2.15,46855,119.254.87.201,80,11,1582,6,705,5,877,17456.40885,2.023588,2787.128605,3467.108917,Malicious
172.30.6.255,56733,157.240.16.39,443,23,5047,11,2174,12,2873,1222.886708,19.588962,887.8469416,1173.313828,Benign
192.168.137.97,34366,172.217.161.3,443,19,2335,14,1760,5,575,226.1382114,78.39670478,179.5993855,58.67593559,Benign
172.30.6.255,57698,103.243.221.87,80,40,24311,23,20155,17,4156,3678.860034,34.187535,4716.338864,972.5182,Benign
172.30.6.255,58271,103.231.98.53,80,19,6478,10,5744,9,734,5287.842168,36.225113,1268.512261,162.097493,Benign
10.0.2.15,42282,119.254.87.201,80,11,1579,6,705,5,874,20371.82512,1.876412,3005.73648,3726.260544,Malicious
10.0.2.15,59818,119.254.87.201,80,11,1579,6,705,5,874,25357.93942,2.840111,1985.837877,2461.87561,Malicious
10.0.2.15,40654,119.254.87.201,80,11,1582,6,705,5,877,9738.009272,1.81751,3103.146613,3860.226354,Malicious
172.30.15.1961,51273,34.205.118.138,443,38,8194,20,3188,18,5006,4074.017387,3.522139,7241.054371,11370.36329,Benign
172.30.15.2128,51440,34.192.10.179,443,6,348,4,228,2,120,4178.425093,9.204925,198.1547921,104.2919959,Benign
10.0.2.15,59564,119.254.87.201,80,11,1579,6,705,5,874,12983.91613,1.510466,3733.947007,4629.035013,Malicious
192.168.137.97,46868,52.84.110.71,443,26,8095,15,1625,11,6470,42.6298348,17.40957767,746.7154143,2973.076142,Benign
172.30.6.255,56242,103.243.221.17,80,47,30171,30,26025,17,4146,527.864189,38.790294,5367.322042,855.0592579,Benign
192.168.137.97,54648,52.91.99.99,443,26,3484,13,2153,13,1331,375.1254622,6.357613016,2709.192893,1674.842425,Benign
172.30.6.255,56698,210.176.156.41,80,9,520,7,392,2,128,1156.108415,134.213492,23.36575819,7.629635328,Benign
10.0.2.15,40925,119.254.87.201,80,11,1579,6,705,5,874,12173.12201,1.386728,4067.1278,5042.084677,Malicious
192.168.137.97,59350,157.240.16.20,443,22,5595,12,1381,10,4214,466.742567,101.6002286,108.7399129,331.8102772,Benign
10.0.2.15,38389,119.254.87.201,80,11,1579,6,705,5,874,98.164168,2.02058,2791.277752,3460.392561,Malicious
172.30.15.2224,51539,184.29.25.145,443,6,348,4,228,2,120,4445.055295,2.535976,719.249709,378.5524784,Benign
192.168.137.97,41598,52.76.199.39,443,24,7749,14,2770,10,4979,29.04717013,67.65560102,327.5412481,588.746525,Benign
172.30.1.136,51522,52.84.108.135,443,21556,19690076,8127,477271,13429,19212805,25.140293,450.946035,8467.017567,340844.4206,Benign
10.0.2.15,33011,119.254.87.201,80,11,1579,6,705,5,874,9560.631186,0.963494,5853.694989,7256.921164,Malicious
172.30.15.1099,50405,50.7.77.122,443,24,8947,11,1855,13,7092,3453.786705,5.267771,2817.130813,10770.39985,Benign
10.0.2.15,47686,119.254.87.201,80,11,1544,6,705,5,839,18843.2292,4.482259,1258.294088,1497.459205,Malicious
192.168.137.97,36366,172.217.161.8,443,23,1622,13,898,10,724,9504.513321,40.81120874,176.0300717,141.921795,Benign
192.168.43.224,33726,34.207.29.244,443,10,672,6,412,4,260,304.5839271,43.86793542,75.134605,47.41504199,Benign
172.30.15.2325,51656,52.55.184.84,443,22,5398,11,2697,11,2701,5074.846023,3.04385,7088.391346,7098.904348,Benign
10.0.2.15,39633,119.254.87.201,80,11,1579,6,705,5,874,5298.192121,1.795344,3141.459241,3894.518265,Malicious
192.168.137.97,41996,104.197.3.80,80,10,911,5,425,5,486,2881.529599,1.052668921,3229.88542,3693.468974,Benign
10.0.2.15,41632,119.254.87.201,80,11,1579,6,705,5,874,17606.46947,0.820441,6874.351721,8522.245963,Malicious
10.0.2.15,56085,119.254.87.201,80,11,1582,6,705,5,877,4785.56907,0.963668,5852.638045,7280.515696,Malicious
172.30.6.255,56648,103.243.221.17,80,13,5328,9,4254,4,1074,1071.848946,19.218108,1770.829886,447.0783492,Benign
10.0.2.15,32814,119.254.87.201,80,11,1582,6,705,5,877,7635.919308,2.087006,2702.43593,3361.753632,Malicious
192.168.137.97,50888,103.211.218.251,443,80,54021,39,5370,41,48651,621.31855,13.0101291,3302.042559,29915.7677,Benign
172.30.15.2055,51367,52.69.95.24,443,24,7853,11,1943,13,5910,4094.378667,3.214295,4835.897141,14709.29084,Benign
172.30.15.1209,50517,217.156.250.128,80,9,1391,6,825,3,566,3466.584813,10.948188,602.8394836,413.5844215,Benign
10.0.2.15,49490,119.254.87.201,80,11,1513,6,705,5,808,11034.38209,1.820466,3098.107847,3550.739206,Malicious
192.168.43.224,48718,104.25.219.21,443,20,6589,11,1195,9,5394,215.0884797,85.20277482,112.2029185,506.4623786,Benign
192.168.43.233,51004,104.244.42.200,443,108,14440,56,5969,52,8471,527.502925,1481.745043,32.22686671,45.73526351,Benign
10.0.2.15,40218,119.254.87.201,80,11,1582,6,705,5,877,6319.259853,1.815216,3107.06825,3865.104759,Malicious
192.168.43.233,51668,54.172.100.225,443,25,8967,12,1327,13,7640,870.212053,23.734877,447.2742791,2575.113408,Benign
172.30.6.255,58227,157.240.16.39,443,5,330,1,66,4,264,5181.087859,15.061066,35.05727948,140.2291179,Benign
172.30.1.136,50165,172.217.161.3,443,7,402,4,228,3,174,165.948122,18.331485,99.50094059,75.93492835,Benign
10.0.2.15,42432,119.254.87.201,80,11,1582,6,705,5,877,24699.60455,2.127729,2650.713507,3297.412405,Malicious
172.30.6.255,58365,172.217.166.197,443,48,19310,26,6074,22,13236,5474.426005,85.768732,566.5467924,1234.575789,Benign
172.30.1.136,51540,204.79.197.213,443,2,132,2,132,0,0,701.64765,2.999746,352.0298052,0,Benign
192.168.43.224,35962,151.101.153.177,443,11,766,7,478,4,288,2425.071454,13.07297693,292.511799,176.2414187,Benign
172.30.15.691,49978,23.56.25.39,443,8,480,5,294,3,186,2402.028242,4.29904,547.0988872,346.1237858,Benign
172.30.15.479,49754,172.217.166.196,443,22,5568,11,1374,11,4194,1730.0567,1.452887,7565.626232,23093.33073,Benign
172.30.6.255,56688,103.243.220.231,80,23,13284,10,5284,13,8000,1155.904018,13.695413,3086.580887,4673.097482,Benign
192.168.43.233,51337,52.84.110.2,443,31,9900,16,2430,15,7470,3078.628957,193.414281,100.5096413,308.9740824,Benign
172.30.15.869,50175,54.85.78.249,80,10,1259,6,751,4,508,3434.604226,2.584592,2324.544841,1572.395179,Benign
10.0.2.15,50924,119.254.87.201,80,11,1579,6,705,5,874,731.305784,1.755068,3213.5507,3983.891222,Malicious
172.30.6.255,57844,103.243.221.51,80,40,25802,24,21708,16,4094,4205.843253,18.22446,9529.171235,1797.145155,Benign
172.30.6.255,58393,35.190.41.40,443,136,33272,59,9537,77,23735,5526.225334,22.84092,3340.320793,8313.150258,Benign
192.168.43.233,50717,172.217.166.206,443,25,8692,12,1729,13,6963,1843.414525,12.52282,1104.543545,4448.199367,Benign
192.168.43.233,50720,172.217.166.208,443,18,5609,9,1285,9,4324,1844.209609,13.02408,789.307191,2656.003342,Benign
10.0.2.15,52431,119.254.87.201,80,11,1579,6,705,5,874,13344.26332,1.631477,3456.9902,4285.687141,Malicious
172.30.15.980,50286,52.0.128.155,80,6,348,4,228,2,120,3442.630759,4.631623,393.8144361,207.2707558,Benign
172.30.6.255,55927,103.231.98.48,80,7,402,4,228,3,174,122.209035,29.721673,61.36935831,46.83451029,Benign
192.168.43.233,51311,52.84.110.71,443,11,644,6,350,5,294,3031.267771,122.910927,22.78072478,19.13580881,Benign
192.168.43.233,51008,117.18.232.102,443,6,348,4,228,2,120,546.539631,24.812949,73.5100048,38.68947621,Benign
192.168.137.97,37836,172.217.194.189,443,114,21034,56,7292,58,13742,345.5765536,733.3807168,79.54395128,149.9030415,Benign
172.30.15.1130,50438,104.20.15.243,80,7,402,4,228,3,174,3458.300782,8.921474,204.4505202,156.0280286,Benign
172.30.15.1549,50858,180.179.41.214,443,17,4015,9,2856,8,1159,3550.098644,0.232222,98388.6109,39927.31094,Benign
172.30.6.255,58145,216.58.196.194,80,72,20359,37,11391,35,8968,4950.813185,163.181425,558.4459138,439.6578839,Benign
172.30.6.255,57077,54.194.27.245,443,12,1416,6,904,6,512,1680.753829,15.219959,475.1655376,269.1203045,Benign
192.168.43.233,51498,198.252.206.25,443,34,4359,19,3076,15,1283,3834.04698,240.986499,102.1136043,42.59159763,Benign
172.30.15.621,49908,23.198.105.137,443,40,16487,18,2205,22,14282,2391.513985,4.791401,3681.595425,23846.05254,Benign
172.30.6.255,56402,23.198.140.217,80,10,1736,5,780,5,956,650.868515,0.611283,10208.03785,12511.38998,Benign
192.168.43.233,51086,182.161.72.131,443,4,240,2,120,2,120,916.41173,10.749818,89.30383752,89.30383752,Benign
192.168.215.49,37892,158.85.224.176,443,1343,473944,696,63461,647,410483,26.62327258,2099.403161,241.8249193,1564.189318,Benign
172.30.15.1940,51252,52.6.46.142,443,6,348,4,228,2,120,4026.84378,0.670213,2721.522859,1432.380452,Benign
172.30.6.255,57927,103.243.220.231,80,16,5452,9,4225,7,1227,4488.860437,11.199831,3017.902681,876.4417963,Benign
192.168.43.233,50930,49.44.178.243,80,14,828,7,414,7,414,433.532223,19.483702,169.9882291,169.9882291,Benign
10.0.2.15,48187,119.254.87.201,80,11,1579,6,705,5,874,15233.97441,1.224823,4604.746972,5708.579934,Malicious
192.168.43.233,51252,172.217.160.229,443,44,7270,21,4211,23,3059,2266.365376,242.306565,139.0304881,100.9960254,Benign
172.30.6.255,56997,103.231.98.53,80,91,47348,48,43126,43,4222,1483.849306,180.075761,1915.904717,187.5654992,Benign
10.0.2.15,60845,119.254.87.201,80,11,1582,6,705,5,877,1451.98797,1.363969,4134.991338,5143.811919,Malicious
192.168.43.233,51427,104.131.222.33,80,260,225049,104,10572,156,214477,3788.457016,28.673306,2949.64243,59840.18725,Benign
192.168.137.97,44268,140.98.193.112,443,31,14123,17,4451,14,9672,79.26209502,18.13946235,1963.012978,4265.617058,Benign
10.0.2.15,37339,119.254.87.201,80,11,1582,6,705,5,877,14425.39764,1.558186,3619.593553,4502.671696,Malicious
192.168.43.233,51165,103.243.221.51,443,11,611,6,337,5,274,952.367276,60.740107,44.38582895,36.08818141,Benign
192.168.43.233,51154,35.171.204.130,443,7,402,4,228,3,174,927.579131,12.378277,147.3549186,112.4550695,Benign
10.0.2.15,45657,219.234.85.243,80,11,1344,6,792,5,552,51.675487,1.820714,3479.953469,2425.422115,Malicious
192.168.42.240,50949,13.35.130.15,443,17,1002,9,510,8,492,179.534353,32.137903,126.9529004,122.4722098,Benign
172.30.6.255,58275,180.149.59.232,80,12,4896,8,3669,4,1227,5288.004411,35.955534,816.3416513,273.0038719,Benign
10.0.2.15,40328,119.254.87.201,80,11,1579,6,705,5,874,15746.70199,2.026115,2783.652458,3450.939359,Malicious
192.168.215.49,47152,173.241.248.143,443,25,5375,14,1937,11,3438,480.1274595,60.79126186,254.9050559,452.4334446,Benign
10.0.2.15,39907,119.254.87.201,80,11,1513,6,705,5,808,9140.155664,1.076317,5240.091906,6005.665617,Malicious
192.168.43.224,39646,172.217.194.189,443,7,478,4,272,3,206,96.69170025,14.12702468,154.0310185,116.6558449,Benign
10.0.2.15,56749,119.254.87.201,80,11,1587,6,705,5,882,3163.961329,128.340946,43.94544513,54.97855688,Malicious
172.30.1.136,51764,172.217.160.228,443,9,534,5,294,4,240,2948.880009,16.949649,138.7639355,113.276682,Benign
10.0.2.15,59074,119.254.87.201,80,11,1582,6,705,5,877,19771.33738,2.212352,2549.323073,3171.285582,Malicious
10.0.2.15,49764,119.254.87.201,80,12,1653,7,779,5,874,3221.71582,3.849956,1618.719798,1816.124652,Malicious
172.30.6.255,57532,103.243.220.231,80,22,11002,10,4552,12,6450,3133.852901,14.181885,2567.782774,3638.444396,Benign
192.168.43.224,39060,103.37.200.184,443,38,18386,20,3220,18,15166,2508.841146,7.403304812,3479.527137,16388.3567,Benign
192.168.137.97,40842,18.211.26.179,443,27,3019,16,2072,11,947,67.54468221,18.69881254,886.4734038,405.1594177,Benign
172.30.15.1361,50669,104.24.246.16,443,22,9720,12,1898,10,7822,3493.250511,3.767779,4029.960356,16608.19278,Benign
172.30.6.255,58119,157.240.16.39,443,113,47204,56,11496,57,35708,4894.929778,4.131979,22257.61554,69134.9109,Benign
192.168.43.233,51010,163.53.78.128,443,68,32896,38,22706,30,10190,565.913026,118.828026,1528.662944,686.0334447,Benign
10.0.2.15,47690,119.254.87.201,80,11,1582,6,705,5,877,11900.32662,1.518931,3713.137726,4619.037994,Malicious
192.168.43.224,43862,52.84.108.114,443,11,746,8,544,3,202,29.06565726,27.22216525,159.8697224,59.36338955,Benign
172.30.15.2323,51653,52.84.108.208,443,35,18415,17,3496,18,14919,5042.115726,5.579815,5012.35256,21389.95648,Benign
172.30.15.2032,51344,157.240.16.39,443,44,10164,21,4298,23,5866,4090.57771,6.781151,5070.525638,6920.359095,Benign
10.0.2.15,38341,119.254.87.201,80,11,1579,6,705,5,874,13311.74657,1.896481,2973.929082,3686.828394,Malicious
192.168.43.224,58640,172.217.167.14,443,15,1030,8,536,7,494,36.8070002,13.22202047,324.3074695,298.895317,Benign
10.0.2.15,33232,119.254.87.201,80,11,1579,6,705,5,874,21726.38371,2.151202,2621.79005,3250.275892,Malicious
172.30.15.1156,50464,180.149.59.136,80,60,51179,22,2301,38,48878,3459.399106,7.633118,2411.596414,51227.29663,Benign
172.30.15.643,49930,192.0.76.3,80,11,1327,6,830,5,497,2394.770295,1.3908,4774.230659,2858.78631,Benign
192.168.43.233,50899,50.16.219.101,443,13,765,7,405,6,360,216.732205,154.845648,20.92406239,18.59916657,Benign
192.168.43.233,51234,188.138.1.175,843,11,923,6,359,5,564,1537.235113,0.684878,4193.447592,6588.034657,Benign
172.30.6.255,55833,103.231.98.48,80,7,402,4,228,3,174,91.721887,10.255955,177.8478942,135.7260245,Benign
10.0.2.15,53471,119.254.87.201,80,11,1579,6,705,5,874,3764.523739,1.552603,3632.609238,4503.404927,Malicious
172.30.15.1946,51258,18.215.97.76,443,6,348,4,228,2,120,4027.63286,9.828581,185.5812146,97.67432349,Benign
192.168.43.224,47552,52.20.111.213,443,36,7751,19,2940,17,4811,56.82241863,62.87213721,374.0925797,612.1630616,Benign
192.168.43.233,51305,104.244.42.194,443,17,1972,9,1066,8,906,2532.246361,59.328173,143.7428387,122.1679285,Benign
192.168.137.97,45816,52.84.110.78,443,10,700,6,412,4,288,73.32234461,15.51450683,212.4463276,148.5061707,Benign
172.30.6.255,56691,173.241.248.220,80,22,8835,12,4421,10,4414,1155.905173,86.223983,410.1874997,409.5380284,Benign
172.30.15.372,49640,62.210.213.13,80,20,9827,9,893,11,8934,1443.09184,7.462034,957.3797171,9578.085546,Benign
192.168.43.224,59206,104.197.3.80,80,13,1125,7,565,6,560,3023.813604,5.639287328,801.51972,794.4266251,Benign
192.168.137.97,41650,172.217.194.188,443,46,8661,25,2705,21,5956,3466.878757,579.3448859,37.35253478,82.24462002,Benign
192.168.43.224,45038,172.82.254.215,443,5,334,3,206,2,128,3267.513884,47.41881487,34.75413725,21.59480373,Benign
172.30.6.255,57040,103.243.221.51,80,6,340,4,228,2,112,1594.092547,16.274305,112.0785189,55.05611453,Benign
192.168.137.97,51124,52.84.110.84,443,8,552,5,338,3,214,291.6725019,13.04294193,207.3151913,131.2587306,Benign
172.30.6.255,56718,172.30.10.168,139,3,198,3,198,0,0,1183.717399,9.006366,175.8755973,0,Benign
172.30.1.136,50616,157.240.16.17,443,10,660,3,198,7,462,1618.580012,34.620667,45.75301799,106.757042,Benign
172.30.15.911,50217,157.240.16.37,443,49,22735,22,2305,27,20430,3439.703232,7.298065,2526.697145,22394.9773,Benign
172.30.15.1175,50483,172.217.167.2,80,16,4183,9,2467,7,1716,3463.660295,3.3721,5852.732718,4071.053646,Benign
192.168.137.97,51742,172.217.161.3,443,16,2049,11,1563,5,486,3759.494627,107.1192122,116.7297606,36.29601002,Benign
192.168.42.240,50906,104.20.42.93,443,4,229,3,163,1,66,7.560692,5.833573,223.5336731,90.51056702,Benign
172.30.1.136,50678,172.217.161.14,443,29,11777,17,2563,12,9214,1804.213023,24.680505,830.777166,2986.648774,Benign
172.30.1.136,50274,104.17.37.113,443,20,3044,10,1750,10,1294,482.652201,9.680762,1446.167151,1069.33731,Benign
10.0.2.15,34847,119.254.87.201,80,11,1582,6,705,5,877,11750.15462,2.548875,2212.740915,2752.586926,Malicious
172.30.6.255,56338,52.114.76.35,443,25,11987,16,5458,9,6529,602.435243,3.157293,13829.56856,16543.28566,Benign
172.30.15.436,49710,59.63.81.183,443,45,17447,22,3184,23,14263,1623.838247,7.062013,3606.903584,16157.43273,Benign
10.0.2.15,46347,119.254.87.201,80,11,1579,6,705,5,874,14302.97478,1.511089,3732.407555,4627.126529,Malicious
10.0.2.15,47068,119.254.87.201,80,11,1513,6,705,5,808,15536.47687,1.676348,3364.456545,3856.00126,Malicious
172.30.15.1532,50840,23.8.189.227,443,72,47698,28,3215,44,44483,3528.090444,8.924497,2881.95514,39874.96438,Benign
192.168.43.224,44952,172.217.166.196,443,5,318,3,198,2,120,0.79891711,12.84501279,123.3163428,74.73717744,Benign
192.168.137.97,37856,117.18.237.70,443,19,7131,11,1389,8,5742,1480.560769,0.083989414,132302.3875,546926.0686,Benign
172.30.6.255,56359,209.15.36.31,80,7,614,5,282,2,332,607.828521,24.019068,93.92537629,110.5788118,Benign
192.168.43.233,51326,172.217.161.8,443,21,5881,10,1351,11,4530,3365.907399,13.172218,820.5148138,2751.245083,Benign
192.168.43.224,39644,172.217.194.189,443,16,5444,9,1377,7,4067,96.44068466,14.22920755,774.1822561,2286.564441,Benign
10.0.2.15,38853,119.254.87.201,80,11,1582,6,705,5,877,158.278097,1.746015,3230.212799,4018.293085,Malicious
10.0.2.15,46904,119.254.87.201,80,11,1513,6,705,5,808,18693.2406,1.777291,3173.368908,3636.995855,Malicious
192.168.43.224,36660,169.55.74.36,443,1828,735081,945,92375,883,642706,350.4929379,2044.04809,361.5374822,2515.424184,Benign
172.30.15.1464,50772,4.78.226.233,443,7,398,4,228,3,170,3505.010638,2.235854,815.7956647,608.2686973,Benign
10.0.2.15,44355,119.254.87.201,80,11,1579,6,705,5,874,22173.80859,1.446428,3899.2608,4833.977218,Malicious
10.0.2.15,42906,119.254.87.201,80,12,1587,7,779,5,808,10911.76736,4.929514,1264.22199,1311.285453,Malicious
192.168.43.224,60960,54.243.243.77,443,285,217501,127,16207,158,201294,14.35417447,82.0859302,1579.515511,19617.88087,Benign
172.30.1.136,50539,172.217.160.238,443,30,11183,15,1916,15,9267,1247.174,78.013761,196.4781572,950.2938847,Benign
192.168.137.97,46344,172.217.160.227,443,24,6388,12,1591,12,4797,3802.441069,26.59376022,478.6085117,1443.045274,Benign
192.168.137.97,41674,104.197.3.80,80,10,911,5,425,5,486,781.5275408,0.841511308,4040.349747,4620.258769,Benign
192.168.43.233,51453,23.74.147.187,80,44,21681,24,3071,20,18610,3810.946239,233.901262,105.0357736,636.5078954,Benign
172.30.1.136,50781,157.240.16.16,443,32,7412,17,2770,15,4642,1925.108742,8.13758,2723.168313,4563.518884,Benign
172.30.6.255,58410,103.243.221.109,80,31,18208,18,15086,13,3122,5551.089268,8.139396,14827.63586,3068.532358,Benign
172.30.6.255,56169,103.231.98.53,80,187,96977,95,87985,92,8992,434.866675,383.079069,1837.427458,187.783687,Benign
10.0.2.15,52441,119.254.87.201,80,11,1582,6,705,5,877,9677.924275,1.487051,3792.741473,4718.062797,Malicious
10.0.2.15,54951,119.254.87.201,80,12,1656,7,779,5,877,21840.91474,4.107671,1517.161428,1708.023841,Malicious
172.30.6.255,58031,103.243.221.46,80,21,11287,11,9916,10,1371,4803.395543,0.667204,118896.1697,16438.75037,Benign
10.0.2.15,36785,119.254.87.201,80,11,1582,6,705,5,877,1572.195209,1.521574,3706.687943,4611.014647,Malicious
172.30.15.234,49503,23.198.126.238,443,17,6648,8,1325,9,5323,52.605377,0.65025,16301.42253,65488.65821,Benign
192.168.43.224,42042,23.251.156.28,443,12,1528,7,1038,5,490,1465.195454,16.35607353,507.7013126,239.6663229,Benign
172.30.1.136,51909,157.240.16.39,443,11,644,6,350,5,294,5587.970945,107.457865,26.05672465,21.88764871,Benign
172.30.6.255,56510,52.109.120.3,443,60,42979,34,24854,26,18125,831.542119,2.973652,66864.58267,48761.59013,Benign
192.168.137.97,52098,172.217.161.3,443,11,766,7,486,4,280,8268.738607,23.21582972,167.4719382,96.48589031,Benign
172.30.6.255,56274,157.240.16.39,443,57,18431,30,6834,27,11597,545.093303,122.056349,447.9242616,760.10794,Benign
10.0.2.15,47672,119.254.87.201,80,11,1582,6,705,5,877,14242.90073,1.553683,3630.084129,4515.721676,Malicious
172.30.1.136,50565,184.29.24.13,443,31,8986,17,1653,14,7333,1495.263217,62.036473,213.1649232,945.6372544,Benign
192.168.215.49,44334,172.217.161.5,443,46,8108,24,4804,22,3304,1050.814183,240.440372,159.8400455,109.9316216,Benign
172.30.15.2101,51413,34.205.118.138,443,20,3782,11,2543,9,1239,4146.127088,1.571411,12946.32658,6307.706895,Benign
192.168.137.97,48490,104.244.46.7,443,8,552,5,338,3,214,1747.941999,17.52407938,154.3019717,97.69414776,Benign
172.30.15.1769,51081,35.201.87.190,443,30,7428,15,2037,15,5391,3641.213244,5.957519,2735.366853,7239.255133,Benign
192.168.43.224,34202,172.217.166.206,443,8,540,5,346,3,194,941.6913375,58.13931817,47.60977747,26.6944995,Benign
172.30.1.136,50774,34.225.100.237,443,12,7050,5,799,7,6251,1921.117163,1.224802,5218.802713,40829.45652,Benign
172.30.6.255,58192,210.176.156.41,80,14,5527,8,3969,6,1558,5089.846708,24.22377,1310.778628,514.535929,Benign
172.30.15.740,50029,157.240.16.52,443,27,4178,14,1841,13,2337,2537.329813,8.880718,1658.424465,2105.235185,Benign
172.30.6.255,56755,184.29.25.174,443,16,7773,9,1029,7,6744,1244.637254,0.575213,14311.22037,93794.82035,Benign
192.168.43.224,42134,157.240.16.20,443,11,730,6,404,5,326,1210.266173,41.53903089,77.80634094,62.78432462,Benign
192.168.43.233,51476,54.81.94.76,80,18,2573,10,1602,8,971,3816.314166,232.856789,55.03812045,33.3595599,Benign
192.168.43.224,52246,192.0.73.2,443,31,9653,17,1615,14,8038,1901.782089,12.92867946,999.3286659,4973.748493,Benign
172.30.15.1105,50413,180.149.59.138,80,24,17313,10,1794,14,15519,3458.262633,8.769648,1636.553713,14157.01063,Benign
172.30.15.1668,50979,103.254.155.35,443,21,9523,11,3550,10,5973,3591.153757,6.300007,4507.931499,7584.753477,Benign
172.30.15.730,50017,162.125.248.4,443,6,348,4,228,2,120,2434.342568,0.174014,10481.91525,5516.797499,Benign
172.30.6.255,57489,74.125.68.188,5228,96,7000,51,3654,45,3346,3052.028371,1822.386307,16.04050683,14.68843346,Benign
10.0.2.15,53397,119.254.87.201,80,11,1593,6,705,5,888,13134.03513,1.911875,2949.983655,3715.724093,Malicious
192.168.43.224,37498,157.240.16.20,443,12,832,5,354,7,478,39.29705943,4.842585547,584.8115583,789.6608047,Benign
172.30.6.255,58008,103.243.221.75,80,17,6561,9,5306,8,1255,4744.483492,15.607715,2719.680619,643.2716128,Benign
10.0.2.15,40190,219.234.85.216,80,9,1379,5,1123,4,256,90.288267,62.142903,144.5700083,32.95629752,Malicious
172.30.15.2384,51718,14.139.45.128,80,11,1450,5,663,6,787,5334.872006,2.291901,2314.236086,2747.064555,Benign
10.0.2.15,45722,119.254.87.201,80,11,1579,6,705,5,874,3075.660908,1.420469,3970.519596,4922.31791,Malicious
172.30.15.557,49841,23.8.185.154,443,6,348,4,228,2,120,2252.850562,3.244139,562.2447127,295.9182698,Benign
172.30.1.136,51772,204.79.197.200,443,47,13619,22,2687,25,10932,2973.487901,40.513097,530.5938472,2158.709318,Benign
172.30.6.255,55835,74.125.11.41,443,7,402,4,228,3,174,98.971286,10.873067,167.7539557,128.0227557,Benign
172.30.15.1455,50763,103.231.98.43,443,7,402,4,228,3,174,3502.387027,4.683381,389.4622282,297.2211742,Benign
172.30.15.2024,51336,52.218.248.232,443,7,409,4,228,3,181,4090.304323,7.338638,248.5474825,197.3118173,Benign
10.0.2.15,36792,119.254.87.201,80,11,1582,6,705,5,877,15028.74413,0.987417,5711.872492,7105.407341,Malicious
172.30.15.1887,51199,52.6.46.142,443,24,4968,13,3437,11,1531,3968.590307,8.881457,3095.888434,1379.053009,Benign
192.168.215.49,48616,172.217.161.4,443,16,4527,9,1212,7,3315,9.219981196,16.14421621,600.5866047,1642.69356,Benign
10.0.2.15,44083,119.254.87.201,80,11,1579,6,705,5,874,22233.90339,1.448004,3895.016865,4828.715943,Malicious
172.30.1.136,51800,72.247.219.151,443,23,7768,10,3469,13,4299,2977.493049,3.114757,8909.844331,11041.63182,Benign
172.30.6.255,58225,172.217.167.2,80,63,17775,33,9958,30,7817,5174.951657,84.067075,947.6242631,743.8821917,Benign
192.168.215.49,38594,104.113.142.99,443,145,92095,66,6798,79,85297,1251.962361,589.6291163,92.23425116,1157.296987,Benign
192.168.43.233,51466,35.177.238.167,80,9,534,5,294,4,240,3815.894435,13.353028,176.1398239,143.7876113,Benign
172.30.6.255,56930,54.169.236.196,80,6,535,4,228,2,307,1387.023025,17.414571,104.7398756,141.0313237,Benign
172.30.1.136,50173,172.217.161.2,443,20,5086,10,1340,10,3746,263.999943,61.058181,175.5702483,490.8105598,Benign
192.168.43.233,50722,172.217.166.202,443,18,4842,9,1285,9,3557,1844.586403,12.694636,809.7908439,2241.576679,Benign
192.168.215.49,36244,52.84.110.243,443,17,5820,9,1257,8,4563,630.644774,19.14279649,525.3150972,1906.931415,Benign
192.168.137.97,56428,172.217.161.14,443,7,466,4,272,3,194,989.839119,52.07497362,41.78590691,29.8031836,Benign
172.30.1.136,51794,54.255.158.169,443,14,1626,7,1009,7,617,2977.307357,3.325835,2427.059671,1484.13857,Benign
172.30.6.255,58316,35.190.43.164,80,10,1629,6,1175,4,454,5354.084978,4.935766,1904.466298,735.853361,Benign
172.30.6.255,58048,172.217.31.2,80,18,4089,10,2319,8,1770,4819.466049,53.085458,349.4742383,266.7397162,Benign
10.0.2.15,33118,119.254.87.201,80,11,1579,6,705,5,874,24513.91093,0.986026,5719.930306,7091.090904,Malicious
172.30.6.255,57753,172.217.24.226,80,21,2751,11,1253,10,1498,3855.594328,247.273416,40.53812238,48.46457089,Benign
172.30.6.255,55948,54.251.146.208,443,45,14478,22,4656,23,9822,154.000614,72.677265,512.5124067,1081.163415,Benign
172.30.15.719,50006,104.20.185.29,443,27,6222,14,1883,13,4339,2409.004401,7.184777,2096.655192,4831.326011,Benign
192.168.137.97,50886,103.211.218.251,443,48,27505,25,4522,23,22983,621.3175429,13.01106254,2780.403206,14131.35933,Benign
10.0.2.15,56703,119.254.87.201,80,12,1667,7,779,5,888,13677.08025,4.383287,1421.764078,1620.701542,Malicious
10.0.2.15,60349,119.254.87.201,80,11,1582,6,705,5,877,11332.25023,1.227249,4595.644405,5716.851267,Malicious
172.30.6.255,55968,52.220.13.130,443,7,402,4,228,3,174,166.099612,10.531148,173.2004906,132.1793218,Benign
192.168.137.97,57122,104.197.3.80,80,13,1125,7,565,6,560,3623.812181,7.057729332,640.4326076,634.7650624,Benign
172.30.6.255,57719,157.240.16.39,443,26,5276,14,3221,12,2055,3717.09203,61.029658,422.2209471,269.3772264,Benign
172.30.1.136,50547,157.240.16.39,443,89,32280,46,11800,43,20480,1451.051513,120.374353,784.2202068,1361.087274,Benign
10.0.2.15,44050,119.254.87.201,80,11,1513,6,705,5,808,1934.491931,1.224144,4607.301102,5280.424525,Malicious
192.168.43.233,51070,52.70.107.220,443,9,534,5,294,4,240,898.244145,18.704303,125.7464659,102.6501763,Benign
172.30.15.961,50267,35.201.85.114,80,16,4604,9,1905,7,2699,3442.260913,4.747106,3210.377017,4548.455417,Benign
172.30.6.255,58012,195.201.82.80,80,10,2505,6,1038,4,1467,4759.887795,14.135109,587.4733615,830.2730456,Benign
192.168.43.224,39776,54.243.243.77,443,8,544,5,338,3,206,406.1011523,73.22839576,36.92556654,22.50493108,Benign
10.0.2.15,52964,119.254.87.201,80,11,1582,6,705,5,877,4126.811711,1.849809,3048.963434,3792.824016,Malicious
172.30.6.255,56581,204.79.197.200,443,27,8860,12,1079,15,7781,897.057555,109.60591,78.75487736,567.9255799,Benign
172.30.15.256,49458,111.221.29.13,443,3,162,2,108,1,54,69.129195,0.184019,4695.167347,2347.583673,Benign
192.168.215.49,36664,54.173.224.161,443,14,1660,8,1080,6,580,613.6429349,17.18783067,502.681238,269.9584426,Benign
172.30.15.1278,50586,104.18.255.119,443,15,5802,8,1025,7,4777,3469.552359,7.395745,1108.745637,5167.295519,Benign
192.168.42.240,50901,172.217.163.67,443,20,1345,9,514,11,831,36.393064,152.587489,26.94847413,43.56844748,Benign
172.30.6.255,55991,103.243.221.46,80,21,9609,11,8271,10,1338,183.912841,30.121693,2196.689276,355.3585119,Benign
192.168.137.97,57810,23.111.9.35,443,138,91456,68,4876,70,86580,420.9993172,30.44546138,1281.241874,22750.18898,Benign
10.0.2.15,51454,119.254.87.201,80,11,1513,6,705,5,808,7185.458166,0.81884,6887.792487,7894.094084,Malicious
172.30.6.255,56377,103.243.221.46,80,14,6401,10,5337,4,1064,631.879888,3.575169,11942.37251,2380.866471,Benign
10.0.2.15,35046,119.254.87.201,80,11,1513,6,705,5,808,5564.004863,1.810732,3114.762428,3569.827009,Malicious
192.168.43.233,51430,104.131.222.33,80,389,338591,153,12030,236,326561,3790.80271,27.099299,3551.383377,96404.26492,Benign
10.0.2.15,57535,119.254.87.201,80,11,1582,6,705,5,877,14278.03253,1.464736,3850.523234,4789.941669,Malicious
172.30.6.255,57956,103.243.221.17,80,22,11039,10,4562,12,6477,4586.859678,15.233993,2395.694944,3401.340673,Benign
10.0.2.15,35133,119.254.87.201,80,11,1582,6,705,5,877,5087.86763,1.417982,3977.483494,4947.87663,Malicious
192.168.137.97,57696,104.197.3.80,80,11,977,6,491,5,486,8423.812814,1.728545184,2272.431196,2249.290349,Benign
192.168.43.233,50902,172.217.166.195,443,20,5798,10,1339,10,4459,294.811627,40.182038,266.5867769,887.7598493,Benign
192.168.43.224,35040,34.232.42.95,443,565,486881,230,35253,335,451628,3015.333046,25.78116534,10939.14865,140141.9972,Benign
192.168.137.97,53994,210.176.156.41,443,15,810,8,432,7,378,7.040004738,267.9219389,12.8992796,11.28686965,Benign
192.168.43.224,36434,18.215.97.76,443,16,4978,9,1245,7,3733,358.1961528,12.53920417,794.308783,2381.650351,Benign
10.0.2.15,36119,119.254.87.201,80,11,1579,6,705,5,874,16470.36893,1.419811,3972.359701,4924.599119,Malicious
192.168.137.97,60644,172.217.161.4,443,56,6660,27,3951,29,2709,9529.186443,255.0114573,123.9473721,84.9844169,Benign
172.30.1.136,50223,52.84.103.186,443,18,3666,12,3282,6,384,385.107439,45.55934,576.3033442,67.42854484,Benign
192.168.43.233,51245,172.217.160.238,443,10,590,6,350,4,240,1804.570102,103.897181,26.94972061,18.47980842,Benign
192.168.43.233,51218,172.217.160.238,443,26,7290,10,1352,16,5938,1510.927823,273.702836,39.51731066,173.5604961,Benign
172.30.6.255,58079,205.185.216.42,443,9971,9307614,3609,227144,6362,9080470,4849.415369,128.947316,14092.20491,563360.0005,Benign
10.0.2.15,54320,119.254.87.201,80,11,1582,6,705,5,877,4755.505063,1.622022,3477.141494,4325.465376,Malicious
192.168.43.233,51441,192.0.73.2,80,20,8010,10,1053,10,6957,3802.208702,89.08168,94.56489819,624.7749257,Benign
172.30.15.1520,50828,34.199.78.214,443,34,15504,18,2722,16,12782,3525.915317,1.28663,16924.83465,79475.83999,Benign
172.30.15.964,50270,159.127.41.169,443,6,344,4,228,2,116,3442.33812,4.925907,370.287137,188.3917013,Benign
10.0.2.15,58742,119.254.87.201,80,11,1582,6,705,5,877,15987.02411,2.364564,2385.21774,2967.143203,Malicious
172.30.15.716,50003,35.190.14.224,80,14,3397,8,2711,6,686,2406.748367,9.441326,2297.134958,581.2742829,Benign
192.168.137.97,38758,104.244.42.136,443,43,2918,22,1440,21,1478,23.68000723,853.6016339,13.49575674,13.85189476,Benign
172.30.6.255,56041,210.176.156.35,80,22,7588,12,4480,10,3108,254.310392,157.91723,226.9543355,157.4495703,Benign
10.0.2.15,60504,119.254.87.201,80,11,1582,6,705,5,877,4272.823639,1.958298,2880.051963,3582.702939,Malicious
10.0.2.15,37335,119.254.87.201,80,11,1593,6,705,5,888,2354.87242,1.568343,3596.152117,4529.62139,Malicious
10.0.2.15,43418,119.254.87.201,80,11,1587,6,705,5,882,6825.191611,0.857056,6580.666841,8232.834261,Malicious
172.30.15.631,49918,23.198.105.137,443,19,6259,10,1333,9,4926,2392.882161,3.218569,3313.273694,12243.95065,Benign
172.30.6.255,57129,103.243.221.75,80,49,34198,29,29888,20,4310,1861.83664,14.197612,16841.14202,2428.577426,Benign
192.168.215.61,53507,74.125.200.188,5228,10,753,0,0,10,753,1768.720444,59.9987056,0,100.402166,Benign
192.168.137.97,37178,140.98.193.112,443,4,264,2,132,2,132,8.221306348,0.331803163,3182.609805,3182.609805,Benign
192.168.43.224,50178,52.207.90.113,443,16,4978,9,1245,7,3733,370.9864572,34.61276135,287.7551403,862.8031637,Benign
172.30.15.2428,51762,14.139.45.128,443,3,198,3,198,0,0,5386.864107,9.001707,175.966625,0,Benign
192.168.43.224,49718,34.227.238.173,443,10,672,5,330,5,342,9.426271416,5.458164829,483.6790538,501.267383,Benign
172.30.1.136,50763,172.217.161.4,443,3,198,1,66,2,132,1914.246151,16.577711,31.84999425,63.6999885,Benign
10.0.2.15,52714,124.95.142.228,80,6451,7282386,1695,91824,4756,7190562,62.178113,33.130577,22172.62923,1736296.232,Malicious
172.30.15.414,49686,192.168.121.7,443,16,2935,8,1691,8,1244,1590.1054,0.35697,37896.74202,27879.09348,Benign
172.30.6.255,56403,151.101.2.49,80,18,2065,10,1309,8,756,651.572542,204.65962,51.16788549,29.55150606,Benign
172.30.15.1992,51304,205.185.216.10,443,21,6415,10,1195,11,5220,4077.457298,4.973218,1922.296589,8396.977571,Benign
192.168.43.233,51681,49.44.149.244,443,20,2449,10,1690,10,759,894.77738,115.756597,116.7967991,52.45489378,Benign
172.30.15.713,50000,172.217.166.234,80,17,8296,9,860,8,7436,2405.616796,0.593009,11601.84753,100315.5095,Benign
10.0.2.15,44480,119.254.87.201,80,11,1513,6,705,5,808,9802.987999,2.078255,2713.815196,3110.301671,Malicious
192.168.137.97,59346,157.240.16.20,443,85,38072,45,4888,40,33184,466.7126753,65.42650019,597.678309,4057.560762,Benign
172.30.6.255,57830,103.243.221.87,80,40,24270,23,20123,17,4147,4135.834262,27.22108,5913.946104,1218.761342,Benign
10.0.2.15,57438,119.254.87.201,80,12,1656,7,779,5,877,2620.991106,6.774924,919.8627173,1035.583573,Malicious
192.168.43.233,51305,13.107.42.254,443,7,434,4,252,3,182,2930.148463,127.464953,15.81611221,11.42274771,Benign
172.30.6.255,57591,172.217.166.206,443,54,10247,29,6199,25,4048,3340.411304,129.794152,382.0819292,249.5027665,Benign
192.168.137.97,34370,172.217.161.3,443,108,16722,47,5923,61,10799,247.1401874,116.0329882,408.3666269,744.5468857,Benign
192.168.43.233,51153,74.125.158.168,443,9,534,5,294,4,240,476.212715,25.278288,93.04427578,75.95451084,Benign
172.30.6.255,55941,52.203.61.66,80,7,402,4,228,3,174,152.515457,6.603472,276.2183288,210.7981983,Benign
172.30.1.136,50769,74.125.68.188,443,10,588,5,294,5,294,1917.840105,5.886878,399.5326555,399.5326555,Benign
192.168.137.97,45314,104.244.42.193,443,17,5737,10,1311,7,4426,143.3607898,0.289399521,36240.55756,122349.8915,Benign
192.168.215.49,38592,104.113.142.99,443,89,61539,37,4263,52,57276,1251.962302,330.7384207,103.1147211,1385.409046,Benign
172.30.6.255,57009,115.114.126.194,443,17,6860,10,1174,7,5686,1506.4801,16.938843,554.4652607,2685.425445,Benign
172.30.6.255,58020,104.122.91.146,80,75,68946,25,2520,50,66426,4763.867888,10.018845,2012.207994,53040.84453,Benign
192.168.137.97,42512,157.240.16.39,443,12,796,6,404,6,392,22.72483381,17.1351408,188.6182342,183.0157124,Benign
172.30.15.1461,50769,54.148.121.12,443,21,9058,10,2415,11,6643,3504.76525,2.516936,7675.999708,21114.56151,Benign
192.168.137.97,49428,157.240.16.52,443,26,6724,14,2623,12,4101,6763.267056,27.66829535,758.4131851,1185.761522,Benign
172.30.15.254,49480,180.149.59.227,80,3,162,2,108,1,54,66.349953,0.010839,79712.15057,39856.07528,Benign
172.30.6.255,58482,173.241.248.220,80,10,2494,6,1300,4,1194,5682.842057,6.375106,1631.345424,1498.328028,Benign
192.168.137.97,54096,140.98.193.112,443,16,1838,9,1221,7,617,24.42940796,13.93385062,701.0266055,354.2452216,Benign
172.30.6.255,56245,103.243.221.46,80,14,4986,8,3358,6,1628,527.879684,3.515119,7642.41552,3705.137721,Benign
10.0.2.15,43040,119.254.87.201,80,11,1579,6,705,5,874,22624.47751,1.819955,3098.977722,3841.853233,Malicious
172.30.6.255,55758,172.217.166.206,443,17,1779,10,1150,7,629,61.400882,108.777059,84.57665692,46.25975409,Benign
192.168.215.49,53906,103.243.220.231,443,26,10048,15,4390,11,5658,479.7114121,29.10393316,1206.709753,1555.253709,Benign
172.30.1.136,50535,157.240.16.16,443,61,7739,28,4274,33,3465,1137.820686,316.438417,108.0526199,87.59998316,Benign
10.0.2.15,56184,119.254.87.201,80,11,1513,6,705,5,808,12891.2217,2.189628,2575.779996,2952.099626,Malicious
10.0.2.15,50334,119.254.87.201,80,11,1579,6,705,5,874,25354.74466,3.952828,1426.826566,1768.860168,Malicious
172.30.1.136,50575,157.240.16.39,443,19,4765,14,4435,5,330,1574.152023,19.243764,1843.714151,137.1872987,Benign
192.168.137.97,37874,52.84.108.13,443,19,7977,11,1401,8,6576,1818.29902,21.07635544,531.7807451,2496.067223,Benign
172.30.6.255,57834,157.240.16.39,443,4,264,1,66,3,198,4144.089653,15.140171,34.87411073,104.6223322,Benign
172.30.6.255,56654,103.243.221.109,80,52,36018,32,30088,20,5930,1090.84732,31.302916,7689.507265,1515.513762,Benign
172.30.15.1090,50396,144.217.79.15,80,7,402,4,228,3,174,3453.055629,4.299927,424.1932479,323.7264261,Benign
172.30.15.806,50098,34.200.202.18,443,15,3949,8,2250,7,1699,2695.932819,10.567873,1703.275579,1286.162315,Benign
172.30.15.427,49701,52.84.103.186,443,104,83673,41,3678,63,79995,1622.998181,7.492251,3927.257643,85416.25207,Benign
10.0.2.15,56222,119.254.87.201,80,11,1582,6,705,5,877,22985.0142,2.289591,2463.322052,3064.302751,Malicious
172.30.6.255,56613,172.217.166.210,443,7,402,4,228,3,174,966.058788,30.824351,59.17399526,45.15910165,Benign
172.30.6.255,56713,103.243.220.231,80,20,9682,9,4226,11,5456,1170.840987,20.17459,1675.771354,2163.513608,Benign
172.30.15.661,49948,35.190.14.224,80,19,6291,10,5256,9,1035,2396.761957,9.447295,4450.797821,876.4413517,Benign
172.30.15.1360,50668,8.41.222.241,443,35,14804,17,3147,18,11657,3493.18763,4.149904,6066.646361,22471.84513,Benign
10.0.2.15,47703,119.254.87.201,80,11,1579,6,705,5,874,23495.63073,2.072922,2720.79702,3373.016447,Malicious
172.30.6.255,57628,103.243.221.75,80,46,29377,26,25067,20,4310,3450.886547,46.181949,4342.30266,746.6120583,Benign
172.30.6.255,58112,103.231.98.53,80,19,6478,10,5744,9,734,4891.849568,7.139964,6435.886792,822.4131102,Benign
172.30.15.1263,50571,205.185.216.42,80,6,348,4,228,2,120,3469.536181,7.996553,228.0982818,120.0517273,Benign
172.30.15.1968,51280,13.107.21.200,443,20,10027,9,1120,11,8907,4076.463695,0.783225,11439.87998,90977.6884,Benign
10.0.2.15,40194,219.234.85.243,80,2,138,1,74,1,64,61.04635,0.295051,2006.432786,1735.29322,Malicious
172.30.6.255,56762,23.198.126.238,443,17,6647,8,1326,9,5321,1244.684505,0.805989,13161.46995,52814.61658,Benign
192.168.137.97,47778,54.85.227.48,443,31,8026,16,2585,15,5441,6793.403006,61.31776819,337.2595026,709.8758041,Benign
192.168.43.224,43344,136.146.208.40,443,4,268,2,140,2,128,93.57785506,12.00267896,93.31250165,85.31428722,Benign
10.0.2.15,43488,119.254.87.201,80,11,1579,6,705,5,874,16525.3361,1.023937,5508.15138,6828.545116,Malicious
172.30.6.255,56817,103.243.220.231,80,25,13648,15,11491,10,2157,1286.840603,25.224743,3644.35824,684.0902205,Benign
10.0.2.15,47275,119.254.87.201,80,11,1579,6,705,5,874,13164.09059,1.025945,5497.370717,6815.180151,Malicious
10.0.2.15,58158,119.254.87.201,80,11,1579,6,705,5,874,25745.27489,2.092394,2695.477047,3341.626864,Malicious
172.30.13.95,50858,172.30.6.255,139,1,66,1,66,0,0,3533.665565,0,0,0,Benign
192.168.43.233,51084,182.22.24.124,443,49,15335,22,3099,27,12236,916.370517,125.055857,198.247412,782.7542216,Benign
172.30.1.136,50748,172.217.194.188,443,18,2802,11,2205,7,597,1894.110497,26.069925,676.6417625,183.1996064,Benign
10.0.2.15,56274,119.254.87.201,80,11,1513,6,705,5,808,11061.88731,1.816955,3104.094488,3557.600491,Malicious
172.30.15.2410,51744,104.19.199.151,443,133,91772,63,4961,70,86811,5344.776663,3.075111,12906.20078,225841.6038,Benign
10.0.2.15,34424,119.254.87.201,80,12,1653,7,779,5,874,25240.06229,3.785473,1646.293607,1847.06112,Malicious
172.30.15.809,50101,192.168.45.1,7680,3,198,3,198,0,0,2734.510854,9.004756,175.9070429,0,Benign
172.30.15.1136,50444,157.240.16.37,443,12,1688,7,971,5,717,3458.30607,8.640954,898.9748123,663.8155926,Benign
172.30.15.420,49694,54.222.61.197,443,7,398,4,228,3,170,1614.685858,6.209721,293.7330035,219.01145,Benign
10.0.2.15,54091,119.254.87.201,80,11,1582,6,705,5,877,8299.316462,2.070192,2724.384985,3389.057633,Malicious
172.30.15.1414,50722,52.45.111.226,443,15,2736,9,1704,6,1032,3500.158162,6.221634,2191.064277,1326.98259,Benign
192.168.137.97,41108,104.198.143.177,80,10,907,6,499,4,408,181.5295096,5.812911876,686.7470358,561.5085984,Benign
172.30.6.255,55894,63.251.88.56,443,20,7241,9,2176,11,5065,114.310147,1.209551,14392.11741,33500.03431,Benign
172.30.6.255,56186,185.86.137.17,80,21,2291,12,1298,9,993,466.705287,303.374732,34.22829559,26.18543722,Benign
10.0.2.15,35798,119.254.87.201,80,11,1582,6,705,5,877,12866.03157,2.177171,2590.517695,3222.530522,Malicious
192.168.43.233,51673,23.21.249.197,443,27,8042,13,1860,14,6182,891.007513,163.402546,91.06345259,302.6635827,Benign
192.168.43.224,54420,52.206.154.207,443,9,622,5,338,4,284,36.6474379,13.47502174,200.6675797,168.6082623,Benign
172.30.6.255,57841,161.69.226.23,443,24,6418,13,3165,11,3253,4179.052053,176.646394,143.3372028,147.3225658,Benign
192.168.43.224,46302,35.170.201.81,443,15,3130,8,2235,7,895,546.6402881,1.237720404,14445.91197,5784.828283,Benign
172.30.1.136,50289,52.84.103.186,443,14,1603,9,1090,5,513,487.363809,20.014035,435.6942516,205.0561019,Benign
172.30.15.1643,50953,184.29.25.7,443,785,729508,284,66241,501,663267,3576.998961,20.382203,25999.5448,260331.8199,Benign
172.30.15.857,50163,180.149.59.138,80,6,348,4,228,2,120,3433.444915,3.601526,506.4519873,266.5536775,Benign
172.30.6.255,56789,103.231.98.53,80,22,13193,15,12519,7,674,1253.880795,4.591501,21812.47483,1174.343641,Benign
192.168.137.97,41984,23.57.214.252,443,11,766,7,486,4,280,68.61700637,20.22271236,192.2590764,110.7665461,Benign
192.168.43.224,51962,157.240.16.20,443,125,83062,60,5327,65,77735,2461.521762,71.05713741,599.7427078,8751.830184,Benign
172.30.6.255,57281,157.240.16.39,443,28,5565,15,3417,13,2148,2314.094341,61.066078,447.6462366,281.4000925,Benign
172.30.6.255,58516,157.240.16.17,443,1213,1206299,376,21639,837,1184660,5751.517815,7.547133,22937.45188,1255745.725,Benign
172.30.15.376,49644,62.210.213.13,80,16,7310,7,785,9,6525,1443.113082,7.440795,843.9958365,7015.379405,Benign
172.30.15.1313,50621,180.179.41.214,443,25,9471,14,1985,11,7486,3487.519923,1.156137,13735.39641,51800.08944,Benign
192.168.43.233,51089,182.22.24.124,443,5,294,3,174,2,120,916.563708,11.074883,125.6898154,86.68263132,Benign
172.30.15.290,49553,192.0.73.2,443,29,10465,15,1855,14,8610,393.988844,0.781367,18992.3557,88153.19818,Benign
172.30.6.255,58294,35.171.73.174,443,25,6022,14,1855,11,4167,5323.293739,10.932659,1357.400793,3049.212456,Benign
192.168.43.224,39096,103.37.200.184,443,9,618,6,404,3,214,2571.251861,14.67364164,220.2588886,116.6717875,Benign
172.30.6.255,57823,157.240.16.39,443,28,5423,16,3329,12,2094,4083.38968,61.162164,435.4325985,273.8948216,Benign
172.30.15.646,49933,52.84.110.215,80,9,1334,6,676,3,658,2395.391746,0.743048,7278.13008,7084.333717,Benign
10.0.2.15,33412,219.234.85.243,80,11,1340,6,788,5,552,19.815445,1.93769,3253.35838,2279.002317,Malicious
192.168.137.97,40834,18.211.26.179,443,24,3217,15,2503,9,714,65.67589538,18.76995366,1066.811371,304.3161482,Benign
10.0.2.15,46225,119.254.87.201,80,12,1653,7,779,5,874,16254.99073,4.421066,1409.614785,1581.519027,Malicious
172.30.15.1371,50679,35.190.74.53,443,28,7950,14,2122,14,5828,3493.460706,3.573243,4750.86637,13048.09105,Benign
192.168.43.224,40126,54.243.243.77,443,124,63774,71,33232,53,30542,2269.88456,260.7095884,1019.740017,937.1960638,Benign
10.0.2.15,40476,119.254.87.201,80,11,1582,6,705,5,877,14488.15798,1.267082,4451.172063,5537.131772,Malicious
172.30.15.2455,51789,14.139.45.128,80,10,1430,5,682,5,748,5420.754682,0.157728,34591.19497,37938.72997,Benign
172.30.1.136,50760,172.217.161.3,443,11,654,6,348,5,306,1907.832615,18.308025,152.0644635,133.7118559,Benign
10.0.2.15,38988,119.254.87.201,80,11,1582,6,705,5,877,25655.15732,2.025955,2783.872297,3463.058163,Malicious
172.30.6.255,57803,173.241.248.220,80,6,535,4,228,2,307,4042.004643,23.015841,79.24976541,106.709114,Benign
172.30.15.2458,51792,14.139.45.128,80,10,1390,5,662,5,728,5420.972649,0.100019,52949.93951,58228.9365,Benign
172.30.6.255,58196,103.243.221.87,80,15,5491,9,4317,6,1174,5089.889756,11.49652,3004.039483,816.9428662,Benign
192.168.137.97,51740,172.217.161.3,443,16,2049,11,1563,5,486,3759.494275,107.1195391,116.7294044,36.29589927,Benign
172.30.15.1891,51203,23.57.208.237,443,9,546,6,360,3,186,3974.683063,12.588179,228.7860699,118.2061361,Benign
10.0.2.15,39809,119.254.87.201,80,11,1582,6,705,5,877,26349.03129,2.018866,2793.647523,3475.218266,Malicious
172.30.15.1839,51151,35.161.208.104,443,6,340,4,228,2,112,3867.224935,10.195014,178.9109853,87.88609805,Benign
192.168.43.233,51244,172.217.160.238,443,26,7005,14,2333,12,4672,1804.319664,144.083823,129.5357078,259.4045551,Benign
192.168.137.97,45274,13.229.196.49,443,6,412,4,272,2,140,24.32272927,10.69137839,203.5284807,104.7573062,Benign
192.168.43.224,49988,52.0.177.159,443,6,412,4,272,2,140,164.5751485,12.44896925,174.7935879,89.96728788,Benign
172.30.15.1407,50715,103.243.220.231,443,7,406,5,294,2,112,3499.97512,7.192065,327.0270778,124.5817439,Benign
192.168.43.233,51211,172.217.160.229,443,10,590,6,350,4,240,1216.62293,103.540746,27.04249398,18.54342444,Benign
10.0.2.15,60933,119.254.87.201,80,11,1579,6,705,5,874,20765.24162,11.085293,508.7822216,630.7456194,Malicious
172.30.15.700,49987,103.243.221.17,443,21,7953,11,2855,10,5098,2403.197786,3.163176,7220.59095,12893.37046,Benign
172.30.6.255,58362,117.18.232.200,443,50,24832,24,2260,26,22572,5466.451573,109.822532,164.6292402,1644.252748,Benign
192.168.43.233,50727,172.217.24.232,443,9,534,5,294,4,240,1846.784914,12.09798,194.4126209,158.7041804,Benign
192.168.43.233,51432,104.131.222.33,80,231,181245,104,11225,127,170020,3790.806348,35.880735,2502.7358,37907.80763,Benign
10.0.2.15,37762,119.254.87.201,80,11,1513,6,705,5,808,7220.187472,2.080269,2711.187832,3107.290451,Malicious
10.0.2.15,60527,119.254.87.201,80,11,1582,6,705,5,877,17311.45253,1.789516,3151.690178,3920.613171,Malicious
172.30.6.255,58489,176.34.147.227,443,13,1482,7,958,6,524,5683.923554,6.593457,1162.364447,635.7818061,Benign
172.30.15.640,49927,122.15.34.17,80,13,3134,8,1422,5,1712,2394.180112,1.953285,5824.034895,7011.777595,Benign
192.168.43.224,34372,52.84.110.254,443,445,316050,211,17540,234,298510,358.4526371,208.7277779,672.2631813,11441.12213,Benign
172.30.1.136,50527,54.229.103.82,443,10,600,6,360,4,240,1041.160023,29.951922,96.15409656,64.10273104,Benign
10.0.2.15,55375,119.254.87.201,80,11,1579,6,705,5,874,7275.542507,1.413559,3989.928967,4946.380024,Malicious
172.30.15.2283,51602,87.250.251.119,443,15,1582,8,1012,7,570,4566.534178,3.028961,2672.863731,1505.466726,Benign
172.30.6.255,55990,119.42.60.92,80,11,1868,6,943,5,925,183.561399,30.471643,247.5744416,242.8487364,Benign
172.30.6.255,57561,103.243.221.17,80,62,52593,22,11151,40,41442,3253.845939,28.222002,3160.938051,11747.43025,Benign
10.0.2.15,44182,119.254.87.201,80,11,1534,6,705,5,829,19948.92698,2.562918,2200.616641,2587.675454,Malicious
172.30.6.255,57018,115.114.126.194,443,17,6860,10,1174,7,5686,1534.739969,14.891484,630.6960408,3054.631761,Benign
172.30.6.255,57084,157.240.16.39,443,28,5566,15,3419,13,2147,1704.096967,61.028572,448.1835164,281.4419449,Benign
10.0.2.15,57315,119.254.87.201,80,12,1587,7,779,5,808,20311.7975,4.443874,1402.379995,1454.586696,Malicious
192.168.215.49,45524,23.57.214.252,443,104,35933,60,22351,44,13582,512.9097788,716.506367,249.5553539,151.6469427,Benign
172.30.15.796,50088,52.84.108.164,443,42,23406,22,2749,20,20657,2677.549596,8.676735,2534.593946,19045.87382,Benign
172.30.6.255,56600,103.243.221.109,80,54,33638,25,17567,29,16071,951.837151,20.494332,6857.310597,6273.344259,Benign
172.30.1.136,50589,52.30.87.88,443,60,24674,31,16559,29,8115,1597.006889,153.9386,860.550895,421.7265845,Benign
172.30.15.1740,51051,184.29.25.7,443,170,151036,62,10730,108,140306,3632.701588,4.325852,19843.48979,259474.4342,Benign
172.30.6.255,57513,103.243.221.109,80,44,31168,17,8646,27,22522,3072.8418,50.187456,1378.192989,3590.060433,Benign
172.30.6.255,57983,23.61.87.106,443,2139,1712485,980,61421,1159,1651064,4693.013308,9.376385,52404.84472,1408699.835,Benign
192.168.43.224,56364,104.17.79.191,443,1808,1249489,772,58329,1036,1191160,1279.901988,805.1037394,579.5923893,11836.0896,Benign
172.30.6.255,56615,172.217.166.210,443,47,8237,22,2797,25,5440,966.093123,184.017548,121.597099,236.4991843,Benign
10.0.2.15,40912,119.254.87.201,80,11,1579,6,705,5,874,17576.46608,1.356244,4158.543743,5155.414512,Malicious
172.30.6.255,58358,172.217.166.206,443,102,18011,56,11399,46,6612,5462.403134,117.068214,778.9646471,451.8391303,Benign
172.30.6.255,57465,103.243.221.109,80,40,24414,24,20321,16,4093,2950.839781,41.191278,3946.660747,794.9255665,Benign
172.30.6.255,57838,103.243.221.109,80,30,16122,17,9402,13,6720,4162.895845,11.105178,6773.056677,4840.984989,Benign
172.30.15.1452,50760,184.29.25.122,443,30,12483,15,10506,15,1977,3502.104231,4.892206,17179.97975,3232.897388,Benign
172.30.15.217,49492,111.221.29.253,443,24,5929,14,1420,10,4509,15.153124,1.020546,11131.29638,35345.78549,Benign
192.168.43.233,51682,107.22.42.44,443,7,402,4,228,3,174,894.860416,10.721469,170.1259408,129.8329548,Benign
10.0.2.15,35640,119.254.87.201,80,11,1582,6,705,5,877,12350.66839,1.620457,3480.499637,4329.642811,Malicious
192.168.43.224,46142,54.85.84.151,443,5,342,3,198,2,144,9.426148176,3.215843609,492.5612662,358.2263754,Benign
192.168.137.97,46246,103.102.166.240,443,21,7647,12,1450,9,6197,19.4457778,11.13312155,1041.935988,4453.01884,Benign
172.30.6.255,55911,23.198.140.217,80,10,1973,5,872,5,1101,121.897631,0.408896,17060.57286,21540.92972,Benign
172.30.6.255,58394,157.240.16.39,443,39,8787,20,3815,19,4972,5529.69279,9.367303,3258.141644,4246.259569,Benign
172.30.6.255,58300,157.240.16.17,443,1736,1458878,727,55412,1009,1403466,5326.607029,7.396029,59937.02837,1518075.173,Benign
192.168.43.224,49990,52.201.103.234,443,56,18366,30,10112,26,8254,935.485509,235.826832,343.0313647,280.0020653,Benign
172.30.1.136,51901,52.114.132.73,443,20,7483,11,2789,9,4694,4744.69022,2.050337,10882.11353,18315.03797,Benign
192.168.137.97,57768,169.60.79.147,443,38,11733,22,3971,16,7762,8331.876447,17.32230598,1833.935969,3584.742128,Benign
172.30.6.255,57229,172.217.166.206,443,39,6548,20,3795,19,2753,2172.418509,87.777767,345.8734602,250.9063599,Benign
192.168.215.49,43608,34.227.208.227,443,89,20456,47,8982,42,11474,552.6611061,83.46056595,860.9574975,1099.824797,Benign
172.30.15.1468,50776,103.231.98.244,443,17,6119,8,778,9,5341,3506.3879,1.064608,5846.283327,40134.96047,Benign
172.30.15.1183,50491,52.86.241.228,80,15,3654,8,2582,7,1072,3464.492983,3.154194,6548.741136,2718.919635,Benign
192.168.43.233,51366,52.216.18.144,443,131,90334,54,4866,77,85468,3464.950712,109.724862,354.7782999,6231.440965,Benign
172.30.15.448,49722,52.84.110.254,443,15,3310,8,1656,7,1654,1632.628372,7.945191,1667.423728,1665.409932,Benign
10.0.2.15,50109,119.254.87.201,80,11,1582,6,705,5,877,280.86031,2.523703,2234.811307,2780.041867,Malicious
172.30.6.255,57238,103.243.220.231,80,16,5526,9,4299,7,1227,2204.911783,21.118402,1628.53231,464.807896,Benign
10.0.2.15,42714,119.254.87.201,80,11,1579,6,705,5,874,9712.89901,5.030277,1121.210621,1389.983096,Malicious
10.0.2.15,56966,119.254.87.201,80,11,1569,6,705,5,864,222.607598,1.75308,3217.19488,3942.775002,Malicious
192.168.43.224,60830,35.171.73.174,443,7,478,4,272,3,206,23.18626177,10.85736046,200.4170358,151.7864316,Benign
172.30.15.799,50091,52.84.108.164,443,30,18109,13,2154,17,15955,2679.554169,6.672499,2582.540664,19129.26476,Benign
192.168.137.97,58376,151.101.12.193,443,17,5393,10,1290,7,4103,5243.857086,64.09447514,161.0123178,512.1190232,Benign
172.30.1.136,50675,172.217.161.14,443,28,8735,14,1615,14,7120,1804.190526,140.377462,92.03756654,405.7631417,Benign
172.30.15.1415,50723,103.231.98.244,443,8,973,5,799,3,174,3500.200058,0.73464,8700.860285,1894.805619,Benign
10.0.2.15,37446,119.254.87.201,80,11,1513,6,705,5,808,19858.79453,2.153288,2619.250189,3001.920783,Malicious
192.168.43.224,36766,104.197.3.80,80,14,1191,8,631,6,560,89.54109142,3.579412923,1410.287136,1251.601896,Benign
172.30.15.632,49919,23.198.105.137,443,19,6145,11,1285,8,4860,2392.883626,3.217285,3195.240708,12084.72361,Benign
192.168.137.97,40832,18.211.26.179,443,35,6243,20,4508,15,1735,63.76924052,290.9102696,123.9694977,47.71230668,Benign
172.30.1.136,51541,172.217.161.4,443,2,132,2,132,0,0,701.877828,2.999766,352.0274581,0,Benign
172.30.6.255,58283,157.240.16.39,443,27,5329,15,3274,12,2055,5303.401002,60.721534,431.3461514,270.7441482,Benign
172.30.15.208,49475,52.229.207.60,443,1,54,1,54,0,0,9.437414,0,0,0,Benign
10.0.2.15,47134,119.254.87.201,80,12,1656,7,779,5,877,21993.57572,4.074309,1529.584526,1722.009794,Malicious
172.30.15.1989,51301,23.57.208.237,443,23,7902,12,1363,11,6539,4077.232815,5.09364,2140.708805,10270.06227,Benign
10.0.2.15,39076,119.254.87.201,80,11,1579,6,705,5,874,15566.5021,1.610853,3501.25058,4340.557456,Malicious
172.30.15.1687,50998,162.247.242.19,443,7,398,4,228,3,170,3608.517011,8.927403,204.3147374,152.3399358,Benign
172.30.15.410,49682,192.168.121.7,8080,24,11347,12,1877,12,9470,1542.108395,8.338533,1800.796375,9085.530992,Benign
172.30.6.255,58375,173.241.248.220,80,11,3524,7,2318,4,1206,5484.930608,4.250774,4362.499629,2269.704294,Benign
172.30.15.1475,50783,54.164.214.76,443,6,340,4,228,2,112,3509.482459,7.98232,228.504996,112.2480682,Benign
192.168.137.97,36448,130.211.21.54,443,71,14760,37,4511,34,10249,347.4442915,266.8608861,135.2315078,307.2462255,Benign
172.30.6.255,56530,23.198.119.247,443,20,9343,11,1312,9,8031,831.971604,41.614248,252.2213065,1543.894293,Benign
172.30.15.1663,50974,184.29.25.7,443,16,2332,8,1541,8,791,3587.669015,9.712527,1269.288621,651.5297203,Benign
172.30.15.2285,51606,172.30.30.101,7680,3,198,3,198,0,0,4648.756897,9.006477,175.8734298,0,Benign
10.0.2.15,45978,119.254.87.201,80,11,1579,6,705,5,874,5954.267434,1.955195,2884.622761,3576.113891,Malicious
10.0.2.15,34327,119.254.87.201,80,11,1513,6,705,5,808,2743.661771,1.175854,4796.513853,5497.281125,Malicious
192.168.43.233,51290,23.9.140.60,80,30,10402,15,8668,15,1734,2793.625966,65.75047,1054.654058,210.9794805,Benign
10.0.2.15,47236,119.254.87.201,80,11,1579,6,705,5,874,9407.623168,1.165005,4841.180939,6001.69098,Malicious
172.30.6.255,57651,103.243.221.75,80,6,340,4,228,2,112,3518.858946,38.203267,47.74460781,23.45349156,Benign
192.168.137.97,53996,210.176.156.41,443,15,810,8,432,7,378,7.140011932,267.8260483,12.90389797,11.29091072,Benign
192.168.137.97,48482,185.199.110.153,80,34,3939,18,2060,16,1879,3.63E-05,403.9949565,40.79258846,37.2083853,Benign
10.0.2.15,38387,118.26.228.168,80,15,2019,8,1011,7,1008,18.789748,166.475978,48.58358604,48.43942109,Malicious
172.30.15.1351,50659,35.189.131.178,443,21,9139,11,1892,10,7247,3492.353286,4.773259,3170.999101,12145.9992,Benign
10.0.2.15,47293,119.254.87.201,80,11,1582,6,705,5,877,24604.02207,1.321889,4266.621479,5307.556081,Malicious
10.0.2.15,58064,119.254.87.201,80,11,1582,6,705,5,877,8959.97374,1.515115,3722.489712,4630.671599,Malicious
172.30.15.882,50188,151.101.66.202,80,10,1987,6,944,4,1043,3437.20917,10.043362,751.9394402,830.7974959,Benign
10.0.2.15,48957,119.254.87.201,80,11,1579,6,705,5,874,3674.433099,1.551058,3636.227659,4507.890743,Malicious
172.30.6.255,57946,103.243.221.75,80,6,340,4,228,2,112,4560.223095,26.829157,67.98573656,33.39650217,Benign
192.168.43.233,51415,13.107.246.10,443,125,69572,52,4448,73,65124,3649.36731,128.678001,276.5352253,4048.80396,Benign
192.168.215.49,48056,104.113.225.158,443,71,40691,33,4070,38,36621,1250.287435,332.4139631,97.95015737,881.334819,Benign
172.30.6.255,56160,103.243.221.17,80,7,394,4,228,3,166,407.105208,4.688634,389.0258869,283.2381457,Benign
10.0.2.15,49205,119.254.87.201,80,11,1513,6,705,5,808,16405.14967,1.357512,4154.659406,4761.652199,Malicious
172.30.6.255,55698,210.176.156.41,80,12,4223,7,2745,5,1478,53.27243,5.44306,4034.495302,2172.307489,Benign
172.30.6.255,57262,13.229.196.49,443,24,7985,12,1441,12,6544,2252.523274,20.673916,557.6108561,2532.273034,Benign
172.30.15.1490,50798,103.243.221.51,443,20,7542,11,3090,9,4452,3520.964725,6.197839,3988.486955,5746.519069,Benign
10.0.2.15,47704,119.254.87.201,80,11,1593,6,705,5,888,20101.54267,2.160647,2610.329221,3287.90404,Malicious
10.0.2.15,49036,219.234.85.243,80,8,940,4,684,4,256,176.632917,0.591816,9246.117036,3460.535031,Malicious
172.30.15.2155,51467,104.16.123.127,443,49,11403,26,3093,23,8310,4188.606732,8.835878,2800.40082,7523.870293,Benign
172.30.6.255,57832,103.243.221.46,80,21,10349,10,4259,11,6090,4135.847841,27.206265,1252.358602,1790.764002,Benign
192.168.43.224,40194,54.243.243.77,443,14,1660,8,1080,6,580,2651.153726,11.83796915,729.8549175,391.9591223,Benign
172.30.6.255,56092,54.169.211.49,443,30,8435,14,2157,16,6278,305.825011,60.477661,285.3284951,830.4553974,Benign
192.168.137.97,39722,192.168.125.6,80,52,32833,27,2389,25,30444,8288.313243,10.39981792,1837.724482,23418.87155,Benign
172.30.15.568,49852,144.2.194.69,443,24,7330,12,2271,12,5059,2254.810522,1.235824,14701.12249,32748.99986,Benign
172.30.15.1636,50946,184.29.25.7,443,45,32996,19,3967,26,29029,3575.551267,1.516233,20930.82,153163.7947,Benign
192.168.43.224,42874,54.208.114.197,443,82,37698,44,23068,38,14630,1073.814689,175.2157217,1053.23882,667.9765883,Benign
172.30.15.605,49892,13.107.21.200,443,36,11967,16,3598,20,8369,2386.774482,9.363102,3074.194856,7150.621664,Benign
172.30.6.255,58471,35.190.41.40,443,87,19593,41,6791,46,12802,5673.181658,5.903582,9202.548554,17348.11171,Benign
192.168.43.224,52244,192.0.73.2,443,25,8666,13,1323,12,7343,1901.593924,13.11681054,806.9034743,4478.527749,Benign
172.30.6.255,55746,182.161.72.94,80,7,402,4,228,3,174,58.300345,0.41224,4424.607025,3376.673782,Benign
10.0.2.15,43281,119.254.87.201,80,11,1544,6,705,5,839,188.31196,1.631967,3455.952234,4112.828262,Malicious
172.30.6.255,57486,157.240.16.39,443,18,1879,9,1071,9,808,3046.097254,61.011389,140.4327969,105.9474322,Benign
172.30.1.136,50690,172.217.161.4,443,3,198,3,198,0,0,1808.559729,9.001924,175.9623832,0,Benign
192.168.43.233,51129,192.82.211.131,443,26,8082,13,2947,13,5135,922.206902,15.283248,1542.604033,2687.910319,Benign
192.168.137.97,51262,216.58.221.34,443,16,1120,10,692,6,428,9531.672928,32.56180936,170.0151223,105.1538618,Benign
172.30.6.255,55996,51.140.98.69,443,54,51327,15,1870,39,49457,221.973456,17.327423,863.3713161,22834.09368,Benign
10.0.2.15,32983,119.254.87.201,80,11,1582,6,705,5,877,13256.49148,1.679313,3358.51625,4177.898938,Malicious
10.0.2.15,53503,119.254.87.201,80,11,1579,6,705,5,874,1749.917599,1.019257,5533.442498,6859.898926,Malicious
10.0.2.15,50979,119.254.87.201,80,11,1582,6,705,5,877,11995.21118,0.833574,6766.045966,8416.769237,Malicious
192.168.137.97,52274,172.217.161.3,443,16,1128,9,626,7,502,9528.42338,35.811345,139.8439517,112.1432328,Benign
10.0.2.15,50728,119.254.87.201,80,12,1653,7,779,5,874,18417.25438,4.175299,1492.587716,1674.610609,Malicious
192.168.43.233,51236,188.138.1.175,2004,1324,119982,796,63905,528,56077,1537.727597,359.160436,1423.430726,1249.068536,Benign
172.30.6.255,55678,195.201.82.80,80,13,5282,7,1200,6,4082,41.472445,17.288115,555.2947791,1888.92774,Benign
172.30.6.255,56860,52.213.19.114,443,19,6432,10,1195,9,5237,1354.659874,22.886454,417.7143388,1830.602504,Benign
172.30.15.1030,50336,54.94.182.41,443,21,5448,10,1965,11,3483,3446.942906,1.799166,8737.381654,15487.17572,Benign
172.30.15.2407,51741,14.139.45.128,80,218,176787,96,6267,122,170520,5344.430826,7.243838,6921.192881,188320.0591,Benign
172.30.1.136,50428,157.240.16.16,443,3,198,3,198,0,0,834.846671,9.000739,175.9855496,0,Benign
10.0.2.15,56069,119.254.87.201,80,11,1582,6,705,5,877,7095.429395,0.891524,6326.245844,7869.670362,Malicious
10.0.2.15,49948,119.254.87.201,80,11,1552,6,705,5,847,25538.04933,0.887264,6356.619901,7636.960364,Malicious
172.30.6.255,56651,172.30.10.168,7680,3,198,3,198,0,0,1075.283536,8.972441,176.5405869,0,Benign
172.30.6.255,56226,103.243.221.51,80,14,4939,7,2545,7,2394,470.17184,20.86587,975.7561031,917.862519,Benign
172.30.6.255,58290,151.101.65.69,443,16,5714,10,1186,6,4528,5320.919236,3.029508,3131.861675,11957.05705,Benign
192.168.43.233,51412,23.100.69.251,443,21,8395,10,1602,11,6793,3647.787501,122.688436,104.4597227,442.9431312,Benign
10.0.2.15,38896,119.254.87.201,80,11,1569,6,705,5,864,20555.16686,1.856085,3038.653941,3723.967383,Malicious
172.30.15.463,49737,162.125.82.1,443,36,14933,19,2773,17,12160,1658.530041,2.077505,10678.19331,46825.39874,Benign
172.30.15.1717,51028,184.29.25.7,443,66,48801,29,9465,37,39336,3618.88491,8.196523,9238.063506,38392.86488,Benign
172.30.6.255,56374,103.243.221.17,80,46,27539,26,23219,20,4320,631.862126,17.201155,10798.80973,2009.167408,Benign
192.168.43.224,53700,18.136.71.251,443,42,12172,22,4130,20,8042,1202.706986,77.1006106,428.5309771,834.4421594,Benign
172.30.15.1477,50785,52.85.51.65,443,24,4854,14,1754,10,3100,3510.652249,6.810277,2060.415457,3641.555255,Benign
172.30.1.136,50227,74.125.68.188,5228,3,198,3,198,0,0,385.590509,9.001428,175.9720791,0,Benign
172.30.6.255,57939,103.243.221.75,80,40,24467,23,20319,17,4148,4527.093703,27.721407,5863.771633,1197.053238,Benign
10.0.2.15,37051,119.254.87.201,80,11,1579,6,705,5,874,24423.82856,1.25634,4489.230622,5565.372431,Malicious
10.0.2.15,58188,119.254.87.201,80,11,1579,6,705,5,874,3492.082916,1.679029,3359.084328,4164.311635,Malicious
192.168.215.49,60138,54.82.135.50,443,31,6746,16,2122,15,4624,554.1143471,60.87968532,278.8450681,607.6246914,Benign
172.30.15.2444,51778,14.139.45.128,80,95,76079,41,3020,54,73059,5420.359781,0.686149,35211.01102,851814.9848,Benign
192.168.43.224,57282,139.59.82.147,443,22,7375,12,1418,10,5957,2583.733044,19.01281427,596.6502295,2506.52004,Benign
172.30.15.1487,50795,157.240.16.39,443,31,6893,17,5078,14,1815,3520.94309,6.09449,6665.69311,2382.479912,Benign
10.0.2.15,39991,119.254.87.201,80,11,1561,6,705,5,856,9858.211805,1.893681,2978.326339,3616.23737,Malicious
172.30.6.255,57881,103.243.221.75,80,28,18159,12,5393,16,12766,4303.838668,41.19251,1047.374875,2479.285676,Benign
192.168.43.233,51477,54.81.94.76,80,18,2812,10,1841,8,971,3816.612731,233.057087,63.19481716,33.33088944,Benign
172.30.6.255,57145,103.243.220.231,80,39,23357,17,9371,22,13986,1875.865661,46.17694,1623.494324,2423.027598,Benign
172.30.6.255,55853,23.7.212.50,443,41,17734,20,5292,21,12442,103.61659,302.336085,140.0295965,329.2230234,Benign
10.0.2.15,50784,119.254.87.201,80,11,1558,6,705,5,853,16795.68208,1.754101,3215.322265,3890.311903,Malicious
192.168.137.97,48660,54.255.158.169,443,16,5141,9,1257,7,3884,347.7465334,15.42721511,651.8350802,2014.102984,Benign
192.168.215.111,50990,172.217.194.188,5228,9,740,0,0,9,740,1695.11991,59.99930202,0,98.66781446,Benign
172.30.15.1017,50323,23.58.23.32,443,34,18339,17,5927,17,12412,3445.269068,1.737477,27290.14542,57149.53349,Benign
172.30.6.255,58170,157.240.16.39,443,28,5560,16,3467,12,2093,4998.096413,61.318096,452.3297658,273.0678395,Benign
172.30.1.136,50224,172.217.161.14,443,86,32134,39,19097,47,13037,385.107726,138.765506,1100.96525,751.598888,Benign
172.30.6.255,57650,103.243.221.75,80,30,18104,17,14992,13,3112,3518.563508,38.498417,3115.348873,646.6759399,Benign
172.30.6.255,58565,157.240.16.17,443,269,213883,120,8594,149,205289,5870.964954,8.267503,8315.932876,198646.6772,Benign
10.0.2.15,46385,119.254.87.201,80,11,1579,6,705,5,874,4452.975473,1.949634,2892.850658,3586.314149,Malicious
10.0.2.15,42176,119.254.87.201,80,11,1582,6,705,5,877,2142.853483,1.791399,3148.37733,3916.492082,Malicious
192.168.43.224,51884,54.173.101.22,443,9,626,6,412,3,214,45.11855826,12.1954028,270.2657759,140.3807671,Benign
172.30.15.739,50027,157.240.16.52,443,27,4745,14,1865,13,2880,2532.63753,3.563849,4186.484893,6464.920371,Benign
10.0.2.15,42567,119.254.87.201,80,11,1579,6,705,5,874,14065.00392,1.355387,4161.173156,5158.674238,Malicious
172.30.6.255,57381,103.243.221.17,80,25,10884,14,8233,11,2651,2648.868966,16.193244,4067.375258,1309.681988,Benign
192.168.43.233,51324,139.59.72.43,443,279,231139,105,14791,174,216348,3074.494853,197.645573,598.687834,8757.008688,Benign
10.0.2.15,57282,119.254.87.201,80,11,1579,6,705,5,874,13224.09815,2.024822,2785.430028,3453.143042,Malicious
192.168.215.49,35210,205.185.208.52,443,129,94409,57,4817,72,89592,1249.252459,43.51454763,885.5888914,16471.18122,Benign
10.0.2.15,55788,119.254.87.201,80,11,1582,6,705,5,877,17398.45264,2.885449,1954.635137,2431.510659,Malicious
172.30.1.136,50205,172.217.161.14,443,14,864,8,492,6,372,359.92938,16.31873,241.1952401,182.3671327,Benign
192.168.43.233,50718,172.217.166.208,443,3195,2962703,1146,63495,2049,2899208,1844.160431,12.793398,39704.85402,1812940.081,Benign
172.30.6.255,56889,104.122.118.96,80,8,480,5,294,3,186,1384.549709,19.842916,118.5309659,74.98897843,Benign
172.30.6.255,58017,103.243.221.51,80,14,6817,10,5751,4,1066,4761.88299,3.461993,13289.45495,2463.320983,Benign
172.30.15.231,49500,52.114.76.37,443,19,8261,11,3621,8,4640,50.740309,0.920376,31474.0932,40331.34284,Benign
192.168.137.97,51852,103.102.166.224,443,37,11666,18,2298,19,9368,5667.489241,180.4133034,101.8993592,415.4017393,Benign
192.168.137.97,35542,209.197.3.15,80,7,466,4,272,3,194,5243.628391,55.74692412,39.03354372,27.84010103,Benign
172.30.15.407,49679,162.125.82.7,443,24,7334,11,1521,13,5813,1537.627301,60.967746,199.5809391,762.7639703,Benign
192.168.43.224,44580,151.101.66.217,443,21,8710,12,1503,9,7207,2418.258387,10.89403828,1103.722944,5292.435965,Benign
192.168.43.233,50936,54.239.35.198,443,44,15520,22,4714,22,10806,450.956398,7.653379,4927.496731,11295.40298,Benign
172.30.15.2385,51719,14.139.45.128,80,49,39245,19,1408,30,37837,5335.038435,4.956047,2272.779092,61076.09553,Benign
192.168.43.224,50890,23.251.156.28,443,1309,1073631,567,51495,742,1022136,2273.397234,257.1966604,1601.731529,31793.13444,Benign
10.0.2.15,45563,119.254.87.201,80,11,1558,6,705,5,853,7160.163526,1.955825,2883.693582,3489.064717,Malicious
172.30.6.255,57987,103.243.221.17,80,51,28526,26,17199,25,11327,4696.856694,25.24886,5449.434153,3588.914509,Benign
172.30.6.255,55246,172.217.194.189,443,174,21464,85,9981,89,11483,1.460485,1351.471882,59.0822503,67.97329728,Benign
172.30.15.1561,50870,52.84.108.98,443,17,6861,9,1153,8,5708,3557.049669,0.154717,59618.52931,295145.3299,Benign
192.168.43.224,45824,104.237.191.1,443,27,4372,14,2245,13,2127,3076.185294,93.69329003,191.6892874,181.6138594,Benign
192.168.43.224,46274,45.33.67.183,443,154,124439,61,10167,93,114272,2468.08293,85.9615213,946.190793,10634.71174,Benign
172.30.1.136,50259,104.17.38.113,443,1,66,1,66,0,0,461.651963,0,0,0,Benign
172.30.6.255,56489,103.243.221.17,80,17,5506,9,4224,8,1282,817.860743,11.1964,3018.112965,916.0087171,Benign
192.168.43.233,51655,157.240.16.39,443,72,13122,36,9000,36,4122,857.456266,174.73817,412.0450615,188.7166382,Benign
192.168.43.224,59732,103.102.166.224,443,20,6165,11,1336,9,4829,29.98702742,13.96411803,765.3902649,2766.519154,Benign
192.168.43.224,50898,23.251.156.28,443,34,17151,19,2405,15,14746,2443.140462,2.897281216,6640.708501,40716.79316,Benign
172.30.6.255,56335,51.140.98.69,443,81,54290,40,3614,41,50676,600.856182,69.987099,413.1047066,5792.610435,Benign
192.168.43.233,51229,157.240.16.16,443,38,7375,22,2491,16,4884,1318.663081,75.4117,264.256077,518.1158892,Benign
172.30.15.1870,51182,54.201.241.25,443,15,2813,8,1989,7,824,3950.786759,6.845428,2324.471165,962.9785019,Benign
192.168.43.224,40612,130.207.188.158,80,7209,6273101,2946,209120,4263,6063981,835.3287837,143.2685491,11677.0918,338607.7985,Benign
172.30.1.136,50303,54.239.35.198,443,44,12970,21,2262,23,10708,512.47578,39.787328,454.8181773,2153.047322,Benign
192.168.43.233,50739,52.214.173.82,443,3,186,2,120,1,66,1868.688409,0.795316,1207.06738,663.8870587,Benign
172.30.6.255,58554,103.243.221.51,80,7,406,5,294,2,112,5814.102282,5.125998,458.8374791,174.7952301,Benign
10.0.2.15,34204,119.254.87.201,80,11,1513,6,705,5,808,2234.752136,1.015779,5552.388856,6363.58893,Malicious
172.30.1.136,51790,54.255.158.169,443,14,1626,7,1009,7,617,2977.306333,3.32685,2426.319191,1483.685769,Benign
172.30.15.1782,51094,104.244.43.112,443,18,2551,10,1570,8,981,3642.114115,5.064873,2479.825259,1549.49591,Benign
172.30.6.255,56428,52.206.38.25,443,7,402,4,228,3,174,678.979005,19.106578,95.46450442,72.85449022,Benign
172.30.15.858,50164,180.149.59.138,80,6,348,4,228,2,120,3433.511514,3.532245,516.3854716,271.7818271,Benign
192.168.43.233,51341,139.59.72.43,443,221,181261,84,9742,137,171519,3080.742152,191.398274,407.1928047,7169.092862,Benign
10.0.2.15,34496,119.254.87.201,80,11,1579,6,705,5,874,10789.17358,0.830414,6791.793009,8419.896582,Malicious
10.0.2.15,60052,119.254.87.201,80,11,1513,6,705,5,808,1063.565064,1.687954,3341.323283,3829.488244,Malicious
172.30.1.136,50226,172.217.161.4,443,3,198,3,198,0,0,385.334781,9.002288,175.9552683,0,Benign
172.30.6.255,55699,210.176.156.41,80,12,4235,7,2753,5,1482,53.27255,5.443123,4046.206562,2178.161324,Benign
172.30.15.1308,50616,139.59.82.147,443,87,66757,34,2898,53,63859,3486.973686,10.060054,2304.560194,50782.23238,Benign
192.168.215.49,34166,52.84.110.12,443,7191,6744355,2473,180831,4718,6563524,472.7221533,343.1150081,4216.218953,153033.7956,Benign
172.30.6.255,56559,172.217.166.197,443,55,22651,23,4333,32,18318,864.892568,240.521557,144.1201381,609.2759494,Benign
172.30.6.255,55945,103.231.98.43,443,33,11952,13,4975,20,6977,152.827427,71.829217,554.0920765,777.0654106,Benign
10.0.2.15,47296,119.254.87.201,80,11,1582,6,705,5,877,9137.388992,4.107906,1372.962283,1707.926131,Malicious
192.168.43.224,47684,184.50.97.22,443,17,6049,10,1437,7,4612,94.23986398,12.01172178,957.0651247,3071.666218,Benign
172.30.6.255,55779,195.201.82.80,80,391,421745,96,14830,295,406915,63.787338,38.266562,3100.356912,85069.57066,Benign
192.168.137.97,36282,52.84.103.186,443,18,7210,10,1311,8,5899,3707.041897,14.15223642,741.0842847,3334.59664,Benign
10.0.2.15,36096,119.254.87.201,80,11,1552,6,705,5,847,25114.5472,1.091689,5166.306521,6206.89592,Malicious
172.30.6.255,55702,52.84.110.25,443,26,9477,13,1859,13,7618,53.405279,5.177442,2872.460957,11771.06378,Benign
10.0.2.15,56803,119.254.87.201,80,11,1569,6,705,5,864,5506.345659,1.888672,2986.225242,3659.714339,Malicious
10.0.2.15,52098,119.254.87.201,80,11,1579,6,705,5,874,4573.133426,1.22143,4617.538459,5724.437749,Malicious
10.0.2.15,34003,119.254.87.201,80,11,1579,6,705,5,874,12293.19855,1.42397,3960.7576,4910.215805,Malicious
10.0.2.15,52413,119.254.87.201,80,11,1582,6,705,5,877,23197.84896,0.926729,6085.921559,7570.713769,Malicious
172.30.15.2051,51363,35.200.76.2,443,20,8864,10,1816,10,7048,4093.294237,4.297751,3380.372665,13119.4199,Benign
192.168.43.233,51295,216.239.32.21,80,9,534,5,294,4,240,2528.121359,15.947263,147.4861235,120.3968355,Benign
172.30.6.255,55767,195.201.82.80,80,87,97173,18,2969,69,94204,62.234582,1.70945,13894.52748,440862.2656,Benign
192.168.43.233,51697,52.216.0.24,80,11,619,6,337,5,282,1492.417587,81.406179,33.11787917,27.71288406,Benign
172.30.6.255,57635,157.240.16.39,443,20,2037,11,1229,9,808,3473.09662,61.053937,161.037936,105.8735983,Benign
192.168.43.233,51690,172.217.166.206,443,9,535,6,361,3,174,1019.031953,69.308303,41.66888922,20.08417375,Benign
10.0.2.15,44764,119.254.87.201,80,11,1579,6,705,5,874,4122.609388,1.699087,3319.429788,4115.151255,Malicious
172.30.15.1519,50827,13.232.120.220,443,15,2713,8,1575,7,1138,3525.750357,1.286339,9795.240601,7077.450035,Benign
172.30.6.255,55639,117.18.232.131,80,56,39817,24,7864,32,31953,36.633659,21.947372,2866.493537,11647.13479,Benign
172.30.1.136,50152,172.217.24.234,443,16,4722,9,1285,7,3437,142.13203,23.562446,436.287472,1166.941666,Benign
192.168.43.233,51249,157.240.16.20,443,30,5068,14,1829,16,3239,1854.221848,65.946803,221.875805,392.9227623,Benign
10.0.2.15,35304,119.254.87.201,80,11,1569,6,705,5,864,11752.72515,1.596935,3531.765538,4328.291383,Malicious
172.30.15.1738,51049,161.202.1.35,443,15,4540,9,3557,6,983,3632.575065,4.512746,6305.695025,1742.619682,Benign
172.30.6.255,58268,103.243.221.109,80,24,14008,10,5292,14,8716,5287.839868,28.035664,1510.076594,2487.117837,Benign
172.30.6.255,56147,103.243.221.109,80,46,32527,27,28272,19,4255,393.837189,12.1912,18552.39845,2792.177964,Benign
10.0.2.15,36546,219.234.85.243,80,11,1631,6,796,5,835,176.624111,3.545378,1796.141342,1884.143242,Malicious
172.30.15.303,49566,131.247.120.10,443,14,1537,6,906,8,631,666.5214,3.626218,1998.776687,1392.083984,Benign
172.30.6.255,57491,172.217.163.133,443,7,402,4,228,3,174,3052.445126,20.433916,89.26335999,68.12203789,Benign
10.0.2.15,40507,119.254.87.201,80,12,1656,7,779,5,877,19558.41193,4.618992,1349.212122,1518.946125,Malicious
192.168.43.233,50729,54.173.195.251,443,47,22558,25,12688,22,9870,1849.394236,34.13636,2973.486335,2313.076145,Benign
172.30.15.1018,50324,23.58.23.32,443,6,348,4,228,2,120,3445.30982,1.698056,1074.169521,565.3523794,Benign
172.30.6.255,57726,23.8.190.108,80,14,5576,7,615,7,4961,3765.367781,60.188667,81.74296334,659.3932376,Benign
172.30.6.255,57322,210.176.156.21,80,223,134691,110,97058,113,37633,2467.88157,581.250877,1335.850027,517.9587884,Benign
10.0.2.15,42839,119.254.87.201,80,11,1582,6,705,5,877,21961.05348,1.027625,5488.383408,6827.393261,Malicious
192.168.137.97,43482,104.31.93.239,80,25,9094,13,1435,12,7659,5243.603035,64.45008085,178.1223522,950.6892651,Benign
172.30.6.255,57871,172.217.163.133,443,18,1833,11,1204,7,629,4271.403352,79.059857,121.8317407,63.64797751,Benign
172.30.15.1083,50389,54.37.85.231,80,6,360,3,198,3,162,3452.848607,1.650032,959.9813822,785.4393127,Benign
172.30.6.255,56367,23.56.25.36,80,8,480,5,294,3,186,608.572987,23.468026,100.2214673,63.40541808,Benign
172.30.1.136,50495,74.125.68.188,5228,21,2481,11,1475,10,1006,963.940426,65.458711,180.2663056,122.9477311,Benign
10.0.2.15,37111,119.254.87.201,80,12,1656,7,779,5,877,14363.03302,3.864326,1612.700378,1815.581812,Malicious
192.168.43.224,33002,35.171.73.174,443,31,6693,17,2164,14,4529,1002.305841,61.8463051,279.9197134,585.8393633,Benign
172.30.6.255,55886,184.84.52.113,80,42,36778,13,1733,29,35045,110.587871,1.688876,8209.010016,166003.8985,Benign
10.0.2.15,36789,119.254.87.201,80,11,1513,6,705,5,808,18092.52495,1.225081,4603.77722,5276.385806,Malicious
10.0.2.15,45275,119.254.87.201,80,11,1568,6,705,5,863,12685.90765,2.150994,2622.043576,3209.678874,Malicious
172.30.15.599,49884,111.221.29.14,443,5,294,3,174,2,120,2321.488391,4.730818,294.2408691,202.9247373,Benign
172.30.6.255,58019,103.243.221.51,80,80,58091,36,22480,44,35611,4762.091079,11.956442,15041.26395,23827.15527,Benign
192.168.43.233,51031,157.240.16.39,443,42,5651,22,3369,20,2282,819.70699,88.633428,304.0839174,205.97195,Benign
10.0.2.15,59518,119.254.87.201,80,11,1579,6,705,5,874,7310.275343,2.093458,2694.107071,3339.928482,Malicious
172.30.6.255,55705,103.243.221.87,80,6,340,4,228,2,112,53.268979,5.491725,332.1360775,163.1545644,Benign
10.0.2.15,47762,119.254.87.201,80,11,1513,6,705,5,808,1784.32169,1.616986,3487.97083,3997.560894,Malicious
192.168.43.224,45786,104.237.191.1,443,11,754,6,412,5,342,2938.154549,84.02483897,39.22649589,32.56179998,Benign
172.30.15.2226,51542,52.220.171.90,443,9,510,5,282,4,228,4449.356023,8.849424,254.9318464,206.1151099,Benign
172.30.6.255,55841,103.231.98.53,80,70,46322,22,14495,48,31827,101.90731,57.076117,2031.672897,4460.990225,Benign
172.30.15.421,49695,52.84.103.186,443,31,15020,15,1900,16,13120,1616.586427,3.89379,3903.651712,26955.74235,Benign
172.30.6.255,56121,172.217.160.234,443,16,4518,9,1120,7,3398,327.509606,11.485811,780.0929338,2366.74624,Benign
172.30.1.136,51918,74.125.24.188,5228,49,4610,25,2582,24,2028,5824.865622,612.653854,33.7156126,26.48151137,Benign
10.0.2.15,57626,119.254.87.201,80,11,1582,6,705,5,877,21546.10891,2.025676,2784.255725,3463.535136,Malicious
172.30.6.255,56537,23.198.119.247,443,19,9631,9,1168,10,8463,832.144215,41.442177,225.4707806,1633.697959,Benign
192.168.43.233,51331,157.240.16.20,443,16,4976,8,1025,8,3951,3076.957894,25.262795,324.5879959,1251.167973,Benign
192.168.42.240,50913,172.217.194.189,443,3,162,2,108,1,54,13.393598,0.13304,6494.287432,3247.143716,Benign
172.30.1.136,50275,104.17.37.113,443,11,1752,6,1458,5,294,482.652491,8.785784,1327.599222,267.7051928,Benign
172.30.6.255,58417,35.190.43.164,80,6,348,4,228,2,120,5561.831308,8.205859,222.2802025,116.9895802,Benign
10.0.2.15,42470,219.234.85.243,80,11,1344,6,792,5,552,125.655108,25.45198,248.9393752,173.5032009,Malicious
172.30.6.255,56514,23.198.119.247,443,19,9253,9,1168,10,8085,831.967943,41.616627,224.5256445,1554.186503,Benign
172.30.6.255,55933,74.217.250.101,80,13,1968,7,902,6,1066,152.44155,71.617183,100.7579424,119.0775683,Benign
10.0.2.15,51680,119.254.87.201,80,11,1579,6,705,5,874,20134.57475,1.616327,3489.392926,4325.85733,Malicious
10.0.2.15,35010,119.254.87.201,80,11,1579,6,705,5,874,7966.268428,2.088593,2700.382506,3347.708242,Malicious
172.30.6.255,55868,210.176.156.55,443,80,44849,42,28725,38,16124,105.3198,306.39924,750.0018603,420.9932113,Benign
172.30.1.136,50166,172.217.161.5,443,43,8785,21,3609,22,5176,184.214318,197.930646,145.8692758,209.2045918,Benign
172.30.15.1316,50624,52.84.108.64,443,21,8718,11,1653,10,7065,3487.90361,9.107974,1451.914553,6205.551311,Benign
172.30.6.255,56825,103.243.221.51,80,38,27457,19,10180,19,17277,1311.849508,4.530879,17974.43719,30505.33903,Benign
192.168.137.97,42788,157.240.16.35,443,8,567,4,264,4,303,16.25999002,19.5710088,107.9147233,123.8566711,Benign
172.30.6.255,56887,63.251.88.51,80,7,398,4,228,3,170,1385.017993,19.570294,93.20248331,69.49307966,Benign
172.30.6.255,56482,52.109.120.4,443,17,8961,8,2116,9,6845,805.613973,7.288632,2322.520879,7513.069668,Benign
172.30.6.255,57709,210.176.156.21,80,3,198,3,198,0,0,3712.849264,9.007107,175.8611283,0,Benign
10.0.2.15,35562,119.254.87.201,80,12,1656,7,779,5,877,2865.391095,6.854559,909.1759222,1023.552354,Malicious
172.30.6.255,57822,157.240.16.39,443,19,1933,11,1179,8,754,4083.38968,61.21556,154.0784729,98.53703862,Benign
192.168.137.97,52068,172.217.161.3,443,235,145379,116,135826,119,9553,7381.174791,294.5887953,3688.558483,259.4260244,Benign
10.0.2.15,47662,115.182.31.2,80,10,1992,5,554,5,1438,51.607546,0.730012,6071.133077,15758.64506,Malicious
192.168.43.224,42026,23.251.156.28,443,14,1824,8,1116,6,708,1379.818647,21.0903748,423.3210687,268.5585274,Benign
172.30.6.255,55680,195.201.82.80,80,364,379728,100,6589,264,373139,41.815072,16.948404,3110.145356,176129.3866,Benign
172.30.15.760,50051,104.27.189.78,443,266,173703,109,8940,157,164763,2615.717083,10.580766,6759.434997,124575.4797,Benign
172.30.6.255,56646,172.30.6.35,139,3,198,3,198,0,0,1053.39495,9.00415,175.9188818,0,Benign
172.30.6.255,57981,122.15.34.34,443,24,6031,14,1275,10,4756,4692.92682,9.462707,1077.915654,4020.836744,Benign
172.30.1.136,50674,172.217.161.14,443,28,9111,13,1549,15,7562,1804.185498,146.062406,84.84044827,414.1791283,Benign
172.30.6.255,57390,103.243.221.17,80,6,340,4,228,2,112,2665.09929,17.014592,107.2021004,52.6606809,Benign
172.30.15.382,49650,62.210.213.13,80,25,14155,11,1398,14,12757,1455.376423,5.180103,2159.030429,19701.53875,Benign
172.30.15.302,49565,131.247.120.10,443,30,13101,13,1811,17,11290,666.305089,3.844529,3768.472029,23493.12491,Benign
192.168.43.224,49976,172.217.166.195,443,20,6329,11,1861,9,4468,81.09501609,29.20664602,509.7469935,1223.831041,Benign
172.30.15.1298,50606,173.241.248.220,80,14,7830,5,1647,9,6183,3471.16043,0.968603,13603.09642,51067.36196,Benign
172.30.1.136,50454,157.240.16.20,443,3,198,3,198,0,0,857.463983,9.00486,175.9050113,0,Benign
192.168.43.233,51246,172.217.166.195,443,45,6947,21,2205,24,4742,1728.75689,241.708957,72.98033229,156.9490865,Benign
172.30.15.1905,51217,52.204.146.6,443,29,7814,16,3516,13,4298,3984.835291,2.63318,10682.14099,13057.97553,Benign
172.30.1.136,50612,157.240.16.17,443,10,660,3,198,7,462,1618.364629,34.885543,45.40562834,105.9464661,Benign
10.0.2.15,41325,119.254.87.201,80,11,1582,6,705,5,877,11785.03922,1.223585,4609.405967,5733.97026,Malicious
10.0.2.15,41250,119.254.87.201,80,11,1582,6,705,5,877,12863.77072,2.230538,2528.537958,3145.429488,Malicious
172.30.6.255,56587,131.253.61.68,443,33,9486,15,1239,18,8247,900.095339,64.650502,153.3166749,1020.502517,Benign
192.168.137.97,33458,52.94.216.31,443,16,2050,11,1748,5,302,3739.70115,61.72856577,226.5401735,39.13909176,Benign
192.168.42.240,50980,172.217.163.67,443,16,5627,8,1219,8,4408,296.179005,17.092531,570.5416009,2063.123361,Benign
172.30.1.136,51526,52.216.229.171,80,54,31130,24,1792,30,29338,200.193626,116.610661,122.9390167,2012.714772,Benign
10.0.2.15,58885,119.254.87.201,80,11,1554,6,705,5,849,20729.62411,1.681669,3353.811006,4038.844743,Malicious
10.0.2.15,46522,119.254.87.201,80,11,1582,6,705,5,877,9322.339032,1.820095,3098.739352,3854.743846,Malicious
192.168.215.49,52348,158.85.224.179,443,3,214,2,140,1,74,1678.008988,0.313822079,3568.901218,1886.419215,Benign
172.30.6.255,57434,157.240.16.39,443,28,5560,15,3415,13,2145,2802.091005,61.020317,447.7197324,281.2178114,Benign
192.168.137.97,59496,103.243.221.87,443,8,544,5,338,3,206,1767.546134,50.5299937,53.51277137,32.61429261,Benign
172.30.15.1929,51241,34.201.201.2,443,11,1407,7,964,4,443,3991.667088,5.533256,1393.754419,640.4908791,Benign
192.168.43.224,51876,54.173.101.22,443,51,11086,29,4800,22,6286,42.06832275,93.35111729,411.3501918,538.6973553,Benign
192.168.215.49,40236,122.15.34.26,80,15,990,8,528,7,462,21.73132033,257.8545378,16.38132893,14.33366282,Benign
10.0.2.15,35094,119.254.87.201,80,11,1579,6,705,5,874,4362.890384,2.080584,2710.777359,3360.59491,Malicious
172.30.15.704,49991,103.243.221.17,443,6,340,4,228,2,112,2403.370161,2.98976,610.0824146,299.6896072,Benign
10.0.2.15,36813,119.254.87.201,80,11,1582,6,705,5,877,2951.425951,0.886558,6361.68192,7913.751836,Malicious
10.0.2.15,51863,119.254.87.201,80,11,1582,6,705,5,877,11004.35084,1.31499,4289.006,5335.40179,Malicious
10.0.2.15,52210,119.254.87.201,80,11,1587,6,705,5,882,6559.49682,2.111789,2670.721365,3341.242899,Malicious
192.168.215.49,52446,54.169.66.49,443,57,28887,29,6979,28,21908,513.3770016,312.2731661,178.7921796,561.2521952,Benign
192.168.215.49,38612,34.224.176.220,443,26,7658,14,3051,12,4607,43.47714563,38.55831089,633.015281,955.8509995,Benign
192.168.43.224,41520,172.217.166.193,443,17,5891,9,1212,8,4679,29.04057368,11.53590648,840.5061202,3244.825195,Benign
10.0.2.15,55322,115.182.31.2,80,10,1992,5,554,5,1438,17.253281,0.614013,7218.088216,18735.75967,Malicious
192.168.215.49,51362,18.211.245.141,443,42,7673,23,4625,19,3048,234.9774157,87.40619313,423.3109655,278.9733671,Benign
172.30.6.255,55711,173.241.248.143,80,12,3258,8,1790,4,1468,57.09528,1.638036,8742.176607,7169.561597,Benign
172.30.15.2236,51553,87.250.251.119,443,6,348,4,228,2,120,4459.351809,8.399891,217.1456749,114.2871973,Benign
10.0.2.15,50749,119.254.87.201,80,11,1579,6,705,5,874,26529.26391,2.033453,2773.607258,3438.486161,Malicious
10.0.2.15,51326,119.254.87.201,80,11,1579,6,705,5,874,24634.01446,0.993211,5678.551687,7039.793156,Malicious
192.168.43.224,41542,172.217.166.193,443,19,6312,10,1455,9,4857,32.49411549,12.62395214,922.0567274,3077.958436,Benign
10.0.2.15,40539,219.234.85.216,80,11,1857,6,795,5,1062,36785.40929,1.898667,3349.718513,4474.718316,Malicious
192.168.43.224,45784,104.237.191.1,443,25,4239,14,2244,11,1995,2937.904996,50.57158122,354.9819794,315.5922677,Benign
172.30.6.255,56986,103.243.220.231,80,15,5843,9,4215,6,1628,1452.834624,3.674503,9176.75125,3544.42492,Benign
10.0.2.15,55800,119.254.87.201,80,3,222,3,222,0,0,9828.176518,9.049331,196.2576018,0,Malicious
10.0.2.15,42655,119.254.87.201,80,11,1513,6,705,5,808,23107.84005,0.958535,5883.979197,6743.624385,Malicious
192.168.215.49,42248,111.119.15.1,443,19,5514,10,1311,9,4203,509.8314084,11.33247943,925.4814943,2967.047079,Benign
192.168.43.233,51307,104.244.42.194,443,140,35282,72,7971,68,27311,2535.413845,736.576345,86.57351058,296.6264142,Benign
192.168.137.97,48998,172.217.194.189,443,20,1384,10,684,10,700,9491.577547,45.19960881,121.0629946,123.8948776,Benign
192.168.43.224,45474,54.173.101.22,443,22,6157,12,1984,10,4173,44.57482796,12.5445217,1265.253501,2661.241361,Benign
172.30.15.2442,51776,14.139.45.128,80,119,106178,42,3501,77,102677,5418.964423,1.428707,19603.73961,574936.6385,Benign
172.30.15.1737,51048,162.247.242.19,443,32,12808,16,8555,16,4253,3631.731094,5.499404,12444.98495,6186.852248,Benign
172.30.6.255,57818,103.243.221.46,80,19,9621,9,4204,10,5417,4064.852433,38.204274,880.3203537,1134.323348,Benign
172.30.15.1611,50921,104.244.42.133,443,23,3446,12,1854,11,1592,3573.880405,3.341578,4438.621514,3811.37295,Benign
10.0.2.15,46514,119.254.87.201,80,11,1579,6,705,5,874,10458.87268,1.58469,3559.055714,4412.219425,Malicious
172.30.6.255,58172,205.185.216.10,443,38906,36549251,13968,819644,24938,35729607,5010.736518,871.518435,7523.824783,327975.6853,Benign
192.168.137.97,47206,157.240.16.20,443,15,4856,9,1183,6,3673,225.2783537,1.143998134,8272.740767,25685.35658,Benign
192.168.43.224,57222,139.59.82.147,443,21,7301,12,1418,9,5883,2493.238072,20.75368666,546.6016801,2267.741667,Benign
192.168.137.97,60114,172.217.161.4,443,21,5067,14,2061,7,3006,3759.740075,107.3892539,153.5349152,223.9330205,Benign
172.30.6.255,56133,66.117.28.68,443,26,9715,14,2480,12,7235,351.298845,43.154306,459.7455466,1341.23348,Benign
172.30.1.136,50383,157.240.16.20,443,1082,789710,471,34592,611,755118,690.138127,137.015735,2019.738828,44089.41791,Benign
172.30.1.136,51771,157.240.16.20,443,101,56219,47,4409,54,51810,2973.346665,41.08314,858.5517076,10088.81015,Benign
172.30.15.1286,50594,87.248.118.22,443,14,1621,8,1014,6,607,3469.811335,7.136094,1136.756326,680.4843098,Benign
172.30.6.255,56003,52.109.120.4,443,17,8977,8,2132,9,6845,225.271246,14.030118,1215.67046,3903.032034,Benign
192.168.43.224,42960,52.84.110.129,443,27,3669,13,1306,14,2363,24.34341307,199.9856682,52.24374374,94.52677371,Benign
172.30.15.266,49529,52.114.74.45,443,28,11922,16,6708,12,5214,106.803293,4.033208,13305.53743,10342.13956,Benign
172.30.15.791,50083,52.84.108.93,443,11,1344,6,906,5,438,2674.81965,1.497985,4838.499718,2339.142248,Benign
192.168.137.97,39662,192.168.125.7,8380,159,111557,82,7821,77,103736,8302.618635,103.7351751,603.1512451,8000.063618,Benign
10.0.2.15,58049,119.254.87.201,80,11,1579,6,705,5,874,25810.76877,2.048071,2753.810781,3413.944145,Malicious
192.168.43.233,51302,52.175.39.99,443,14,6089,8,1069,6,5020,2901.827842,9.732224,878.7302882,4126.497705,Benign
10.0.2.15,50780,119.254.87.201,80,11,1579,6,705,5,874,22953.20605,1.547924,3643.589737,4517.017631,Malicious
10.0.2.15,56773,119.254.87.201,80,11,1579,6,705,5,874,14543.20524,0.823181,6851.47009,8493.879232,Malicious
10.0.2.15,35341,119.254.87.201,80,11,1579,6,705,5,874,1093.565844,1.921893,2934.606661,3638.079747,Malicious
10.0.2.15,33311,219.234.85.243,80,8,944,4,688,4,256,186.424277,64.300733,85.59778004,31.85033676,Malicious
172.30.15.2346,51680,192.168.121.37,443,19,6208,10,2390,9,3818,5313.050123,4.850721,3941.682072,6296.795878,Benign
172.30.15.622,49909,23.198.105.137,443,9,534,5,294,4,240,2391.706322,4.589957,512.4231011,418.3045724,Benign
192.168.43.233,50728,54.173.195.251,443,7,402,4,228,3,174,1849.365799,14.687865,124.1841479,94.7721129,Benign
172.30.6.255,55808,204.11.109.67,80,7,402,4,228,3,174,91.005879,11.138354,163.7584871,124.9735823,Benign
192.168.43.224,51490,104.244.42.8,443,14,980,9,618,5,362,38.06352745,13.80479929,358.1363188,209.7821155,Benign
172.30.1.136,51911,172.217.160.238,443,37,18029,23,7347,14,10682,5744.857414,72.544014,810.2115772,1177.988304,Benign
10.0.2.15,59831,119.254.87.201,80,11,1582,6,705,5,877,701.292227,1.760946,3202.823937,3984.222117,Malicious
172.30.6.255,58487,176.34.147.227,443,23,8815,12,3338,11,5477,5683.740323,5.492547,4861.860991,7977.355496,Benign
172.30.6.255,57824,103.243.221.87,80,71,48014,43,40048,28,7966,4102.833129,19.317068,16585.53979,3299.051388,Benign
172.30.6.255,57893,103.243.221.87,80,39,24320,23,20226,16,4094,4368.834964,37.225885,4346.652873,879.8179009,Benign
172.30.15.530,49814,169.44.165.64,443,6,348,4,228,2,120,2246.539172,9.762554,186.8363545,98.33492342,Benign
172.30.6.255,56346,202.58.9.200,80,11,1646,6,879,5,767,607.491564,24.482992,287.2197973,250.6229631,Benign
172.30.1.136,50657,180.149.59.225,80,16,6738,8,846,8,5892,1775.691673,19.805295,341.7267958,2379.969599,Benign
172.30.6.255,56262,104.16.91.60,80,13,1666,7,942,6,724,529.952133,58.956374,127.8233292,98.24213409,Benign
10.0.2.15,43589,119.254.87.201,80,11,1582,6,705,5,877,15053.75964,1.221536,4617.137768,5743.5884,Malicious
172.30.15.2044,51356,13.107.21.200,443,30,10494,14,2444,16,8050,4090.902156,6.657993,2936.62069,9672.584516,Benign
192.168.43.233,51280,52.175.28.154,443,4,240,2,120,2,120,2431.92252,119.209587,8.053043586,8.053043586,Benign
10.0.2.15,57457,119.254.87.201,80,11,1582,6,705,5,877,23047.79729,3.264971,1727.427288,2148.870541,Malicious
10.0.2.15,37172,119.254.87.201,80,12,1656,7,779,5,877,16797.91261,4.16877,1494.925362,1682.990426,Malicious
172.30.1.136,51791,54.255.158.169,443,14,1626,7,1009,7,617,2977.306614,3.326567,2426.525604,1483.81199,Benign
10.0.2.15,59042,119.254.87.201,80,11,1579,6,705,5,874,8329.337467,0.823844,6845.956273,8487.043664,Malicious
172.30.15.467,49742,52.175.23.79,443,30,10211,17,2361,13,7850,1684.725195,64.329349,293.6140392,976.2262634,Benign
172.30.6.255,57580,157.240.16.39,443,19,1933,10,1125,9,808,3290.100343,61.064466,147.385224,105.8553431,Benign
172.30.6.255,57496,103.243.221.109,80,24,13737,11,5329,13,8408,3057.8515,15.17802,2808.798513,4431.671588,Benign
10.0.2.15,39998,119.254.87.201,80,11,1513,6,705,5,808,25054.48318,1.653178,3411.610849,3910.044774,Malicious
192.168.137.97,52790,74.125.68.188,5228,92,8391,46,3124,46,5267,28.86135306,1776.843864,14.06538892,23.71395757,Benign
192.168.42.240,50973,64.233.184.94,443,182,36020,84,23316,98,12704,288.232691,320.641681,581.7334771,316.9644061,Benign
172.30.6.255,56215,54.36.212.191,80,7,614,5,282,2,332,470.031303,20.813731,108.3899854,127.608068,Benign
172.30.15.1964,51276,35.171.73.174,443,15,4753,8,1087,7,3666,4075.850459,1.39764,6221.916946,20983.94436,Benign
172.30.15.449,49723,52.84.110.254,443,15,3281,8,1648,7,1633,1632.6295,7.94462,1659.487804,1644.383243,Benign
10.0.2.15,52956,119.254.87.201,80,11,1593,6,705,5,888,821.414794,1.221677,4616.60488,5814.957636,Malicious
172.30.6.255,57789,103.231.98.53,80,290,154421,148,140605,142,13816,4041.835932,588.16546,1912.455043,187.9199095,Benign
192.168.43.224,55704,172.217.166.196,80,23,3979,12,1875,11,2104,2216.801754,242.4735028,61.86242962,69.41789436,Benign
172.30.6.255,57694,172.217.163.133,443,19,1899,11,1204,8,695,3670.40996,130.093044,74.03931605,42.73864174,Benign
172.30.6.255,58086,122.15.34.40,80,19,10816,9,918,10,9898,4857.691714,14.825199,495.3727771,5341.176196,Benign
172.30.6.255,56320,63.251.88.56,80,7,398,4,228,3,170,590.942006,15.129099,120.5623679,89.89299363,Benign
172.30.15.298,49561,162.125.82.3,443,6,348,4,228,2,120,632.7293,0.341734,5337.48471,2809.202479,Benign
172.30.6.255,58299,157.240.16.17,443,13,1754,8,1037,5,717,5326.390235,7.562849,1096.941113,758.4443376,Benign
10.0.2.15,48103,119.254.87.201,80,11,1579,6,705,5,874,20972.41278,1.582683,3563.568952,4417.814559,Malicious
172.30.1.136,51866,172.217.160.228,443,10,600,6,360,4,240,4169.091023,14.810547,194.4560184,129.6373456,Benign
172.30.6.255,57744,103.231.98.53,80,39,17419,20,15673,19,1746,3844.890557,66.039998,1898.606962,211.5081833,Benign
192.168.43.233,51299,104.16.88.20,80,13,1427,7,751,6,676,2530.59877,60.931039,98.60327509,88.75607718,Benign
172.30.15.2472,51806,14.139.45.128,80,149,143575,48,3011,101,140564,5423.735478,2.963174,8129.121003,379495.7704,Benign
172.30.6.255,58441,103.231.98.53,80,19,6478,10,5744,9,734,5616.850037,2.258316,20347.90525,2600.167558,Benign
192.168.43.224,35068,34.232.42.95,443,80,37458,48,19976,32,17482,3058.358315,186.1864086,858.3225876,751.1611672,Benign
10.0.2.15,55470,119.254.87.201,80,11,1559,6,705,5,854,21092.5314,1.215798,4638.928506,5619.354531,Malicious
172.30.15.1478,50786,151.139.104.66,443,78,57610,31,2724,47,54886,3511.216854,6.248394,3487.616178,70272.13713,Benign
10.0.2.15,57765,119.254.87.201,80,11,1582,6,705,5,877,6196.90142,1.824842,3090.678535,3844.716419,Malicious
192.168.43.233,51341,34.208.98.48,443,21,3362,12,2107,9,1255,3379.26692,85.55973,197.0085693,117.3449238,Benign
172.30.1.136,50349,172.217.161.3,443,16,5540,9,1556,7,3984,618.377668,11.534781,1079.170901,2763.12138,Benign
192.168.137.97,56488,18.208.55.232,443,3,198,2,132,1,66,1.1700381,0.223841426,4717.625414,2358.812707,Benign
192.168.43.233,51486,52.84.110.163,443,38,8059,20,2774,18,5285,3818.69009,189.379186,117.1828883,223.2557912,Benign
10.0.2.15,46978,119.254.87.201,80,11,1579,6,705,5,874,25444.8075,0.898023,6280.46275,7785.992118,Malicious
192.168.43.233,50958,163.53.78.128,80,12,1132,7,414,5,718,473.553037,16.526692,200.4030813,347.558967,Benign
172.30.15.522,49805,162.247.242.19,443,19,3059,9,2193,10,866,2138.748137,7.60404,2307.194597,911.0946286,Benign
172.30.15.685,49972,23.23.150.12,80,6,348,4,228,2,120,2399.12382,7.261128,251.2006399,132.2108631,Benign
10.0.2.15,53399,119.254.87.201,80,11,1593,6,705,5,888,1303.824522,1.619965,3481.5567,4385.279929,Malicious
10.0.2.15,36585,219.234.85.243,80,8,943,4,687,4,256,182.564958,64.222145,85.57795757,31.8893117,Malicious
172.30.6.255,57429,52.213.19.114,443,19,6444,10,1207,9,5237,2796.640515,34.103537,283.1377871,1228.494276,Benign
10.0.2.15,37978,119.254.87.201,80,11,1579,6,705,5,874,13586.97287,1.226513,4598.402137,5700.714138,Malicious
172.30.15.1200,50508,184.29.25.201,80,18,7793,10,5047,8,2746,3465.450231,1.750559,23064.6325,12549.13431,Benign
192.168.43.233,51362,172.217.160.238,443,20,5866,10,1339,10,4527,3436.295256,28.587205,374.7130928,1266.860471,Benign
172.30.6.255,56200,52.84.111.68,80,14,2348,8,892,6,1456,466.918069,121.975668,58.50347136,95.4944555,Benign
10.0.2.15,54154,119.254.87.201,80,11,1559,6,705,5,854,22777.56096,1.079935,5222.536542,6326.306676,Malicious
192.168.215.49,33032,52.206.154.207,443,35,8368,18,2941,17,5427,1583.519553,11.48810598,2048.031246,3779.213048,Benign
172.30.6.255,57662,103.243.221.46,80,22,10726,10,4552,12,6174,3556.841342,15.210035,2394.208823,3247.329806,Benign
192.168.137.97,41596,52.76.199.39,443,9,626,6,412,3,214,28.91630586,13.63447365,241.7401715,125.5640697,Benign
192.168.137.97,41108,157.240.16.20,443,16,5159,9,1183,7,3976,2906.697236,16.0279071,590.4701057,1984.53858,Benign
192.168.43.233,51330,157.240.16.20,443,74,40812,33,2896,41,37916,3076.947448,66.582937,347.9570149,4555.641635,Benign
172.30.15.1781,51093,161.202.1.35,443,30,12760,18,10016,12,2744,3641.871633,5.305372,15103.18221,4137.692889,Benign
192.168.43.233,51279,52.175.28.154,443,4,240,2,120,2,120,2431.745017,121.534316,7.899003603,7.899003603,Benign
192.168.43.224,39850,198.252.206.25,443,104,13333,52,5826,52,7507,1904.688803,1509.956428,30.86711585,39.77333311,Benign
172.30.15.2080,51392,34.205.118.138,443,6,348,4,228,2,120,4123.079856,4.496998,405.6039162,213.4757454,Benign
10.0.2.15,45231,119.254.87.201,80,11,1582,6,705,5,877,12143.00262,1.352423,4170.292874,5187.72603,Malicious
192.168.137.97,35530,35.241.16.233,443,72,22258,37,4432,35,17826,1765.454732,240.5821088,147.37588,592.7622828,Benign
172.30.15.894,50200,210.176.156.62,80,14,5165,8,3648,6,1517,3438.484391,8.685321,3360.152146,1397.300111,Benign
172.30.6.255,56162,157.240.16.39,443,28,5421,15,3274,13,2147,423.093043,61.021429,429.2262641,281.4748897,Benign
172.30.15.423,49697,59.63.81.183,443,93,58493,42,3693,51,54800,1616.771416,4.080138,7240.931557,107447.3461,Benign
172.30.15.1815,51127,54.218.8.216,443,15,5005,8,1087,7,3918,3743.440195,3.568481,2436.891215,8783.569255,Benign
192.168.43.233,50963,163.53.78.128,443,218,182907,83,11328,135,171579,480.52574,66.013044,1372.81959,20793.34502,Benign
192.168.43.224,51694,54.152.129.23,443,17,1174,9,614,8,560,28.38812287,15.56599959,315.5595612,287.806766,Benign
10.0.2.15,48997,119.254.87.201,80,11,1582,6,705,5,877,518.708377,1.179114,4783.25251,5950.230427,Malicious
172.30.15.2114,51426,151.101.66.2,443,20,9062,11,1240,9,7822,4178.04421,9.310067,1065.513277,6721.326495,Benign
172.30.15.913,50219,184.29.25.103,80,13,3215,7,2003,6,1212,3439.760544,2.338132,6853.3342,4146.900175,Benign
172.30.6.255,56148,103.243.221.87,80,24,15228,9,2921,15,12307,393.844612,12.18351,1918.002283,8081.086649,Benign
10.0.2.15,32905,119.254.87.201,80,11,1579,6,705,5,874,14453.10235,3.067032,1838.911364,2279.728415,Malicious
10.0.2.15,45938,119.254.87.201,80,11,1582,6,705,5,877,11389.78803,1.622703,3475.682241,4323.650107,Malicious
172.30.6.255,58279,52.213.19.114,443,19,6444,10,1207,9,5237,5289.021465,26.838571,359.7807052,1561.036912,Benign
172.30.15.803,50095,52.84.108.93,443,18,3676,10,1641,8,2035,2685.648915,10.656954,1231.871696,1527.641013,Benign
10.0.2.15,53119,119.254.87.201,80,11,1579,6,705,5,874,5055.854522,1.220339,4621.666602,5729.555476,Malicious
10.0.2.15,45102,119.254.87.201,80,11,1579,6,705,5,874,10253.5003,1.381307,4083.089422,5061.87256,Malicious
172.30.6.255,55713,157.240.16.39,443,25,5220,13,3166,12,2054,57.100765,61.015143,415.1100654,269.310194,Benign
10.0.2.15,43266,119.254.87.201,80,11,1587,6,705,5,882,24636.9689,6.260953,900.8213286,1126.984981,Malicious
192.168.43.224,56188,185.199.108.153,80,6,412,4,272,2,140,804.5124916,29.73651788,73.17601909,37.66412747,Benign
10.0.2.15,59252,119.254.87.201,80,12,1626,7,779,5,847,18029.29855,249.696778,24.95827159,27.13691404,Malicious
10.0.2.15,50160,119.254.87.201,80,11,1513,6,705,5,808,23528.2734,2.021872,2789.494093,3197.037201,Malicious
172.30.15.2379,51713,14.139.45.128,80,10,1384,5,657,5,727,5334.676948,0.32246,16299.69609,18036.34559,Benign
10.0.2.15,49907,119.254.87.201,80,11,1579,6,705,5,874,11755.0196,1.032617,5461.850812,6771.145546,Malicious
192.168.137.97,39750,172.217.160.234,443,93,17154,46,5533,47,11621,142.2681709,471.7745231,93.82448147,197.0602384,Benign
172.30.15.1374,50682,151.101.130.2,443,39,13606,18,2363,21,11243,3494.228557,2.805564,6738.039125,32059.15103,Benign
172.30.6.255,56677,74.125.24.188,5228,7,403,4,229,3,174,1154.114562,55.377559,33.08199265,25.1365359,Benign
172.30.15.1154,50462,180.149.59.136,80,101,87464,39,3831,62,83633,3459.396,7.636133,4013.54979,87618.17009,Benign
172.30.15.2140,51452,34.197.5.59,443,18,7030,9,1141,9,5889,4178.608658,9.02115,1011.844388,5222.394041,Benign
172.30.15.415,49687,192.168.121.7,443,19,4763,10,2292,9,2471,1590.112767,0.350067,52378.54468,56469.19018,Benign
172.30.6.255,57172,103.243.221.87,80,71,47950,42,39926,29,8024,2007.836185,26.445376,12078.02831,2427.343064,Benign
192.168.43.224,58262,174.129.238.218,443,96,46505,55,22487,41,24018,567.7626648,236.5009403,760.656595,812.4449726,Benign
10.0.2.15,40169,119.254.87.201,80,11,1582,6,705,5,877,22083.65888,1.423143,3963.059229,4929.933253,Malicious
172.30.6.255,57195,103.243.221.75,80,17,5588,9,4299,8,1289,2072.851707,15.174628,2266.414702,679.5553736,Benign
172.30.6.255,58005,52.114.6.46,443,92,64941,56,56610,36,8331,4738.15915,5.698441,79474.36852,11695.83049,Benign
192.168.137.97,47760,151.101.64.223,443,40,18725,21,2612,19,16113,2008.400266,0.594884954,35126.11953,216687.2756,Benign
172.30.15.1551,50860,64.74.232.52,443,6,348,4,228,2,120,3551.255705,6.014534,303.2653901,159.6133632,Benign
10.0.2.15,42448,119.254.87.201,80,11,1579,6,705,5,874,5894.22836,0.886916,6359.114054,7883.497423,Malicious
172.30.15.350,49618,204.4.185.73,80,3,198,3,198,0,0,1158.361471,9.010797,175.7891117,0,Benign
172.30.6.255,58302,157.240.16.17,443,15,4921,8,1025,7,3896,5326.657369,7.294038,1124.205824,4273.078917,Benign
172.30.6.255,56329,77.66.11.200,80,7,402,4,228,3,174,591.729486,14.273287,127.7911668,97.52483783,Benign
172.30.6.255,57573,192.168.56.1,7680,3,198,3,198,0,0,3282.271467,9.004297,175.9160099,0,Benign
172.30.6.255,58153,210.176.156.41,80,14,4353,7,3916,7,437,4957.840615,0.881141,35553.90114,3967.582941,Benign
192.168.43.233,51352,52.216.18.144,443,29,7894,13,1964,16,5930,3424.002076,10.610339,1480.819793,4471.110678,Benign
192.168.137.97,56072,52.205.114.175,443,7,478,4,272,3,206,347.6947719,8.312243118,261.782526,198.261766,Benign
192.168.215.49,58510,104.113.219.181,443,45,9430,23,4625,22,4805,612.5543397,367.2668092,100.7441976,104.6650529,Benign
192.168.43.233,51420,13.107.246.10,443,19,4992,8,1056,11,3936,3649.410192,125.033118,67.56609877,251.8372772,Benign
192.168.215.49,49198,104.237.191.1,443,12,808,7,470,5,338,71.86839991,163.4019658,23.01073908,16.54814853,Benign
192.168.42.240,50903,172.217.161.5,443,407,258090,149,33909,258,224181,28.847861,150.599616,1801.279493,11908.71562,Benign
192.168.43.224,36342,52.20.136.189,443,48,22150,26,8331,22,13819,2882.596162,71.19248847,936.1661803,1552.860454,Benign
172.30.15.1318,50626,104.244.43.48,443,8,480,5,294,3,186,3488.120331,9.006664,261.1399737,165.2110038,Benign
192.168.137.97,35150,104.17.41.113,443,3828,2175595,1816,118677,2012,2056918,2.840689143,1982.457506,478.9086257,8300.477537,Benign
172.30.15.745,50034,158.85.224.180,443,7,402,4,228,3,174,2547.818027,8.652145,210.8147748,160.8849597,Benign
172.30.1.136,51552,204.79.197.213,443,10,800,6,552,4,248,729.831459,11.263004,392.0801236,176.1519396,Benign
10.0.2.15,51739,119.254.87.201,80,11,1579,6,705,5,874,2204.748405,2.021914,2789.436148,3458.109494,Malicious
10.0.2.15,47837,119.254.87.201,80,11,1579,6,705,5,874,8266.639769,2.083082,2707.526636,3356.564936,Malicious
192.168.43.224,32840,151.101.112.193,443,9,626,6,412,3,214,807.3119659,27.08184295,121.7051589,63.21578642,Benign
10.0.2.15,48636,119.254.87.201,80,11,1582,6,705,5,877,15474.23238,1.227395,4595.097748,5716.171241,Malicious
10.0.2.15,36726,119.254.87.201,80,12,1656,7,779,5,877,3554.311785,3.98169,1565.164541,1762.065856,Malicious
172.30.15.2480,51814,14.139.45.128,80,592,558369,208,12006,384,546363,5424.384547,9.910282,9691.752465,441047.389,Benign
192.168.43.233,51245,157.240.16.20,443,9,512,5,284,4,228,1593.535683,105.483916,21.53882873,17.29173574,Benign
172.30.15.417,49689,192.168.121.7,443,35,20014,15,1950,20,18064,1604.193512,6.274992,2486.058946,23029.83016,Benign
10.0.2.15,37833,119.254.87.201,80,11,1579,6,705,5,874,23195.25053,1.02509,5501.955926,6820.864509,Malicious
10.0.2.15,37924,119.254.87.201,80,11,1582,6,705,5,877,16800.72161,1.426774,3952.973631,4917.387056,Malicious
172.30.6.255,57826,103.243.221.46,80,16,5462,9,4234,7,1228,4102.837099,3.542089,9562.718497,2773.504562,Benign
172.30.15.2324,51654,52.84.108.208,443,16,3038,9,2117,7,921,5042.116833,5.564602,3043.524047,1324.083915,Benign
172.30.6.255,56394,151.101.2.2,80,16,2339,10,1254,6,1085,650.861545,205.241575,48.87898565,42.29162634,Benign
172.30.6.255,58503,35.190.43.164,80,10,1573,6,1119,4,454,5747.844196,1.222781,7321.016601,2970.278406,Benign
10.0.2.15,44923,119.254.87.201,80,11,1579,6,705,5,874,5598.532271,1.701192,3315.322433,4110.0593,Malicious
172.30.1.136,51763,172.217.160.228,443,14,1743,7,1181,7,562,2948.627436,17.258114,547.4526359,260.5151409,Benign
172.30.1.136,50558,184.29.24.13,443,31,11537,13,1429,18,10108,1472.293131,17.385715,657.5513288,4651.174829,Benign
172.30.1.136,50149,172.217.161.3,443,22,7037,11,1333,11,5704,132.055408,13.834874,770.8057189,3298.331448,Benign
10.0.2.15,35407,119.254.87.201,80,11,1582,6,705,5,877,22654.5217,1.700465,3316.739833,4125.93026,Malicious
172.30.15.998,50304,52.221.102.82,443,6,340,4,228,2,112,3443.105876,3.956529,461.010143,226.4611229,Benign
192.168.42.240,50940,216.58.221.67,443,41,8283,22,2611,19,5672,160.589279,50.95208,409.9538233,890.5622695,Benign
172.30.1.136,51532,172.217.161.16,80,59,34702,27,3736,32,30966,302.699888,95.781619,312.0431698,2586.383511,Benign
192.168.43.233,51067,52.70.107.220,443,35,14249,19,6311,16,7938,898.100746,108.492654,465.3586961,585.3299524,Benign
10.0.2.15,47107,119.254.87.201,80,11,1582,6,705,5,877,2294.808824,1.36156,4142.307353,5152.912835,Malicious
10.0.2.15,44136,119.254.87.201,80,11,1582,6,705,5,877,23648.41404,5.174189,1090.025896,1355.961292,Malicious
10.0.2.15,56561,119.254.87.201,80,11,1582,6,705,5,877,16375.09313,1.246509,4524.636405,5628.519329,Malicious
172.30.15.2294,51622,74.125.68.188,5228,40,7282,20,1930,20,5352,4920.613133,542.285874,28.47206748,78.95466589,Benign
172.30.15.2437,51771,14.139.45.128,80,28,18628,10,932,18,17696,5418.724273,1.274805,5848.73765,111050.7097,Benign
172.30.6.255,56069,52.4.123.24,80,13,1420,7,800,6,620,286.544943,61.170907,104.6248995,81.08429715,Benign
172.30.15.594,49879,23.56.25.241,443,19,7963,11,1273,8,6690,2321.316245,4.743037,2147.147492,11283.90944,Benign
10.0.2.15,49858,119.254.87.201,80,11,1582,6,705,5,877,7908.765469,2.081158,2710.029705,3371.200072,Malicious
10.0.2.15,45657,119.254.87.201,80,11,1579,6,705,5,874,9052.212553,1.957367,2881.421828,3572.145643,Malicious
192.168.215.49,45738,23.57.214.252,443,48,8333,27,5648,21,2685,1252.224403,589.3671557,76.66528337,36.44587214,Benign
192.168.215.49,49258,63.215.202.75,443,38,8007,20,2932,18,5075,790.3400353,439.2100688,53.40496875,92.43868227,Benign
10.0.2.15,51850,119.254.87.201,80,11,1582,6,705,5,877,10313.45091,1.317182,4281.868413,5326.522834,Malicious
172.30.6.255,58269,103.243.221.109,80,34,22448,13,5455,21,16993,5287.840098,28.035609,1556.591833,4848.976172,Benign
192.168.43.224,49834,172.217.166.195,443,17,5876,9,1377,8,4499,31.48749049,12.46791774,883.5476966,2886.769126,Benign
10.0.2.15,55536,119.254.87.201,80,11,1579,6,705,5,874,8149.160727,2.05945,2738.595256,3395.081211,Malicious
192.168.43.224,47658,54.82.135.50,443,29,6585,14,1990,15,4595,1158.468878,61.54323244,258.6799453,597.3036927,Benign
10.0.2.15,48922,119.254.87.201,80,11,1579,6,705,5,874,19113.52422,2.178341,2589.126312,3209.782123,Malicious
192.168.43.224,56878,54.85.133.68,443,116,16236,65,7024,51,9212,1236.976908,522.1073097,107.6253846,141.1510596,Benign
172.30.6.255,57424,103.243.221.17,80,53,36260,32,30284,21,5976,2792.840524,3.959635,61185.43755,12073.84014,Benign
192.168.43.233,51233,23.66.249.177,80,16,5699,7,603,9,5096,1501.528526,18.309426,263.4708483,2226.612675,Benign
192.168.137.97,40884,103.211.218.251,80,14,4944,8,2673,6,2271,610.8999111,10.51546683,2033.575907,1727.740698,Benign
172.30.6.255,57098,157.240.16.39,443,28,5423,15,3274,13,2149,1765.095723,61.031086,429.1583473,281.6925132,Benign
172.30.1.136,50420,172.217.161.4,443,3,198,3,198,0,0,833.104053,9.001447,175.9717077,0,Benign
192.168.43.233,51419,13.107.246.10,443,19,4992,8,1056,11,3936,3649.368008,124.611845,67.79451825,252.6886589,Benign
172.30.6.255,58220,157.240.16.17,443,414,337472,177,12144,237,325328,5165.049788,8.898223,10918.135,292488.0619,Benign
172.30.6.255,57661,103.243.221.46,80,16,5480,9,4245,7,1235,3556.839078,15.212298,2232.404335,649.4745238,Benign
172.30.6.255,57123,117.18.237.29,80,10,1590,6,574,4,1016,1856.451634,109.832663,41.80905638,74.00348656,Benign
192.168.43.233,51028,52.114.6.46,443,19,7839,10,3146,9,4693,809.180327,1.667052,15097.3095,22521.1931,Benign
192.168.137.97,56734,103.231.98.48,443,7,478,4,272,3,206,377.0088994,13.94624456,156.0276669,118.1680124,Benign
172.30.6.255,56382,103.243.221.75,80,27,16903,11,4209,16,12694,648.897304,28.167475,1195.421315,3605.292984,Benign
172.30.6.255,57969,103.243.221.17,80,17,5552,9,4263,8,1289,4646.842471,50.215937,679.1469409,205.3531332,Benign
172.30.6.255,57880,172.217.166.206,443,18,1837,11,1208,7,629,4289.414291,61.018969,158.3769795,82.46615901,Benign
192.168.137.97,35458,104.198.143.177,80,11,977,6,491,5,486,10223.81318,1.720729261,2282.753068,2259.50711,Benign
192.168.137.97,39770,192.168.125.6,80,1475,1346070,611,42302,864,1303768,8327.367827,79.25218629,4270.115638,131607.0192,Benign
10.0.2.15,40584,119.254.87.201,80,11,1513,6,705,5,808,8356.67456,1.425343,3956.942294,4535.048757,Malicious
172.30.6.255,58462,52.229.171.86,443,29,10553,16,2294,13,8259,5661.140564,129.116016,142.1357363,511.7258265,Benign
10.0.2.15,50096,119.254.87.201,80,11,1579,6,705,5,874,6859.817137,1.353365,4167.390172,5166.381575,Malicious
172.30.6.255,57964,103.243.221.75,80,6,348,4,228,2,120,4630.878935,16.152285,112.9251991,59.43431533,Benign
10.0.2.15,57383,119.254.87.201,80,11,1552,6,705,5,847,8179.194006,2.073882,2719.537563,3267.302576,Malicious
172.30.15.2541,51875,192.168.121.146,80,5,717,3,597,2,120,5501.85766,1.523779,3134.312784,630.0126199,Benign
10.0.2.15,45003,119.254.87.201,80,3,222,3,222,0,0,1241.80613,9.059025,196.0475879,0,Malicious
172.30.6.255,56553,172.217.166.210,443,32,7017,17,2364,15,4653,845.159249,10.956581,1726.085902,3397.410196,Benign
172.30.6.255,58018,103.243.221.46,80,7,406,5,294,2,112,4762.083856,11.964418,196.5829011,74.88872422,Benign
192.168.137.97,48656,54.255.158.169,443,16,5141,9,1257,7,3884,347.746121,15.42758154,651.8195984,2014.055147,Benign
172.30.6.255,56586,131.253.61.68,443,33,14088,13,5072,20,9016,900.096017,65.276604,621.6009644,1104.959443,Benign
172.30.6.255,57327,173.241.248.220,80,119,61816,59,27621,60,34195,2467.943909,581.218906,380.1803378,470.6660385,Benign
172.30.15.2290,51615,40.77.224.11,443,27,11950,16,1905,11,10045,4801.917246,109.448377,139.2437277,734.2274249,Benign
10.0.2.15,51181,119.254.87.201,80,11,1579,6,705,5,874,12022.84837,1.240916,4545.029639,5634.547383,Malicious
172.30.15.1994,51306,34.255.159.221,443,16,4989,8,1087,8,3902,4077.468095,4.981118,1745.792812,6266.866193,Benign
10.0.2.15,38323,119.254.87.201,80,12,1653,7,779,5,874,19924.37575,5.245646,1188.032894,1332.914955,Malicious
172.30.6.255,57846,103.243.221.109,80,23,10731,11,4325,12,6406,4205.860985,18.20525,1900.550665,2815.012153,Benign
10.0.2.15,42397,119.254.87.201,80,11,1579,6,705,5,874,2503.26497,1.564272,3605.511062,4469.810877,Malicious
172.30.6.255,55730,173.241.248.143,443,6,348,4,228,2,120,58.006375,0.728634,2503.314421,1317.533906,Benign
172.30.6.255,55622,157.240.16.17,443,15,4922,8,1025,7,3897,5.266089,0.087012,94239.87496,358295.4075,Benign
172.30.1.136,50389,172.217.161.3,443,3,198,3,198,0,0,734.367054,9.000454,175.9911222,0,Benign
172.30.6.255,57258,13.229.196.49,443,7,406,5,294,2,112,2252.523157,18.431825,127.6053782,48.61157265,Benign
172.30.15.1777,51089,161.202.1.35,443,15,4640,9,3657,6,983,3641.824449,5.352411,5465.947963,1469.244421,Benign
172.30.1.136,50235,74.125.68.188,443,9,535,5,295,4,240,432.823906,58.698609,40.20538204,32.70946335,Benign
172.30.1.136,51537,13.107.4.52,80,2,132,2,132,0,0,695.511853,8.999949,117.3339982,0,Benign
192.168.43.224,54920,151.101.194.217,443,21,9520,12,1422,9,8098,3245.059776,19.30754168,589.1998156,3355.37279,Benign
172.30.6.255,56077,157.240.16.39,443,19,1933,10,1125,9,808,301.102731,60.090204,149.7748285,107.5716102,Benign
192.168.43.233,51513,13.107.140.254,443,59,18270,31,3396,28,14874,3902.403089,133.045655,204.2005806,894.3696808,Benign
172.30.15.352,49620,204.4.185.73,80,3,198,3,198,0,0,1158.364619,9.001658,175.9675829,0,Benign
192.168.215.49,49408,172.217.161.14,443,1,66,1,66,0,0,6.607276103,0,0,0,Benign
172.30.6.255,58041,104.25.171.105,443,38,11890,21,2151,17,9739,4815.199732,57.340906,300.0998973,1358.750767,Benign
10.0.2.15,37872,119.254.87.201,80,11,1579,6,705,5,874,13436.75624,2.506648,2250.016755,2789.382474,Malicious
172.30.6.255,56387,209.191.163.209,80,10,2464,6,1283,4,1181,650.888136,26.248746,391.0282038,359.9410044,Benign
192.168.43.233,51177,172.217.166.206,443,46,8325,21,2299,25,6026,1042.629572,242.379613,75.88096941,198.8946158,Benign
172.30.1.136,50182,172.217.161.3,443,1,66,1,66,0,0,356.840064,0,0,0,Benign
172.30.6.255,57752,172.217.166.206,443,17,1779,10,1150,7,629,3852.401991,126.09243,72.96234992,39.90723313,Benign
10.0.2.15,42291,119.254.87.201,80,11,1579,6,705,5,874,23976.17832,2.088205,2700.884252,3348.330265,Malicious
10.0.2.15,50417,119.254.87.201,80,11,1579,6,705,5,874,6765.108804,2.142584,2632.335535,3263.349302,Malicious
172.30.6.255,56476,52.114.76.35,443,32,17275,19,10058,13,7217,782.704202,1.394826,57687.48217,41392.97662,Benign
10.0.2.15,33202,119.254.87.201,80,11,1579,6,705,5,874,23348.05734,5.117874,1102.020097,1366.19229,Malicious
192.168.137.97,41232,184.29.25.22,443,6,412,4,272,2,140,122.4770673,10.70962758,203.1816685,104.5787999,Benign
10.0.2.15,49613,119.254.87.201,80,11,1582,6,705,5,877,7665.949297,2.158703,2612.679929,3250.099713,Malicious
172.30.6.255,56120,103.243.221.109,80,32,19493,18,17087,14,2406,325.171573,15.281006,8945.484348,1259.602935,Benign
172.30.6.255,57212,52.175.23.79,443,27,10070,14,2220,13,7850,2114.944147,94.122598,188.6900742,667.214902,Benign
172.30.1.136,50745,204.79.197.213,443,48,22687,27,6260,21,16427,1893.134706,50.201796,997.5738717,2617.75495,Benign
192.168.42.240,50964,216.58.221.46,443,27,7559,14,1861,13,5698,234.997704,36.753698,405.0748853,1240.256151,Benign
10.0.2.15,55895,119.254.87.201,80,11,1513,6,705,5,808,17336.31284,1.298979,4341.871578,4976.215936,Malicious
172.30.15.332,49600,104.25.218.21,443,6,348,4,228,2,120,956.253591,3.964315,460.1047091,242.1603732,Benign
192.168.137.97,60734,23.57.218.60,443,39,5379,19,2816,20,2563,0.832001227,403.1631219,55.87812669,50.85782624,Benign
172.30.15.392,49660,62.210.213.13,80,17,7339,8,829,9,6510,1466.488912,4.029283,1645.950409,12925.37655,Benign
172.30.15.1302,50610,204.79.197.200,443,85,20926,39,10383,46,10543,3478.108836,9.434567,8804.219632,8939.890935,Benign
192.168.43.224,37956,103.37.200.180,80,258,186772,130,9914,128,176858,2578.599749,14.39569346,5509.425457,98283.83775,Benign
10.0.2.15,48190,119.254.87.201,80,11,1582,6,705,5,877,18957.77301,8.132206,693.538752,862.7425326,Malicious
172.30.6.255,56284,103.243.221.17,80,6,348,4,228,2,120,568.224164,20.837845,87.53304384,46.07002308,Benign
10.0.2.15,54501,119.254.87.201,80,11,1579,6,705,5,874,3882.379044,165.315684,34.11654517,42.29483755,Malicious
172.30.6.255,57921,103.243.220.231,80,16,5483,9,4255,7,1228,4465.835544,12.214186,2786.923337,804.3106598,Benign
172.30.15.2406,51740,14.139.45.128,80,167,139098,70,4571,97,134527,5344.430015,2.2725,16091.52915,473582.3982,Benign
172.30.15.1619,50929,54.171.197.251,443,17,5556,9,1909,8,3647,3573.957421,3.265079,4677.375341,8935.771539,Benign
172.30.15.1699,51010,184.29.25.7,443,26,12405,12,3640,14,8765,3609.721467,7.406241,3931.819124,9467.69083,Benign
172.30.15.893,50199,210.176.156.62,80,15,6604,9,5084,6,1520,3438.484069,8.685854,4682.556258,1399.977481,Benign
172.30.6.255,57980,122.15.34.34,443,1596,1221476,773,54257,823,1167219,4692.926676,9.462189,45872.68337,986849.0262,Benign
172.30.6.255,55930,52.23.112.47,80,15,2789,8,1422,7,1367,152.439411,100.618441,113.0607857,108.6878299,Benign
172.30.1.136,51883,52.229.207.60,443,51,20657,30,8467,21,12190,4419.680775,3.415496,19831.96584,28552.22199,Benign
192.168.137.97,34224,172.217.161.3,443,10,692,6,412,4,280,69.30620879,14.94443964,220.5502568,149.888524,Benign
172.30.6.255,58366,172.217.166.197,443,17,1779,10,1150,7,629,5474.426005,85.744367,107.2956781,58.68607089,Benign
192.168.43.233,51475,54.81.94.76,80,11,655,6,349,5,306,3816.249251,76.214746,36.63333077,32.11976853,Benign
10.0.2.15,47415,119.254.87.201,80,11,1513,6,705,5,808,10308.67372,1.294202,4357.897762,4994.583535,Malicious
192.168.42.240,50944,216.58.221.46,443,155,48231,67,27269,88,20962,178.677047,128.052019,1703.620151,1309.592784,Benign
192.168.137.97,41106,157.240.16.20,443,440,355063,186,13647,254,341416,2906.623672,95.70164793,1140.795403,28540.03101,Benign
172.30.6.255,58445,52.213.19.114,443,16,3835,9,3137,7,698,5617.69679,1.501247,16716.76946,3719.57446,Benign
10.0.2.15,57243,119.254.87.201,80,11,1582,6,705,5,877,248.367763,4.830513,1167.577854,1452.433727,Malicious
192.168.137.97,47612,104.198.143.177,80,10,911,5,425,5,486,942.3169235,1.853747549,1834.122452,2097.372969,Benign
192.168.43.233,51375,204.79.197.222,443,32,8947,17,1984,15,6963,3212.448264,0.358214,44308.70932,155504.81,Benign
10.0.2.15,59452,119.254.87.201,80,11,1582,6,705,5,877,23137.82091,2.215335,2545.890351,3167.015372,Malicious
10.0.2.15,51115,119.254.87.201,80,11,1582,6,705,5,877,15894.63285,1.024664,5504.243342,6847.122569,Malicious
10.0.2.15,59720,119.254.87.201,80,11,1579,6,705,5,874,7700.709241,1.482539,3804.284407,4716.233435,Malicious
172.30.15.2468,51802,14.139.45.128,80,30,20371,12,1101,18,19270,5422.874925,0.225238,39105.30195,684431.579,Benign
172.30.6.255,57669,103.243.221.46,80,40,23722,21,13236,19,10486,3571.840249,46.201394,2291.878899,1815.70279,Benign
172.30.1.136,50406,172.217.161.14,443,2,132,2,132,0,0,796.201163,3.000233,351.9726635,0,Benign
10.0.2.15,42267,119.254.87.201,80,11,1582,6,705,5,877,4695.451364,1.819317,3100.064475,3856.392261,Malicious
192.168.43.233,51172,151.101.153.176,443,411,200102,193,15377,218,184725,1036.999289,756.435241,162.6259504,1953.637165,Benign
192.168.43.233,51180,23.9.140.60,443,17,2462,9,1392,8,1070,633.350029,2.165915,5141.476004,3952.140319,Benign
172.30.15.2258,51575,104.121.244.70,443,87,76878,30,4225,57,72653,4486.765633,0.81066,41694.42183,716976.2909,Benign
172.30.15.554,49838,23.8.185.154,443,25,12451,12,2097,13,10354,2252.848925,3.245677,5168.721348,25520.71571,Benign
172.30.6.255,56829,103.243.220.231,80,7,402,5,282,2,120,1313.865559,13.620567,165.6318713,70.48164735,Benign
192.168.43.224,47980,151.101.153.177,443,21,9142,12,1410,9,7732,46.51656273,19.43169794,580.4948201,3183.252446,Benign
10.0.2.15,49653,119.254.87.201,80,11,1582,6,705,5,877,15599.26147,4.714341,1196.349606,1488.224971,Malicious
172.30.6.255,57705,103.243.221.87,80,25,14081,15,11902,10,2179,3712.832889,26.220008,3631.425284,664.8358002,Benign
172.30.15.411,49683,192.168.121.7,8080,32,11162,19,4426,13,6736,1544.192322,6.252746,5662.791996,8618.293467,Benign
10.0.2.15,53441,119.254.87.201,80,11,1582,6,705,5,877,20219.07236,2.718747,2074.485048,2580.600549,Malicious
10.0.2.15,50891,119.254.87.201,80,11,1579,6,705,5,874,21516.09741,1.722551,3274.213652,4059.096073,Malicious
172.30.6.255,56696,103.243.220.231,80,6,340,4,228,2,112,1156.101479,13.55643,134.5486976,66.09409704,Benign
10.0.2.15,60379,119.254.87.201,80,11,1582,6,705,5,877,16044.84049,1.952428,2888.710877,3593.474382,Malicious
10.0.2.15,57485,119.254.87.201,80,11,1579,6,705,5,874,24489.36575,1.095565,5148.028643,6382.095083,Malicious
192.168.43.224,33182,35.171.73.174,443,6,412,4,272,2,140,2058.306329,23.09614705,94.21484873,48.49293684,Benign
172.30.6.255,56021,52.114.74.44,443,62,42533,39,34346,23,8187,230.884719,8.417326,32643.14582,7781.093426,Benign
10.0.2.15,54851,119.254.87.201,80,11,1560,6,705,5,855,16827.83695,2.096163,2690.630452,3263.105016,Malicious
172.30.6.255,57597,103.243.221.17,80,17,5496,9,4215,8,1281,3359.836544,16.199901,2081.494202,632.5964585,Benign
172.30.15.419,49693,54.222.61.197,443,30,13587,15,1465,15,12122,1614.443562,6.024952,1945.243713,16095.72989,Benign
172.30.6.255,57843,157.240.16.39,443,29,5537,16,3353,13,2184,4205.096867,61.019633,439.5962198,286.3340722,Benign
10.0.2.15,47653,119.254.87.201,80,11,1579,6,705,5,874,15296.29739,2.117315,2663.751024,3302.295596,Malicious
172.30.1.136,50546,157.240.16.16,443,54,9118,25,3946,29,5172,1439.438027,134.238946,235.1627522,308.2264964,Benign
10.0.2.15,60371,119.254.87.201,80,11,1587,6,705,5,882,23015.06881,2.088683,2700.266149,3378.205309,Malicious
192.168.43.224,37452,34.196.117.182,443,78,13338,38,4516,40,8822,36.47705097,305.2582126,118.3522622,231.2009869,Benign
192.168.43.233,51152,74.125.158.136,443,24,8992,11,2619,13,6373,476.192811,6.014531,3483.56339,8476.803927,Benign
192.168.43.233,51275,151.139.105.14,443,17,4921,9,1153,8,3768,1990.058171,11.622537,793.6305129,2593.581763,Benign
10.0.2.15,34331,119.254.87.201,80,11,1560,6,705,5,855,2805.395232,1.27789,4413.525421,5352.573383,Malicious
10.0.2.15,60277,119.254.87.201,80,11,1582,6,705,5,877,25715.25454,2.019045,2793.39985,3474.910168,Malicious
172.30.6.255,57764,103.243.221.109,80,8,449,5,283,3,166,3922.088311,53.958109,41.9584756,24.61168534,Benign
10.0.2.15,59422,119.254.87.201,80,11,1579,6,705,5,874,17846.61636,2.019035,2793.413685,3463.040512,Malicious
10.0.2.15,40908,119.254.87.201,80,11,1582,6,705,5,877,12082.93625,1.422505,3964.836679,4932.144351,Malicious
172.30.15.1969,51281,52.207.90.113,443,29,7899,15,3482,14,4417,4076.479376,6.088105,4575.479562,5804.10489,Benign
192.168.215.49,46598,52.222.178.64,443,17,6982,10,1311,7,5671,630.6695372,19.11799346,548.5931366,2373.052386,Benign
192.168.43.224,33420,52.84.110.17,443,12,869,6,396,6,473,31.17142966,129.3020424,24.50077309,29.2648123,Benign
172.30.6.255,56857,103.243.220.231,80,6,340,4,228,2,112,1354.628309,21.432036,85.10624002,41.80657405,Benign
192.168.43.224,44860,157.240.16.52,443,26,4413,14,2013,12,2400,1160.866578,59.95466085,268.6029705,320.2419917,Benign
172.30.6.255,57192,157.240.16.39,443,28,5556,15,3410,13,2146,2070.090844,61.02425,447.0353999,281.3307824,Benign
172.30.15.1874,51186,54.201.241.25,443,15,2805,8,1989,7,816,3961.608915,5.955872,2671.649088,1096.061165,Benign
172.30.6.255,56156,103.243.221.109,80,47,33697,29,29486,18,4211,406.839261,4.954623,47609.67686,6799.306426,Benign
172.30.15.2127,51439,52.84.108.238,443,11,1407,7,960,4,447,4178.309226,9.043283,849.2491057,395.4316148,Benign
172.30.15.431,49705,172.217.194.156,443,27,6583,13,2175,14,4408,1623.376786,7.178658,2423.851366,4912.338769,Benign
10.0.2.15,45867,119.254.87.201,80,11,1582,6,705,5,877,12110.52699,1.245323,4528.945502,5633.879724,Malicious
192.168.215.49,43612,34.227.208.227,443,24,5596,13,1509,11,4087,552.7575502,81.5237271,148.079589,401.0611531,Benign
10.0.2.15,44270,119.254.87.201,80,11,1582,6,705,5,877,3526.147222,3.07665,1833.162693,2280.402386,Malicious
10.0.2.15,58676,119.254.87.201,80,11,1568,6,705,5,863,20431.85517,1.92181,2934.733402,3592.446704,Malicious
172.30.1.136,50179,172.217.161.3,443,1,66,1,66,0,0,356.790394,0,0,0,Benign
10.0.2.15,37517,119.254.87.201,80,11,1582,6,705,5,877,15354.13831,1.75871,3206.895964,3989.287603,Malicious
172.30.6.255,56876,161.69.226.28,443,96,23953,52,16115,44,7838,1382.713906,339.931169,379.2532482,184.4608724,Benign
192.168.43.224,34320,172.217.166.206,443,14,1767,10,1270,4,497,1400.873932,24.04101504,422.6111078,165.384032,Benign
192.168.43.224,43238,185.199.109.153,80,6,412,4,272,2,140,3058.385627,10.78147964,201.8275852,103.8818453,Benign
10.0.2.15,56777,119.254.87.201,80,11,1579,6,705,5,874,13226.43181,1.784205,3161.071738,3918.832197,Malicious
172.30.15.368,49636,195.154.150.142,80,6,348,4,228,2,120,1442.708307,7.845779,232.4816949,122.3587868,Benign
192.168.43.224,35552,151.101.153.177,443,29,11344,16,1884,13,9460,348.2036457,15.87403089,949.475285,4767.535136,Benign
172.30.1.136,50253,172.217.161.14,443,3,198,3,198,0,0,452.217376,9.001154,175.9774358,0,Benign
172.30.15.2096,51408,54.236.156.42,443,6,348,4,228,2,120,4142.009917,5.667822,321.8167402,169.3772317,Benign
172.30.6.255,56736,103.243.221.75,80,15,5567,9,5231,6,336,1222.955791,0.554845,75422.86585,4844.596239,Benign
192.168.43.233,50950,104.237.191.1,443,29,5287,15,3086,14,2201,465.306571,50.951685,484.5374594,345.5822904,Benign
10.0.2.15,59220,119.254.87.201,80,11,1579,6,705,5,874,24303.68015,2.083998,2706.33657,3355.089592,Malicious
172.30.6.255,55962,159.127.41.108,443,19,8143,9,1735,10,6408,165.947189,1.405737,9873.824193,36467.70342,Benign
172.30.15.981,50287,147.75.111.32,80,6,348,4,228,2,120,3442.632094,4.63175,393.8036379,207.2650726,Benign
172.30.15.2237,51554,52.220.171.90,443,19,4974,10,3557,9,1417,4462.403592,15.347697,1854.089249,738.6124446,Benign
172.30.1.136,50444,104.113.230.86,443,60,6379,26,3450,34,2929,855.435133,99.260167,278.0571586,236.0664979,Benign
192.168.137.97,47698,13.228.225.25,443,22,7160,12,1467,10,5693,377.014304,14.18613946,827.286383,3210.457654,Benign
172.30.6.255,56780,23.198.126.238,443,16,6330,8,1319,8,5011,1245.555296,0.776761,13584.61612,51609.18223,Benign
10.0.2.15,52605,119.254.87.201,80,11,1582,6,705,5,877,3642.758314,1.803114,3127.922028,3891.046268,Malicious
172.30.6.255,56807,161.69.38.37,80,7,398,4,228,3,170,1267.448596,0.647979,2814.906039,2098.83345,Benign
172.30.15.2457,51791,14.139.45.128,80,10,1404,5,669,5,735,5420.868192,0.155123,34501.65353,37905.4041,Benign
172.30.6.255,58450,157.240.16.17,443,255,209466,101,7361,154,202105,5624.736277,4.332693,13591.54687,373172.0664,Benign
192.168.43.233,51433,151.101.193.69,443,649,458141,296,21854,353,436287,3795.042825,258.638792,675.9697517,13494.86662,Benign
172.30.6.255,56620,172.30.16.59,445,6,583,4,463,2,120,980.542948,3.237854,1143.967579,296.4926769,Benign
172.30.6.255,58563,157.240.16.39,443,14,1586,8,1017,6,569,5852.087551,0.274295,29661.49583,16595.27151,Benign
192.168.137.97,55940,172.217.161.5,443,22,4966,12,1571,10,3395,66.56760314,17.6821847,710.7718991,1536.009292,Benign
10.0.2.15,45294,119.254.87.201,80,11,1582,6,705,5,877,8869.835276,1.823512,3092.932758,3847.520609,Malicious
172.30.15.890,50196,210.176.156.62,80,15,6620,9,5100,6,1520,3438.482986,8.686792,4696.785649,1399.826311,Benign
172.30.15.1947,51259,52.86.72.168,443,15,2636,8,1866,7,770,4028.422347,9.038519,1651.598011,681.5275821,Benign
192.168.215.49,43614,34.227.208.227,443,24,5596,13,1509,11,4087,552.7601209,81.5211922,148.0841935,401.0736241,Benign
192.168.215.49,45686,23.57.214.252,443,15,1769,8,1116,7,653,790.7872318,34.78480412,256.6637998,150.1805208,Benign
192.168.43.224,37568,192.229.237.182,443,9,626,6,412,3,214,3026.056061,14.07480189,234.1773636,121.6358151,Benign
192.168.43.224,41752,34.232.42.95,443,105,85805,40,4706,65,81099,33.29076551,77.37928505,486.5384835,8384.569586,Benign
172.30.6.255,55917,23.198.140.217,80,9,534,5,294,4,240,121.897673,30.071299,78.21411373,63.84825611,Benign
10.0.2.15,32975,119.254.87.201,80,11,1582,6,705,5,877,22507.21289,1.098878,5132.507885,6384.694206,Malicious
172.30.6.255,56007,202.58.9.200,443,24,8571,13,2074,11,6497,227.849513,76.757461,216.161397,677.1458999,Benign
10.0.2.15,40179,119.254.87.201,80,11,1582,6,705,5,877,5473.950522,1.883062,2995.121775,3725.84652,Malicious
10.0.2.15,34481,119.254.87.201,80,11,1582,6,705,5,877,20489.33938,1.95595,2883.509292,3587.003758,Malicious
172.30.6.255,55780,195.201.82.80,80,175,182756,45,10029,130,172727,63.788511,38.260935,2096.969141,36115.58369,Benign
10.0.2.15,56655,119.254.87.201,80,11,1513,6,705,5,808,24369.1392,1.253417,4499.699621,5157.102544,Malicious
172.30.1.136,50665,157.240.16.16,443,18,2998,9,1935,9,1063,1798.13213,108.367797,142.8468644,78.47349707,Benign
172.30.15.1096,50402,144.217.79.15,443,30,13482,16,2196,14,11286,3453.689407,5.365471,3274.269864,16827.60004,Benign
172.30.15.1550,50859,64.74.232.52,443,13,3005,7,2169,6,836,3551.003144,1.079525,16073.73613,6195.317385,Benign
172.30.1.136,50764,172.217.161.4,443,11,3030,8,2696,3,334,1911.335137,4.168988,5173.437774,640.922929,Benign
192.168.137.97,38784,157.240.16.16,443,18,2268,13,1495,5,773,223.5377546,80.99705999,147.6596805,76.34845019,Benign
172.30.6.255,57115,157.240.16.39,443,19,1933,10,1125,9,808,1826.097939,61.031879,147.463918,105.9118629,Benign
172.30.6.255,55754,205.180.87.172,80,6,376,1,66,5,310,58.381114,15.432009,34.21459902,160.7049348,Benign
192.168.215.49,42244,111.119.15.1,443,19,5514,10,1311,9,4203,509.7224274,11.44142269,916.6692192,2938.795369,Benign
172.30.15.2344,51678,139.59.82.147,443,18,6891,10,1174,8,5717,5311.052329,6.71511,1398.636806,6810.908533,Benign
172.30.6.255,55957,103.243.221.75,80,80,61458,29,11316,51,50142,162.86358,51.170167,1769.155844,7839.255244,Benign
10.0.2.15,54945,219.234.85.216,80,11,1857,6,795,5,1062,36786.35896,1.643035,3870.885282,5170.918453,Malicious
192.168.43.224,48800,34.227.208.227,443,16,4997,9,1251,7,3746,361.4584292,44.14062344,226.7299195,678.921086,Benign
192.168.43.233,51164,74.125.170.89,443,9,534,5,294,4,240,483.63688,17.938602,131.1138962,107.031752,Benign
10.0.2.15,34444,119.254.87.201,80,11,1582,6,705,5,877,12653.54967,1.892156,2980.726748,3707.939515,Malicious
172.30.15.580,49865,14.139.45.149,80,10,1151,5,698,5,453,2298.411088,0.147606,37830.4405,24551.84749,Benign
192.168.43.224,36692,172.217.166.202,443,34,7464,18,1983,16,5481,24.37578325,254.0576435,62.44252204,172.590753,Benign
172.30.6.255,57984,157.240.16.39,443,28,5544,15,3399,13,2145,4693.086131,61.054441,445.3730073,281.0606357,Benign
192.168.137.97,59418,157.240.16.20,443,34,10377,16,2123,18,8254,1598.441747,65.35550715,259.8709847,1010.350969,Benign
172.30.6.255,55913,104.24.246.16,443,33,10399,17,2150,16,8249,121.706269,289.922319,59.32623628,227.6195921,Benign
10.0.2.15,43038,119.254.87.201,80,10,981,6,725,4,256,10371.25426,180.37717,32.15484532,11.35398676,Malicious
172.30.6.255,56397,70.42.132.21,80,7,402,4,228,3,174,650.889672,26.306214,69.3372296,52.91525417,Benign
192.168.43.224,36036,52.206.154.207,443,27,8150,14,2623,13,5527,53.41153457,11.8901404,1764.823567,3718.711344,Benign
10.0.2.15,55634,119.254.87.201,80,11,1585,6,705,5,880,17158.24547,2.024074,2786.459388,3478.133705,Malicious
172.30.6.255,56217,159.127.41.210,80,6,344,4,228,2,116,470.031509,21.075938,86.54419082,44.03125498,Benign
192.168.43.224,54946,54.85.227.48,443,35,8109,19,2950,16,5159,362.6329398,62.08439465,380.1277299,664.7725283,Benign
172.30.6.255,56779,23.198.126.238,443,18,6437,8,1318,10,5119,1245.555216,0.879158,11993.29358,46580.93312,Benign
172.30.6.255,56790,173.241.248.220,80,99,56049,47,22187,52,33862,1253.884707,486.796648,364.6204236,556.4869871,Benign
172.30.1.136,50749,172.217.160.228,443,18,2953,11,2343,7,610,1894.110718,26.053864,719.4326339,187.3042709,Benign
172.30.6.255,55697,103.243.221.87,80,27,23393,10,4271,17,19122,53.188802,0.753224,45362.33577,203094.9625,Benign
10.0.2.15,49633,119.254.87.201,80,11,1513,6,705,5,808,11810.1898,1.500682,3758.29123,4307.374914,Malicious
172.30.1.136,50126,74.125.24.188,443,40,7973,21,2167,19,5806,103.97241,279.526115,62.01924997,166.1669429,Benign
172.30.6.255,58451,157.240.16.17,443,476,421853,176,12387,300,409466,5634.312939,4.741638,20899.10702,690843.1221,Benign
192.168.43.233,50861,74.125.130.188,443,4,217,2,109,2,108,0,45.490909,19.16866511,18.99280579,Benign
10.0.2.15,33942,119.254.87.201,80,12,1667,7,779,5,888,10221.11816,4.017791,1551.10109,1768.135774,Malicious
192.168.43.233,51318,104.25.14.32,443,20,6979,10,1145,10,5834,3362.720071,12.735281,719.2617108,3664.779756,Benign
192.168.43.224,49186,104.198.143.177,80,10,911,5,425,5,486,989.5415242,1.208985403,2812.275476,3215.919721,Benign
10.0.2.15,34642,119.254.87.201,80,11,1582,6,705,5,877,14032.65336,1.361249,4143.253732,5154.090104,Malicious
172.30.1.136,50561,52.84.103.186,443,56,24653,29,5604,27,19049,1473.554723,100.162752,447.5915358,1521.44382,Benign
10.0.2.15,42204,119.254.87.201,80,11,1513,6,705,5,808,25685.19738,2.021528,2789.968776,3197.581236,Malicious
172.30.6.255,57923,103.243.220.231,80,20,10633,10,4562,10,6071,4465.840945,12.209091,2989.24793,3978.01933,Benign
192.168.43.224,42148,192.229.237.25,443,13,898,7,478,6,420,939.3285518,63.57123242,60.15299459,52.85409567,Benign
192.168.43.233,51516,204.79.197.254,443,39,9625,20,1953,19,7672,3914.666487,130.082609,120.1082921,471.823255,Benign
10.0.2.15,37559,119.254.87.201,80,11,1582,6,705,5,877,16587.61405,2.402458,2347.595671,2920.342416,Malicious
192.168.43.224,39216,169.55.74.49,443,29,8188,15,3302,14,4886,2094.765713,1.540394045,17148.85882,25375.32531,Benign
10.0.2.15,41208,119.254.87.201,80,11,1579,6,705,5,874,19023.38551,1.015961,5551.394197,6882.153941,Malicious
172.30.1.136,50369,157.240.16.20,443,34,10030,19,2476,15,7554,655.401403,39.514919,501.2790232,1529.346422,Benign
192.168.137.97,57476,172.217.160.237,443,10,676,5,350,5,326,24.1561349,10.85940313,257.8410588,240.160529,Benign
172.30.6.255,57593,157.240.16.39,443,5,330,1,66,4,264,3351.100428,15.057071,35.06658101,140.266324,Benign
172.30.15.444,49718,52.84.110.254,443,54,40571,23,3110,31,37461,1632.076806,8.418436,2955.418322,35599.0115,Benign
10.0.2.15,57141,119.254.87.201,80,11,1579,6,705,5,874,4545.299394,1.225743,4601.290809,5704.295272,Malicious
192.168.43.233,51634,172.217.163.78,443,4,264,1,66,3,198,835.695486,2.583622,204.3642607,613.0927821,Benign
192.168.43.224,39076,103.37.200.184,443,139,93972,70,7946,69,86026,2541.953781,23.56784994,2697.233739,29201.13637,Benign
172.30.15.2033,51345,205.185.216.10,443,6,348,4,228,2,120,4090.691115,6.900913,264.3128525,139.1120276,Benign
10.0.2.15,53313,115.182.31.2,80,10,1992,5,554,5,1438,145.224627,0.722476,6134.45983,15923.02028,Malicious
172.30.6.255,58073,176.34.147.227,443,24,10309,13,4820,11,5489,4828.376745,44.317987,870.0756196,990.8392274,Benign
172.30.6.255,57063,103.243.221.17,80,21,10660,10,4552,11,6108,1679.858803,16.132862,2257.256028,3028.848818,Benign
10.0.2.15,57925,119.254.87.201,80,11,1582,6,705,5,877,6044.523508,1.825156,3090.146815,3844.054974,Malicious
10.0.2.15,36439,119.254.87.201,80,11,1582,6,705,5,877,13526.89765,0.955433,5903.082686,7343.267398,Malicious
172.30.6.255,56893,103.15.158.129,80,16,9626,9,5493,7,4133,1384.648065,10.253648,4285.694223,3224.608452,Benign
192.168.215.49,38604,104.113.142.99,443,59,32290,26,2865,33,29425,1252.687583,330.0132534,69.45175616,713.3046858,Benign
10.0.2.15,50943,119.254.87.201,80,11,1579,6,705,5,874,9800.785612,1.82854,3084.428014,3823.815722,Malicious
172.30.15.2467,51801,14.139.45.128,80,40,26490,20,1958,20,24532,5422.545621,1.662943,9419.444924,118017.2742,Benign
172.30.1.136,50811,172.217.161.14,443,27,3864,15,2321,12,1543,1952.395488,12.518121,1483.289705,986.0904843,Benign
10.0.2.15,36878,119.254.87.201,80,11,1579,6,705,5,874,2264.786331,1.645351,3427.840017,4249.549184,Malicious
192.168.42.240,50987,35.188.42.15,443,22,1332,13,786,9,546,310.640265,53.113513,118.3879515,82.23895866,Benign
192.168.43.233,51340,34.208.98.48,443,48,17642,25,7605,23,10037,3379.081711,85.745155,709.5444635,936.4494122,Benign
172.30.15.1102,50410,184.72.247.8,80,10,1771,6,1330,4,441,3458.185226,9.468549,1123.720224,372.6019689,Benign
172.30.6.255,56778,23.198.126.238,443,17,6384,8,1319,9,5065,1245.555124,0.763026,13829.14868,53104.35031,Benign
172.30.1.136,50510,172.217.161.14,443,87,30486,45,22401,42,8085,989.579016,37.417006,4789.479949,1728.625748,Benign
10.0.2.15,59565,119.254.87.201,80,12,1653,7,779,5,874,4034.901997,4.054518,1537.050767,1724.495982,Malicious
172.30.6.255,57930,103.243.221.17,80,16,5535,9,4309,7,1226,4499.886091,27.176487,1268.44945,360.900215,Benign
10.0.2.15,53982,119.254.87.201,80,11,1579,6,705,5,874,12440.76305,0.921921,6117.660841,7584.163936,Malicious
192.168.137.97,37834,172.217.194.189,443,19,5606,11,1473,8,4133,345.5764955,0.513457049,22950.31303,64394.87015,Benign
172.30.1.136,50340,104.244.46.103,443,61,36097,30,3244,31,32853,599.659625,30.287302,856.8607399,8677.696019,Benign
172.30.6.255,58049,172.217.31.2,80,26,6569,14,3699,12,2870,4819.469905,53.08174,557.4798415,432.5404555,Benign
192.168.43.233,51262,49.44.170.2,443,161,96295,66,16379,95,79916,1950.280278,333.918655,392.4069471,1914.621991,Benign
172.30.6.255,58533,157.240.16.39,443,27,5497,14,3347,13,2150,5791.086907,61.056855,438.5420769,281.7046505,Benign
192.168.137.97,47804,151.101.193.176,443,23,8962,13,1484,10,7478,380.0836067,19.73130793,601.6833776,3031.932815,Benign
172.30.6.255,56836,122.15.34.105,443,17,4802,8,1099,9,3703,1319.893977,1.247389,7048.322536,23748.80651,Benign
172.30.15.1207,50515,52.221.149.164,443,30,9637,15,3122,15,6515,3466.493031,11.015707,2267.307945,4731.425772,Benign
192.168.43.233,51409,23.100.69.251,443,23,9412,11,2076,12,7336,3647.786756,127.421211,130.3393671,460.5826576,Benign
172.30.6.255,56405,103.243.221.75,443,32,16862,16,7568,16,9294,652.048594,25.652707,2360.140784,2898.407564,Benign
172.30.15.1833,51145,104.16.90.50,443,30,9572,16,2029,14,7543,3864.707789,2.467668,6577.870281,24453.85684,Benign
10.0.2.15,53784,119.254.87.201,80,11,1579,6,705,5,874,6379.263925,1.227421,4595.000411,5696.496964,Malicious
172.30.15.1363,50671,209.191.163.213,443,20,8833,11,2320,9,6513,3493.274912,4.091154,4536.617297,12735.77089,Benign
172.30.6.255,56593,172.30.16.59,7680,3,198,3,198,0,0,914.663278,8.96296,176.7273311,0,Benign
172.30.15.1262,50570,180.149.59.145,80,8,468,5,282,3,186,3469.535078,7.971393,283.0120156,186.6674996,Benign
192.168.43.224,48512,151.139.105.121,443,7,430,5,310,2,120,94.71266969,13.52542916,183.3583224,70.97741513,Benign
172.30.15.1393,50701,52.33.0.53,443,20,7794,10,2105,10,5689,3497.688052,9.568492,1759.942946,4756.44438,Benign
172.30.6.255,58082,103.243.221.51,80,31,16152,15,8575,16,7577,4857.238655,15.470452,4434.259581,3918.178991,Benign
172.30.1.136,50742,13.107.4.52,80,15,2559,7,513,8,2046,1888.596776,0.908547,4517.102582,18015.57872,Benign
172.30.15.2195,51507,77.88.21.119,443,16,7860,8,1087,8,6773,4282.786511,4.628486,1878.800109,11706.63582,Benign
172.30.1.136,51919,74.125.24.188,5228,11,619,6,337,5,282,5824.869485,60.19724,44.78610647,37.47680126,Benign
172.30.6.255,58354,172.217.166.197,443,46,22306,22,4405,24,17901,5450.875188,8.183768,4306.084923,17499.02979,Benign
192.168.137.97,50820,172.217.161.3,80,11,742,6,404,5,338,337.7896292,11.58568803,278.9648738,233.3914043,Benign
172.30.15.573,49857,103.243.220.231,443,21,8073,10,3231,11,4842,2255.605585,10.702406,2415.157863,3619.373064,Benign
192.168.43.233,50696,151.101.152.188,443,15,9036,5,799,10,8237,1837.371655,0.854273,7482.385607,77136.93398,Benign
192.168.137.97,54668,52.84.108.88,443,8442,7978438,3002,202143,5440,7776295,789.8973747,200.2807246,8074.386604,310615.8125,Benign
192.168.137.97,59498,13.228.177.65,443,21,6706,12,2453,9,4253,34.95155264,61.75126881,317.791041,550.9846301,Benign
192.168.43.233,51382,104.244.42.67,443,45,8202,23,2438,22,5764,3477.688707,593.791029,32.84657236,77.65694958,Benign
172.30.15.916,50222,184.29.26.86,443,25,10432,13,2268,12,8164,3439.987112,7.003353,2590.759026,9325.818647,Benign
10.0.2.15,45269,119.254.87.201,80,11,1582,6,705,5,877,16164.96509,1.030651,5472.269469,6807.347977,Malicious
172.30.6.255,55798,184.29.25.122,80,17,4553,9,3806,8,747,89.137764,2.599472,11713.1479,2298.928398,Benign
172.30.6.255,56824,103.243.221.51,80,3,198,3,198,0,0,1311.848671,9.007433,175.8547635,0,Benign
192.168.43.233,51017,157.240.16.39,443,29,4320,15,2796,14,1524,698.791605,71.702351,311.9562983,170.0362656,Benign
192.168.137.97,46022,172.82.254.215,443,31,11272,17,5566,14,5706,84.25059271,97.54868462,456.4695073,467.9509537,Benign
10.0.2.15,34604,119.254.87.201,80,11,1582,6,705,5,877,2320.691115,1.634872,3449.811361,4291.467467,Malicious
172.30.6.255,58573,35.190.43.164,80,7,1411,4,1011,3,400,5879.919516,0.565059,14313.54956,5663.125444,Benign
192.168.137.97,46610,172.217.161.14,443,23,6282,12,1575,11,4707,1047.153464,106.1355535,118.7161096,354.7915732,Benign
172.30.6.255,55773,195.201.82.80,80,11,1537,6,956,5,581,62.685172,36.204715,211.2432041,128.3810686,Benign
172.30.6.255,56732,103.243.221.46,80,17,6576,9,5321,8,1255,1221.841492,11.228591,3791.036649,894.1460242,Benign
192.168.42.240,50919,204.79.197.200,443,13,4179,6,3603,7,576,1.859013,124.227077,232.0267102,37.0933625,Benign
192.168.43.233,50719,172.217.166.202,443,17,4787,9,1285,8,3502,1844.187729,13.045763,787.9953054,2147.517167,Benign
192.168.43.224,48150,152.14.93.202,80,10,684,6,404,4,280,2217.109516,52.78788798,61.22616614,42.43397653,Benign
172.30.6.255,55883,72.247.219.133,80,54,21290,29,19372,25,1918,110.31537,301.325902,514.3135687,50.92160979,Benign
172.30.1.136,50155,172.217.194.189,443,19,5470,11,1417,8,4053,145.89121,19.802408,572.4556327,1637.376626,Benign
10.0.2.15,35525,119.254.87.201,80,11,1579,6,705,5,874,7846.115836,2.158322,2613.141135,3239.55369,Malicious
172.30.15.1581,50890,184.29.25.7,443,211,193120,75,12162,136,180958,3567.692423,9.375385,10377.81382,154411.1522,Benign
172.30.1.136,50566,184.29.24.13,443,1233,926665,569,41868,664,884797,1495.507454,196.2776,1706.481025,36063.08616,Benign
10.0.2.15,55543,119.254.87.201,80,11,1579,6,705,5,874,14908.62347,0.98933,5700.827833,7067.409257,Malicious
192.168.137.97,41182,23.57.218.60,443,28,6253,16,4577,12,1676,81.587762,97.17348111,376.8106235,137.9800317,Benign
192.168.43.233,51139,52.46.7.55,443,11,643,6,349,5,294,120.605554,123.785874,22.55507765,19.00055252,Benign
172.30.6.255,56897,184.29.25.201,80,17,6264,9,3435,8,2829,1384.860876,3.259,8432.034366,6944.461491,Benign
172.30.1.136,50490,157.240.16.17,443,335,245398,146,11825,189,233573,955.13786,71.851198,1316.609919,26006.30264,Benign
192.168.137.97,51062,157.240.16.35,443,32,8050,17,2417,15,5633,22.66127068,68.37761883,282.7825878,659.0460558,Benign
172.30.15.1382,50690,184.29.26.86,443,16,3623,8,1781,8,1842,3495.659277,1.359149,10483.03019,10842.07839,Benign
172.30.6.255,57978,13.78.168.230,443,23,6383,14,1487,9,4896,4692.925844,1.63572,7272.638349,23945.41853,Benign
10.0.2.15,58849,119.254.87.201,80,11,1582,6,705,5,877,5986.699077,234.208835,24.08107277,29.95617138,Malicious
192.168.43.233,51370,23.213.64.207,80,101,84221,41,2955,60,81266,3203.154197,5.19849,4547.474363,125060.9312,Benign
10.0.2.15,54334,119.254.87.201,80,11,1579,6,705,5,874,4216.995741,2.62186,2151.144607,2666.809059,Malicious
172.30.6.255,58440,210.176.156.21,80,14,5525,8,3971,6,1554,5616.849783,2.315845,13717.67109,5368.234921,Benign
192.168.43.233,51642,52.84.110.12,443,52,13024,26,3196,26,9828,842.735746,231.147688,110.613263,340.1461666,Benign
192.168.137.97,53898,103.102.166.240,443,47,10783,25,2929,22,7854,4.250313281,181.4742185,129.1202695,346.2309993,Benign
10.0.2.15,53324,119.254.87.201,80,11,1582,6,705,5,877,11875.18619,9.020967,625.2101355,777.743672,Malicious
192.168.43.224,40064,54.91.247.198,443,71,10805,38,4140,33,6665,353.912751,376.1638392,88.04674066,141.7467455,Benign
172.30.6.255,57505,54.194.27.245,443,282,111726,169,92713,113,19013,3059.422321,983.291929,754.3070152,154.6885472,Benign
10.0.2.15,36636,119.254.87.201,80,11,1579,6,705,5,874,19228.09114,1.714134,3290.291191,4079.027661,Malicious
10.0.2.15,47749,119.254.87.201,80,11,1582,6,705,5,877,4427.320045,1.781433,3165.990526,3938.402399,Malicious
172.30.6.255,57934,157.240.16.39,443,28,5560,15,3411,13,2149,4510.083373,61.058621,446.9147772,281.5654811,Benign
172.30.1.136,50214,52.84.103.186,443,24,8420,13,1531,11,6889,370.536008,11.03874,1109.546923,4992.598793,Benign
172.30.6.255,55731,173.241.248.143,80,9,1434,6,942,3,492,58.030218,0.704898,10690.90847,5583.78659,Benign
172.30.15.1721,51032,184.29.25.7,443,102,82891,40,17478,62,65413,3619.379613,7.657361,18260.07681,68339.99337,Benign
10.0.2.15,46198,119.254.87.201,80,11,1582,6,705,5,877,11484.81259,1.101418,5120.671716,6369.970347,Malicious
10.0.2.15,36069,119.254.87.201,80,11,1579,6,705,5,874,2623.420288,1.359656,4148.108051,5142.477215,Malicious
172.30.6.255,58568,173.241.248.220,80,3,186,2,120,1,66,5879.858919,1.187697,808.2869621,444.5578291,Benign
192.168.43.224,46918,157.240.16.16,443,21,2454,11,1366,10,1088,12.282371,69.58064609,157.0551671,125.0922561,Benign
172.30.15.1014,50320,52.85.51.95,443,8,480,5,294,3,186,3444.360981,2.876875,817.5537693,517.2278949,Benign
172.30.6.255,57121,161.69.13.35,80,17,5156,9,2452,8,2704,1855.242082,61.259862,320.2096668,353.1186538,Benign
192.168.43.224,57724,172.217.166.197,443,44,6179,21,3159,23,3020,1492.986015,241.0071894,104.8599424,100.2459722,Benign
10.0.2.15,38008,119.254.87.201,80,11,1513,6,705,5,808,13524.41215,1.440787,3914.527269,4486.436926,Malicious
10.0.2.15,57125,119.254.87.201,80,11,1558,6,705,5,853,11482.41642,4.297599,1312.360693,1587.863363,Malicious
172.30.15.2270,51588,52.84.108.223,443,20,3626,11,1589,9,2037,4527.483239,10.254395,1239.663578,1589.172252,Benign
172.30.6.255,58122,180.149.59.210,80,8,468,5,282,3,186,4895.52275,10.432018,216.2572956,142.6377907,Benign
172.30.6.255,56134,66.117.28.68,443,6,348,4,228,2,120,351.456625,17.526482,104.0710851,54.77425532,Benign
192.168.43.224,52188,52.84.110.17,443,18,7111,10,1311,8,5800,37.39639841,10.83663525,967.8280903,4281.771872,Benign
192.168.43.233,51204,13.107.3.128,443,43,11147,22,3087,21,8060,1240.277131,6.516264,3789.901698,9895.240586,Benign
172.30.15.725,50012,151.139.104.116,443,1127,976092,455,28334,672,947758,2416.678434,27.316058,8298.122665,277568.0151,Benign
10.0.2.15,34950,119.254.87.201,80,11,1582,6,705,5,877,551.148835,3.554357,1586.784895,1973.915395,Malicious
172.30.6.255,56905,52.202.222.55,80,7,402,5,282,2,120,1385.390309,19.77089,114.1071545,48.55623596,Benign
172.30.15.1216,50524,173.241.248.220,80,9,1939,6,1461,3,478,3467.150113,10.47288,1116.025391,365.133564,Benign
192.168.137.97,41438,157.240.16.52,443,34,10998,17,2202,17,8796,3029.319849,51.39357582,342.7665757,1369.198365,Benign
192.168.137.97,45250,173.194.60.168,443,11,754,6,412,5,342,634.5798253,57.82773101,56.99687576,47.31294056,Benign
172.30.6.255,56781,184.29.25.174,443,17,7111,9,1032,8,6079,1245.639604,0.246699,33465.88353,197130.9166,Benign
172.30.6.255,55690,35.190.43.247,443,28,9295,14,2073,14,7222,45.077799,13.54345,1224.503358,4265.973589,Benign
172.30.15.1952,51264,52.86.72.168,443,6,340,4,228,2,112,4028.674284,8.7871,207.5770163,101.9676571,Benign
172.30.15.2013,51325,52.207.90.113,443,25,6462,12,1893,13,4569,4089.220048,8.396516,1803.60521,4353.234127,Benign
192.168.43.224,36334,52.20.136.189,443,89,64015,40,9508,49,54507,2852.173995,101.9555561,746.0505626,4276.922383,Benign
10.0.2.15,51282,119.254.87.201,80,11,1582,6,705,5,877,10103.2166,1.085487,5195.824547,6463.458337,Malicious
192.168.137.97,47700,157.240.16.39,443,13,886,7,494,6,392,769.7056976,105.4616884,37.47332381,29.73591687,Benign
172.30.15.1491,50799,180.179.41.214,443,18,4071,9,2858,9,1213,3520.965752,4.444496,5144.340326,2183.374673,Benign
192.168.43.233,51503,13.107.42.254,443,9,534,4,240,5,294,3897.283397,0.903198,2125.779729,2604.080168,Benign
172.30.6.255,58458,172.217.166.206,443,18,1883,11,1242,7,641,5654.411608,71.053744,139.8378107,72.17072193,Benign
172.30.6.255,56748,23.198.126.238,443,17,6725,8,1113,9,5612,1244.006823,0.801138,11114.19006,56040.2827,Benign
172.30.15.1035,50341,54.94.182.41,443,7,398,4,228,3,170,3447.194647,10.290367,177.2531534,132.1624389,Benign
10.0.2.15,50897,119.254.87.201,80,11,1579,6,705,5,874,20161.59219,1.644576,3429.455373,4251.551768,Malicious
192.168.43.233,51256,52.84.108.242,443,35,11062,17,3251,18,7811,2295.288988,216.302219,120.2391733,288.8920895,Benign
172.30.6.255,58209,103.243.221.87,80,16,5908,9,4317,7,1591,5155.864289,8.25069,4185.83173,1542.658856,Benign
192.168.137.97,52106,172.217.161.3,443,158,83940,81,8262,77,75678,8269.03954,255.521581,258.6709105,2369.365428,Benign
192.168.137.97,41738,104.244.42.193,443,394,89383,211,38868,183,50515,384.6953336,2696.09608,115.3312014,149.8908006,Benign
192.168.137.97,45550,192.168.121.7,8080,1610,1452057,615,56806,995,1395251,2901.845056,104.5302214,4347.527383,106782.5921,Benign
172.30.6.255,58213,35.190.43.164,80,10,1629,6,1175,4,454,5155.946041,8.048203,1167.962587,451.2808636,Benign
192.168.43.233,50992,157.240.16.39,443,29,3634,14,2056,15,1578,513.719045,67.241462,244.6109812,187.7413076,Benign
192.168.215.49,46212,188.65.124.58,443,140,104848,93,95253,47,9595,513.5578156,136.2296481,5593.672233,563.4603118,Benign
172.30.1.136,50346,172.217.161.14,443,9,534,5,294,4,240,614.532702,15.37975,152.9283636,124.8394805,Benign
172.30.15.1559,50868,52.84.108.98,443,2146,1727557,918,74404,1228,1653153,3557.048569,9.935111,59911.96273,1331160.165,Benign
10.0.2.15,35768,119.254.87.201,80,11,1582,6,705,5,877,17068.16572,2.106768,2677.086419,3330.219559,Malicious
172.30.15.1623,50933,104.244.42.195,443,11,1376,7,958,4,418,3574.179751,2.793675,2743.339866,1196.989628,Benign
10.0.2.15,53070,219.234.85.243,80,11,1631,6,796,5,835,51.670526,1.825759,3487.864499,3658.752333,Malicious
192.168.137.97,50948,172.217.160.234,80,11,766,7,478,4,288,8274.419355,17.53489484,218.0794373,131.3951421,Benign
192.168.43.233,50881,172.217.166.206,443,18,5759,9,1285,9,4474,35.451179,30.047115,342.1293525,1191.195894,Benign
10.0.2.15,40534,119.254.87.201,80,11,1593,6,705,5,888,17638.78274,1.484855,3798.350681,4784.305538,Malicious
192.168.43.224,43582,18.206.249.150,443,9,598,5,338,4,260,1280.68112,78.44846719,34.46848736,26.51422105,Benign
172.30.6.255,56924,115.114.126.213,443,9,510,5,282,4,228,1386.864691,17.544083,128.5903629,103.9666764,Benign
192.168.42.240,51041,216.58.221.35,443,1,66,1,66,0,0,615.384828,0,0,0,Benign
10.0.2.15,35694,119.254.87.201,80,11,1582,6,705,5,877,18299.65328,4.324579,1304.173192,1622.354453,Malicious
172.30.15.994,50300,34.241.15.178,80,10,1726,6,965,4,761,3443.077221,4.183213,1845.471412,1455.340668,Benign
172.30.15.1768,51080,184.29.25.7,443,28,17252,13,3902,15,13350,3640.907278,6.261839,4985.116992,17055.69243,Benign
172.30.1.136,50233,52.84.108.5,80,14,804,8,456,6,348,431.657555,30.403793,119.9850295,91.56752251,Benign
172.30.6.255,56705,172.217.166.206,443,42,6960,24,4233,18,2727,1168.402766,74.180128,456.5104013,294.094936,Benign
10.0.2.15,41414,119.254.87.201,80,11,1559,6,705,5,854,5203.721165,1.493213,3777.090074,4575.368685,Malicious
192.168.137.97,51900,172.217.161.3,443,9,598,6,404,3,194,5227.836262,18.77898924,172.1072395,82.64555562,Benign
10.0.2.15,33852,119.254.87.201,80,11,1582,6,705,5,877,13556.91655,1.164129,4844.823898,6026.823488,Malicious
172.30.15.513,49796,172.217.166.197,443,32,6320,17,3840,15,2480,2048.735963,7.235785,4245.565616,2741.927794,Benign
10.0.2.15,44302,119.254.87.201,80,11,1579,6,705,5,874,14818.51411,1.163649,4846.822367,6008.684749,Malicious
172.30.15.1169,50477,210.176.156.62,80,20,11066,10,3699,10,7367,3460.54956,6.723668,4401.169124,8765.453618,Benign
172.30.6.255,58036,35.230.55.83,80,6,348,4,228,2,120,4814.666389,11.441012,159.4264563,83.90866123,Benign
172.30.1.136,50808,172.217.161.14,443,1194,903649,519,44715,675,858934,1952.394799,45.254557,7904.618313,151840.4434,Benign
172.30.15.1675,50986,162.247.242.19,443,23,5952,11,2126,12,3826,3596.711052,10.526377,1615.750604,2907.743091,Benign
192.168.137.97,42282,54.82.135.50,443,36,9341,20,3788,16,5553,3030.360641,50.54047822,599.5986003,878.9786239,Benign
10.0.2.15,52037,119.254.87.201,80,11,1579,6,705,5,874,15356.33353,1.223506,4609.70359,5714.724734,Malicious
192.168.43.233,51294,117.18.237.70,443,17,5689,8,1087,9,4602,2522.55485,0.346526,25094.79808,106243.1102,Benign
10.0.2.15,45111,119.254.87.201,80,11,1579,6,705,5,874,11932.81398,1.228364,4591.472886,5692.123833,Malicious
172.30.1.136,50493,172.217.161.14,443,61,21389,31,12603,30,8786,958.915254,282.947237,356.3349869,248.4138059,Benign
172.30.6.255,58372,103.231.98.53,80,19,6478,10,5744,9,734,5484.89385,4.221218,10885.95756,1391.067697,Benign
172.30.15.1223,50531,103.229.205.253,443,17,6402,9,2122,8,4280,3467.303752,10.319284,1645.075375,3318.059664,Benign
192.168.215.49,49618,209.197.3.15,443,25,7325,13,1509,12,5816,80.27248518,56.0388762,215.4218789,830.2807472,Benign
172.30.6.255,55703,180.149.59.210,80,12,5395,8,4171,4,1224,53.40544,5.168051,6456.59263,1894.718144,Benign
192.168.43.233,51345,139.59.72.43,443,9,523,5,283,4,240,3082.998693,55.078244,41.10515942,34.85949915,Benign
172.30.1.136,50381,157.240.16.20,443,26,6783,8,2059,18,4724,690.137713,97.790206,168.4422262,386.4599692,Benign
192.168.43.233,51285,117.18.237.70,443,18,5841,9,1141,9,4700,2472.357415,19.596192,465.8047849,1918.740131,Benign
192.168.137.97,55274,13.228.141.18,443,29,10079,17,3066,12,7013,72.81808296,76.47942872,320.7136927,733.5828855,Benign
172.30.6.255,57945,103.243.221.75,80,80,62056,50,53971,30,8085,4559.097591,27.954245,15445.52536,2313.780966,Benign
172.30.6.255,56352,72.251.245.181,80,7,402,4,228,3,174,607.55993,24.472438,74.5328275,56.88031573,Benign
172.30.15.1032,50338,52.221.102.82,443,15,2907,8,1667,7,1240,3446.987535,10.079601,1323.068244,984.1659407,Benign
10.0.2.15,43138,119.254.87.201,80,11,1579,6,705,5,874,818.895328,1.14899,4908.658909,6085.34452,Malicious
192.168.42.240,50928,172.217.161.5,443,113,27407,53,18004,60,9403,13.397335,594.973048,242.0815539,126.4326178,Benign
172.30.6.255,58197,103.243.221.46,80,39,24317,23,20223,16,4094,5089.890018,24.25193,6670.974228,1350.490456,Benign
172.30.6.255,56071,37.157.6.251,80,11,1354,6,780,5,574,286.669194,37.31988,167.20311,123.0443399,Benign
192.168.43.233,51133,34.231.96.113,443,28,8734,14,2294,14,6440,923.789046,84.879549,216.2122704,606.9777774,Benign
172.30.1.136,51478,52.230.85.180,443,24,3299,16,1683,8,1616,60.396389,679.893129,19.80311232,19.01475313,Benign
172.30.6.255,56365,52.84.111.68,80,15,2044,8,923,7,1121,608.196796,138.691897,53.24031295,64.66131183,Benign
172.30.6.255,57306,161.69.226.29,443,32,8176,18,4458,14,3718,2436.616213,262.730456,135.743684,113.2110851,Benign
192.168.43.224,42012,23.251.156.28,443,825,616065,389,39322,436,576743,1286.240499,472.3428893,665.9907603,9768.208867,Benign
172.30.15.1755,51067,184.29.25.7,443,33,22881,14,6140,19,16741,3638.209494,8.961924,5480.965918,14944.11245,Benign
172.30.1.136,51789,130.211.21.54,443,35,6130,17,2647,18,3483,2977.304478,41.462099,510.7314996,672.0354413,Benign
192.168.137.97,47660,157.240.16.39,443,34,5763,17,2744,17,3019,1761.371884,65.55329553,334.8725617,368.4330407,Benign
172.30.15.1444,50752,103.231.98.244,443,27,11581,12,1042,15,10539,3501.726914,2.746537,3035.094739,30697.5657,Benign
192.168.137.97,38714,104.17.37.113,443,2662,1583037,1276,83488,1386,1499549,6.370032682,1804.701381,370.0911448,6647.300283,Benign
10.0.2.15,57009,119.254.87.201,80,11,1582,6,705,5,877,3916.522332,4.602452,1225.433747,1524.404817,Malicious
192.168.137.97,40816,104.198.143.177,80,10,911,5,425,5,486,16.76618218,0.976164683,3483.018859,3982.934507,Benign
172.30.15.1570,50879,52.84.108.98,443,96,69070,44,3520,52,65550,3558.916304,8.067013,3490.759219,65005.47353,Benign
172.30.6.255,55986,34.226.161.213,80,13,1581,7,977,6,604,183.435812,69.629344,112.2515243,69.39602935,Benign
172.30.15.1480,50788,52.220.14.37,443,21,2757,12,1656,9,1101,3520.885888,6.176851,2144.782188,1425.969317,Benign
192.168.43.224,58550,52.24.249.177,443,18,1948,10,1220,8,728,97.19687757,13.58736454,718.3144289,428.6335281,Benign
172.30.15.383,49651,62.210.213.13,80,22,11792,10,1356,12,10436,1455.40435,5.148626,2106.969898,16215.58839,Benign
10.0.2.15,45247,219.234.85.236,80,10,1023,5,593,5,430,21.450934,0.86157,5506.227004,3992.710981,Malicious
10.0.2.15,36862,115.182.31.2,80,8,719,4,463,4,256,53.586832,0.579801,6388.398778,3532.246409,Malicious
172.30.6.255,57427,103.243.221.109,80,28,15378,14,8287,14,7091,2792.848684,37.225637,1780.923185,1523.896018,Benign
172.30.6.255,56205,54.149.221.157,80,12,2338,6,1168,6,1170,467.332771,23.818197,392.3050935,392.9768488,Benign
172.30.6.255,58429,157.240.16.20,443,186,113322,84,8954,102,104368,5592.929631,6.102167,11738.78067,136827.4582,Benign
172.30.1.136,51557,52.230.85.180,443,2,132,2,132,0,0,736.530275,3.000713,351.9163612,0,Benign
172.30.6.255,58327,204.79.197.200,443,31,13729,18,3503,13,10226,5383.93796,61.502058,455.6595488,1330.16687,Benign
172.30.6.255,55939,202.58.9.200,80,7,402,4,228,3,174,152.503232,6.480194,281.4730547,214.8083838,Benign
192.168.137.97,34384,172.217.161.3,443,127,38217,62,25508,65,12709,281.1150577,110.7904027,1841.892393,917.6968175,Benign
172.30.1.136,50388,172.217.161.3,443,49,6322,28,3985,21,2337,722.806,45.820473,695.7588587,408.0272153,Benign
10.0.2.15,43536,219.234.85.216,80,11,1344,6,792,5,552,189.927564,57.625987,109.9503944,76.63209309,Malicious
172.30.15.2199,51511,77.88.21.119,443,74,41037,38,36061,36,4976,4290.538984,7.124299,40493.52785,5587.637464,Benign
10.0.2.15,44346,119.254.87.201,80,12,1667,7,779,5,888,18747.65747,4.66274,1336.553185,1523.567688,Malicious
172.30.1.136,50798,52.18.200.60,443,32,9434,19,2819,13,6615,1931.918906,28.967392,778.5305629,1826.881757,Benign
192.168.137.97,44124,172.217.161.10,443,40,5429,20,3017,20,2412,5227.501094,240.9584724,100.1666377,80.08018896,Benign
10.0.2.15,59057,119.254.87.201,80,11,1582,6,705,5,877,14455.409,1.374303,4103.898485,5105.133293,Malicious
10.0.2.15,36935,119.254.87.201,80,11,1582,6,705,5,877,17491.82298,1.273191,4429.814537,5510.563615,Malicious
172.30.6.255,56964,172.217.160.226,443,42,8139,20,3049,22,5090,1406.880762,240.712721,101.3324094,169.1643044,Benign
192.168.137.97,49438,74.125.130.188,5228,11,754,6,412,5,342,9482.703648,61.69488632,53.42420088,44.34727355,Benign
172.30.6.255,57552,103.243.220.231,80,16,5443,9,4215,7,1228,3218.844454,35.187736,958.2884219,279.1881808,Benign
172.30.15.543,49827,205.180.87.201,443,20,8083,11,1793,9,6290,2251.236145,1.140318,12578.94728,44128.04148,Benign
192.168.137.97,39772,192.168.125.6,80,1260,1094920,560,40896,700,1054024,8327.369654,79.25048269,4128.277695,106399.251,Benign
10.0.2.15,47330,119.254.87.201,80,11,1559,6,705,5,854,21870.93662,2.248459,2508.384631,3038.525497,Malicious
172.30.1.136,51548,52.84.110.135,443,11,654,7,414,4,240,711.228069,29.866457,110.8936356,64.28616558,Benign
10.0.2.15,43896,119.254.87.201,80,11,1579,6,705,5,874,23618.37139,2.617885,2154.410908,2670.858346,Malicious
172.30.15.2180,51492,31.24.224.56,443,21,3925,12,1763,9,2162,4261.691304,6.442087,2189.352612,2684.844213,Benign
172.30.6.255,58475,216.58.196.162,80,46,13346,24,7729,22,5617,5680.850164,8.236958,7506.654763,5455.412059,Benign
172.30.6.255,55740,104.193.80.60,80,2,132,1,66,1,66,58.419291,0.295855,1784.658025,1784.658025,Benign
172.30.6.255,57027,172.217.194.189,443,43,10096,21,3862,22,6234,1550.426228,240.394067,128.5223067,207.459363,Benign
172.30.15.426,49700,59.63.81.183,443,10,612,6,360,4,252,1616.804653,4.064649,708.5482658,495.9837861,Benign
192.168.43.233,50929,52.84.109.5,443,9,534,5,294,4,240,433.44659,19.364459,121.4596287,99.1507173,Benign
192.168.43.224,50042,34.227.238.173,443,6,412,4,272,2,140,368.7940939,37.18391367,58.51992932,30.12055186,Benign
172.30.6.255,58134,35.190.41.40,443,53,15006,24,3966,29,11040,4910.821336,8.142438,3896.621626,10846.87412,Benign
172.30.6.255,58107,35.190.43.164,80,10,1573,6,1119,4,454,4891.836149,7.116414,1257.936933,510.369408,Benign
172.30.15.1440,50748,103.231.98.244,443,8,973,5,799,3,174,3501.361179,0.359938,17758.61398,3867.332707,Benign
172.30.1.136,50385,157.240.16.39,443,15,834,3,174,12,660,695.625521,133.295849,10.44293585,39.61113598,Benign
192.168.215.49,55942,111.119.15.0,443,7118,6565683,2576,197258,4542,6368425,514.6662289,45.53535124,34655.79944,1118853.783,Benign
172.30.6.255,57710,210.176.156.21,80,14,4317,7,3880,7,437,3713.099851,1.001246,31001.37229,3491.649405,Benign
10.0.2.15,44191,119.254.87.201,80,11,1582,6,705,5,877,7726.030156,2.02122,2790.393921,3471.170877,Malicious
172.30.1.136,51922,52.84.108.120,443,4908,4467087,1824,106797,3084,4360290,6211.150844,226.368329,3774.273565,154095.4079,Benign
172.30.6.255,58405,103.243.221.51,80,7,414,5,294,2,120,5550.877289,8.348505,281.7270877,114.990648,Benign
10.0.2.15,50212,119.254.87.201,80,11,1582,6,705,5,877,1962.459663,1.907013,2957.504747,3679.052004,Malicious
10.0.2.15,49121,119.254.87.201,80,12,1653,7,779,5,874,21155.57975,3.850937,1618.307441,1815.662006,Malicious
192.168.43.224,58384,172.217.166.206,443,22,6231,12,1583,10,4648,856.9211175,12.86607405,984.2940399,2890.0813,Benign
172.30.6.255,56386,104.90.192.189,443,8,480,5,294,3,186,650.888091,26.146471,89.95477822,56.91016581,Benign
172.30.15.1392,50700,156.154.136.36,443,7,398,4,228,3,170,3496.207414,1.163939,1567.092434,1168.446113,Benign
172.30.15.460,49734,18.204.234.216,443,19,2865,10,1816,9,1049,1643.431314,7.274553,1997.098653,1153.610401,Benign
192.168.43.233,51041,172.82.241.224,443,38,14564,18,8822,20,5742,821.877524,65.687387,1074.4224,699.3123353,Benign
172.30.15.1707,51018,111.221.29.13,443,27,7260,16,1929,11,5331,3614.828943,1.293175,11933.41968,32979.29515,Benign
172.30.6.255,55974,199.166.0.200,443,20,8889,10,1775,10,7114,174.522329,0.611935,23205.07897,93003.34186,Benign
172.30.6.255,57168,103.243.221.46,80,17,6250,9,4497,8,1753,1982.861667,25.163615,1429.683295,557.3126119,Benign
172.30.15.1656,50967,184.29.25.7,443,8,480,5,294,3,186,3582.924643,4.574492,514.1554516,325.2820204,Benign
172.30.6.255,56940,151.101.2.49,80,6,348,4,228,2,120,1387.825516,16.698376,109.2321792,57.49062064,Benign
192.168.43.224,51468,23.213.88.167,443,8,552,5,338,3,214,1282.684583,18.23088269,148.3197521,93.90658858,Benign
192.168.43.224,45476,54.173.101.22,443,22,6157,12,1984,10,4173,44.5799194,12.53928638,1265.781762,2662.352465,Benign
172.30.15.692,49979,23.56.25.39,80,15,3944,9,846,6,3098,2402.400864,4.393526,1540.448378,5641.027275,Benign
172.30.6.255,56012,141.170.25.54,443,18,6663,8,2012,10,4651,227.883964,0.821722,19588.13321,45280.52066,Benign
172.30.15.1493,50801,64.74.232.52,443,14,3057,8,2221,6,836,3520.971252,4.790386,3709.095676,1396.129665,Benign
192.168.137.97,37694,23.57.214.252,443,18,2648,10,1765,8,883,3532.580679,27.11365534,520.7708007,260.5329275,Benign
10.0.2.15,41534,119.254.87.201,80,11,1582,6,705,5,877,9888.243301,1.955952,2883.506344,3587.00009,Malicious
192.168.137.97,55880,172.217.161.14,443,23,5870,12,1591,11,4279,32.18989847,18.25293798,697.3124005,1875.424112,Benign
10.0.2.15,36305,119.254.87.201,80,11,1569,6,705,5,864,7398.228268,1.676651,3363.848529,4122.503729,Malicious
172.30.6.255,56017,204.11.109.67,443,7,402,4,228,3,174,228.109942,10.799521,168.8963798,128.8946056,Benign
172.30.15.1976,51288,151.101.2.2,443,29,15140,16,1582,13,13558,4076.622469,0.626124,20213.24849,173230.8616,Benign
172.30.6.255,56681,157.240.16.39,443,5,330,1,66,4,264,1155.094468,15.091458,34.98667922,139.9467169,Benign
172.30.15.1357,50665,103.243.220.231,443,27,11864,14,5092,13,6772,3493.138649,4.198477,9702.565954,12903.72676,Benign
10.0.2.15,49958,119.254.87.201,80,11,1582,6,705,5,877,6437.127679,2.091049,2697.210826,3355.253751,Malicious
172.30.15.896,50202,103.243.220.231,80,24,9337,13,5358,11,3979,3438.495529,8.76619,4889.695523,3631.224055,Benign
10.0.2.15,58614,119.254.87.201,80,11,1582,6,705,5,877,18509.83055,1.430081,3943.832552,4906.015813,Malicious
10.0.2.15,33576,119.254.87.201,80,11,1579,6,705,5,874,21900.99146,1.439361,3918.405459,4857.711165,Malicious
172.30.6.255,57742,157.240.16.39,443,29,5474,16,3329,13,2145,3839.088602,61.059184,436.1669819,281.0388033,Benign
172.30.6.255,58549,173.241.248.220,80,10,2494,6,1300,4,1194,5813.930503,5.258114,1977.895496,1816.620941,Benign
172.30.6.255,58307,103.231.98.53,80,19,6478,10,5744,9,734,5353.843865,5.227364,8790.663899,1123.319516,Benign
172.30.1.136,50375,172.217.161.3,443,9,534,6,360,3,174,681.223792,19.865545,144.9746282,70.07107029,Benign
172.30.6.255,57242,103.243.220.231,80,6,340,4,228,2,112,2205.124023,20.906806,87.24431652,42.85685724,Benign
172.30.6.255,58446,52.213.19.114,443,15,2905,8,2207,7,698,5617.697157,1.502998,11747.18795,3715.241138,Benign
172.30.6.255,57152,103.243.221.75,80,47,29552,27,25236,20,4316,1921.856748,20.226955,9981.136558,1707.029061,Benign
172.30.15.556,49840,151.101.112.84,443,8,480,5,294,3,186,2252.850047,3.338305,704.5491649,445.735186,Benign
172.30.6.255,56336,52.109.120.3,443,58,41859,31,23680,27,18179,601.467654,5.789319,32722.32883,25120.74391,Benign
172.30.6.255,58069,35.190.43.164,80,26,6692,14,4902,12,1790,4826.906556,45.645327,859.1459976,313.7232427,Benign
10.0.2.15,39335,119.254.87.201,80,11,1582,6,705,5,877,24033.3651,2.103831,2680.823697,3334.868628,Malicious
10.0.2.15,46136,119.254.87.201,80,11,1513,6,705,5,808,18449.76252,1.556833,3622.73924,4152.018874,Malicious
172.30.6.255,56621,172.30.16.59,139,9,750,6,571,3,179,983.782252,3.307808,1380.974954,432.9150906,Benign
192.168.43.224,36042,34.204.88.0,443,15,2706,8,1643,7,1063,30.32268741,2.835913841,4634.837565,2998.680664,Benign
192.168.137.97,37688,172.217.194.189,443,100,25527,50,12160,50,13367,150.1584888,195.5492141,497.4706775,546.8495515,Benign
192.168.43.224,49578,151.139.237.11,443,6,356,4,236,2,120,804.5146691,29.96075228,63.01577418,32.04191907,Benign
192.168.43.224,34088,52.84.108.208,443,68,42014,31,4937,37,37077,2890.743813,123.845246,318.914139,2395.053582,Benign
192.168.43.233,51379,52.216.18.144,443,17,989,9,524,8,465,3477.399003,114.086001,36.74421019,32.60698041,Benign
10.0.2.15,42409,119.254.87.201,80,11,1534,6,705,5,829,338.455771,1.759587,3205.297607,3769.066264,Malicious
10.0.2.15,60244,119.254.87.201,80,11,1587,6,705,5,882,21486.02373,2.018464,2794.20391,3495.727444,Malicious
192.168.137.97,44272,140.98.193.112,443,30,14827,16,4370,14,10457,79.26538877,17.95478151,1947.113641,4659.260261,Benign
172.30.15.2028,51340,52.207.90.113,443,6,348,4,228,2,120,4090.537382,7.056141,258.4982358,136.051703,Benign
10.0.2.15,48107,119.254.87.201,80,11,1579,6,705,5,874,21513.08686,1.549006,3641.044644,4513.862438,Malicious
192.168.43.224,53972,14.139.116.17,443,19,4875,10,1798,9,3077,1573.21818,62.06648469,231.7514851,396.6069631,Benign
172.30.1.136,50281,52.84.103.186,443,586,393575,273,23569,313,370006,484.002677,147.055107,1282.186004,20128.8351,Benign
192.168.42.240,51017,13.35.130.42,443,46,10732,20,2201,26,8531,420.486498,187.763766,93.77741177,363.4780099,Benign
192.168.43.233,50995,163.53.79.200,443,27,8259,13,1783,14,6476,514.180664,68.349668,208.691577,757.984662,Benign
172.30.6.255,56098,151.101.194.49,80,10,1572,5,904,5,668,305.825942,0.485545,14894.60297,11006.18892,Benign
192.168.137.97,50128,169.237.6.105,80,15,6045,8,965,7,5080,1955.438376,1.841097633,4193.150793,22073.78863,Benign
172.30.6.255,57695,172.217.163.133,443,30,8084,16,5473,14,2611,3670.409925,129.798969,337.3216316,160.9257775,Benign
172.30.15.223,49473,23.57.219.27,80,1,54,1,54,0,0,30.384641,0,0,0,Benign
10.0.2.15,38945,119.254.87.201,80,11,1551,6,705,5,846,6434.781058,2.042601,2761.185371,3313.422445,Malicious
172.30.6.255,57336,103.243.221.17,80,6,340,4,228,2,112,2469.40213,41.6261,43.81866185,21.5249567,Benign
192.168.137.97,39736,172.217.161.14,443,16,1136,11,782,5,354,3750.86229,97.22597703,64.34494351,29.12801791,Benign
172.30.6.255,55729,50.116.239.135,80,9,1824,6,995,3,829,58.16672,0.54577,14584.8984,12151.63897,Benign
192.168.215.49,43148,151.101.194.2,443,90,43732,41,3763,49,39969,513.8903662,600.1328985,50.16222253,532.8019857,Benign
10.0.2.15,33123,119.254.87.201,80,11,1582,6,705,5,877,25958.70608,0.970134,5813.62987,7231.990632,Malicious
172.30.6.255,57539,103.243.220.231,80,17,5853,9,4216,8,1637,3147.861532,14.169828,2380.268836,924.2172876,Benign
192.168.43.224,57188,139.59.82.147,443,28,7836,15,1620,13,6216,2458.825865,34.40931653,376.6421803,1445.189996,Benign
10.0.2.15,46691,119.254.87.201,80,12,1656,7,779,5,877,15414.16535,4.379205,1423.089351,1602.117279,Malicious
192.168.137.97,42488,216.58.196.202,443,64,13252,33,4079,31,9173,3833.546702,241.1484149,135.3191561,304.3105219,Benign
10.0.2.15,54150,119.254.87.201,80,12,1656,7,779,5,877,10641.51701,6.926717,899.704723,1012.889656,Malicious
192.168.43.233,51522,23.213.64.207,80,94,74203,42,3056,52,71147,3956.250256,4.687001,5216.128608,121437.1407,Benign
10.0.2.15,43223,119.254.87.201,80,11,1582,6,705,5,877,21425.93389,2.224013,2535.9564,3154.657819,Malicious
192.168.43.233,51162,103.243.221.75,443,11,611,6,337,5,274,951.403534,61.703788,43.69261738,35.52456131,Benign
192.168.43.233,51194,131.253.14.229,443,80,45522,42,4205,38,41317,668.200323,76.929536,437.2832822,4296.607222,Benign
172.30.6.255,55761,157.240.16.16,443,231,56073,113,27931,118,28142,61.585149,821.55066,271.9832274,274.0378786,Benign
172.30.15.2084,51396,52.84.108.91,443,22,3663,11,2170,11,1493,4123.361408,3.9855,4355.789738,2996.863631,Benign
172.30.15.843,50146,34.232.42.95,443,19,4987,10,2635,9,2352,3251.649385,5.399918,3903.762983,3484.497357,Benign
192.168.43.233,51693,52.114.77.33,443,36,16609,19,10410,17,6199,1365.951293,6.244108,13337.37341,7942.207278,Benign
192.168.137.97,48908,172.217.194.189,443,43,10245,20,4003,23,6242,348.9268981,240.3788971,133.2230091,207.7387017,Benign
172.30.6.255,57494,210.176.156.62,80,31,14703,16,11386,15,3317,3057.937735,19.151793,4756.108214,1385.562177,Benign
192.168.43.224,56912,167.114.119.85,443,8,544,5,338,3,206,2479.245431,51.67213471,52.32994563,31.89339882,Benign
10.0.2.15,49327,119.254.87.201,80,11,1582,6,705,5,877,13104.00765,2.22156,2538.756549,3158.141126,Malicious
172.30.1.136,50356,52.84.103.186,443,11,654,6,348,5,306,640.228989,14.694836,189.454309,166.5891338,Benign
172.30.6.255,55854,209.191.163.208,443,6,348,4,228,2,120,103.607867,10.902807,167.2963669,88.05071942,Benign
192.168.43.233,51350,139.59.46.160,443,263,208689,106,21390,157,187299,3083.952997,188.090243,909.7760589,7966.346239,Benign
172.30.15.1421,50729,52.9.96.194,443,19,7097,10,1840,9,5257,3500.254874,7.00375,2101.731215,6004.783152,Benign
192.168.215.49,53510,216.58.196.202,443,47,8468,23,2803,24,5665,482.9420247,250.1681859,89.63569817,181.1581271,Benign
172.30.6.255,57887,157.240.16.39,443,28,5544,14,3343,14,2201,4327.092964,61.069052,437.9304922,288.3293489,Benign
10.0.2.15,58125,119.254.87.201,80,11,1569,6,705,5,864,17789.01365,1.285473,4387.490052,5377.009085,Malicious
172.30.15.1498,50806,34.233.218.142,443,16,2824,8,2000,8,824,3520.987789,6.20898,2576.912794,1061.688071,Benign
192.168.43.224,33004,35.171.73.174,443,6,412,4,272,2,140,1002.454381,25.16968837,86.45319592,44.49796849,Benign
10.0.2.15,41948,119.254.87.201,80,11,1579,6,705,5,874,16134.92451,1.160526,4859.865268,6024.854247,Malicious
172.30.15.774,50066,34.200.202.18,443,122,98034,52,5419,70,92615,2657.618984,8.825023,4912.395129,83956.7217,Benign
192.168.137.97,41704,104.197.3.80,80,10,911,5,425,5,486,1081.529728,1.028683142,3305.196577,3779.589498,Benign
172.30.6.255,58493,216.58.196.162,80,16,3981,9,2265,7,1716,5711.158255,7.933214,2284.06797,1730.446197,Benign
172.30.6.255,56548,52.114.74.43,443,48,29382,29,21876,19,7506,833.273343,40.363931,4335.752135,1487.664816,Benign
192.168.137.97,57808,23.111.9.35,443,6,356,4,236,2,120,420.880593,46.11704865,40.93930673,20.81659664,Benign
172.30.15.1951,51263,34.205.118.138,443,25,6328,13,1898,12,4430,4028.583983,8.8775,1710.391439,3992.114897,Benign
192.168.43.224,45870,54.237.193.74,443,29,4270,16,2657,13,1613,2429.093503,20.13071542,1055.898887,641.0105022,Benign
10.0.2.15,41729,119.254.87.201,80,11,1513,6,705,5,808,24546.84693,0.825868,6829.178513,7826.91665,Malicious
192.168.137.97,44624,18.208.55.232,443,9,610,5,338,4,272,4061.633343,98.6459212,27.41116883,22.05869207,Benign
172.30.15.828,50127,172.217.166.196,443,7,402,4,228,3,174,3104.309377,10.629687,171.5948927,130.953997,Benign
192.168.43.224,37414,34.201.177.231,443,36,10978,20,3471,16,7507,55.67875936,302.8420879,91.6913504,198.307971,Benign
172.30.6.255,57035,103.243.221.51,80,16,5443,9,4215,7,1228,1593.840536,16.527011,2040.296337,594.4208544,Benign
192.168.215.49,47362,54.245.117.223,443,23,8662,13,2224,10,6438,480.1877023,28.6273789,621.5029347,1799.116859,Benign
172.30.6.255,57452,103.243.221.17,80,35,23435,14,4768,21,18667,2890.853,31.17895,1223.389498,4789.641729,Benign
192.168.215.49,59888,54.148.63.115,443,14,1660,8,1080,6,580,517.1259045,13.35080583,647.1519481,347.5445647,Benign
10.0.2.15,60205,119.254.87.201,80,11,1582,6,705,5,877,3856.46929,1.217965,4630.674937,5760.428255,Malicious
172.30.15.1715,51026,184.29.25.7,443,107,82113,46,21688,61,60425,3618.882286,8.197277,21166.05307,58970.80213,Benign
172.30.15.259,49522,172.217.166.197,443,68,28483,30,7753,38,20730,80.056512,4.451079,13934.59878,37258.38162,Benign
10.0.2.15,57651,119.254.87.201,80,11,1579,6,705,5,874,5175.992033,1.376693,4096.773936,5078.837475,Malicious
172.30.6.255,58232,172.217.166.206,443,17,1779,10,1150,7,629,5182.407605,61.071884,150.6421515,82.39470719,Benign
172.30.6.255,55857,52.203.61.66,443,19,5982,11,1965,8,4017,104.941671,7.599945,2068.436022,4228.451653,Benign
172.30.15.1730,51041,54.201.247.66,443,26,5745,14,4583,12,1162,3623.584763,3.770792,9723.156302,2465.264592,Benign
192.168.137.97,32930,52.216.133.213,443,9,525,5,290,4,235,382.5599381,15.30181327,151.6160182,122.8612562,Benign
172.30.1.136,50297,172.217.161.3,443,22,1308,11,654,11,654,499.794602,20.324334,257.4254094,257.4254094,Benign
172.30.15.2372,51706,14.139.45.128,80,10,1380,5,655,5,725,5334.545776,0.163785,31993.16177,35412.27829,Benign
192.168.43.233,51396,172.217.166.206,443,19,5812,9,1285,10,4527,3625.440681,21.110902,486.9521918,1715.511729,Benign
172.30.15.904,50210,157.240.16.63,443,25,6211,13,1699,12,4512,3438.677545,8.32922,1631.845479,4333.659094,Benign
192.168.43.233,51204,172.217.160.238,443,32,2958,17,1551,15,1407,801.701916,339.207167,36.57941579,33.18326113,Benign
172.30.6.255,56210,104.198.91.84,80,14,2760,8,1472,6,1288,469.888213,21.096996,558.1837338,488.4107671,Benign
172.30.6.255,56915,35.201.85.114,80,23,3349,12,2120,11,1229,1385.94521,277.903681,61.02833881,35.37916434,Benign
172.30.6.255,56844,157.240.16.39,443,22,2889,13,2081,9,808,1338.09348,61.568882,270.3963343,104.988101,Benign
172.30.15.1495,50803,104.19.199.151,443,15,5831,8,1025,7,4806,3520.984228,5.980743,1371.067107,6428.632697,Benign
10.0.2.15,35555,119.254.87.201,80,11,1579,6,705,5,874,13106.34333,3.819995,1476.441723,1830.368888,Malicious
172.30.15.523,49806,23.9.250.106,443,47,25348,20,3181,27,22167,2208.913757,7.162003,3553.195943,24760.671,Benign
10.0.2.15,57688,119.254.87.201,80,11,1513,6,705,5,808,10764.09341,0.887963,6351.616002,7279.582595,Malicious
192.168.137.97,47122,157.240.16.20,443,115,46352,63,6594,52,39758,133.1691709,82.12890479,642.3073599,3872.741282,Benign
192.168.43.233,51079,52.84.109.10,443,53,27758,24,2765,29,24993,916.257041,159.943195,138.2991005,1250.093822,Benign
172.30.6.255,57816,103.243.221.87,80,40,24302,23,20155,17,4147,4064.843656,38.213053,4219.500598,868.1850152,Benign
172.30.6.255,57997,13.75.122.216,443,22,8827,14,2564,8,6263,4726.704585,1.011407,20280.65853,49538.90966,Benign
172.30.15.255,49481,180.149.59.227,80,3,162,2,108,1,54,66.350111,0.010574,81709.85436,40854.92718,Benign
172.30.15.1959,51271,54.236.156.42,443,24,7055,12,2374,12,4681,4073.166621,4.392125,4324.102798,8526.168996,Benign
192.168.215.49,32914,172.217.161.19,443,54,9488,25,3081,29,6407,479.7815746,240.5022331,102.4855349,213.1206822,Benign
172.30.6.255,57654,172.30.13.95,7680,3,198,3,198,0,0,3528.955031,9.004542,175.9112235,0,Benign
192.168.43.233,51157,173.194.166.76,443,23,8730,11,2405,12,6325,479.52813,6.360419,3024.957947,7955.450734,Benign
192.168.137.97,45434,103.243.221.75,443,12,1532,7,1038,5,494,375.8276189,15.12766408,548.9281064,261.2432414,Benign
192.168.137.97,39884,104.113.219.221,443,6,412,4,272,2,140,375.0668065,15.71660883,138.4522593,71.26219226,Benign
172.30.6.255,56151,103.243.221.109,80,6,340,4,228,2,112,394.759279,11.269186,161.8572983,79.50884829,Benign
172.30.15.2133,51445,184.29.26.86,443,14,1562,6,904,8,658,4178.561074,9.150494,790.3398439,575.2694882,Benign
10.0.2.15,36983,119.254.87.201,80,11,1582,6,705,5,877,24213.59558,2.115437,2666.115795,3316.572415,Malicious
172.30.15.2504,51838,14.139.45.128,80,10,1410,5,677,5,733,5475.852881,0.145868,37129.45951,40200.72943,Benign
192.168.137.97,34426,172.217.161.3,443,17,2111,11,1547,6,564,325.4863303,30.4422222,406.5406237,148.2151983,Benign
172.30.6.255,57634,157.240.16.39,443,24,5318,14,3369,10,1949,3473.096618,61.054008,441.4452201,255.3804494,Benign
192.168.137.97,33452,52.94.216.31,443,13,1872,10,1694,3,178,3738.262681,63.16802358,214.538927,22.54305136,Benign
172.30.6.255,57885,52.229.174.233,443,30,10373,16,2271,14,8102,4312.837953,77.75981,233.6425462,833.5411313,Benign
192.168.43.224,55792,54.210.3.254,443,30,7928,16,3189,14,4739,1918.706423,52.63317528,484.7132985,720.3061528,Benign
10.0.2.15,32972,119.254.87.201,80,11,1579,6,705,5,874,3704.464761,1.76503,3195.413109,3961.405755,Malicious
192.168.43.224,60962,54.243.243.77,443,24,7537,14,1551,10,5986,14.35432255,14.31064393,867.0469382,3346.32042,Benign
10.0.2.15,60866,119.254.87.201,80,11,1587,6,705,5,882,21275.73025,1.545083,3650.289337,4566.744958,Malicious
192.168.43.233,51138,52.46.7.55,443,2171,1853331,868,52887,1303,1800444,120.486636,212.080966,1994.973938,67915.34512,Benign
172.30.6.255,56898,103.15.158.129,80,4,240,2,120,2,120,1384.904523,10.271605,93.4615379,93.4615379,Benign
192.168.43.233,50952,104.20.23.135,80,9,510,5,282,4,228,466.9614,23.022542,97.9909169,79.22669877,Benign
172.30.6.255,55902,184.29.25.122,80,40,18220,24,16132,16,2088,120.835253,290.788937,443.8133078,57.44372593,Benign
172.30.6.255,56315,204.2.197.204,80,9,1227,5,725,4,502,590.771027,0.792544,7318.205677,5067.226551,Benign
192.168.43.233,51069,49.44.148.176,443,9,534,5,294,4,240,898.144542,18.594247,126.4907366,103.2577442,Benign
192.168.43.224,38966,23.9.182.234,443,20,7439,12,1707,8,5732,94.39152084,11.85976896,1151.455821,3866.517145,Benign
192.168.43.233,51394,52.175.39.99,443,25,6861,13,2085,12,4776,3517.941501,2.280059,7315.600166,16757.4611,Benign
10.0.2.15,46034,119.254.87.201,80,11,1579,6,705,5,874,2833.626054,1.422669,3964.379627,4914.706091,Malicious
192.168.137.97,50126,169.237.6.105,80,11,2855,6,835,5,2020,1955.435233,1.845168913,3620.264764,8758.005777,Benign
192.168.43.233,51509,13.107.21.200,443,35,13094,20,2537,15,10557,3898.277086,133.337335,152.2154316,633.4009901,Benign
192.168.137.97,60804,172.217.194.189,443,19,5993,10,1713,9,4280,21.89233096,42.598858,321.6987648,803.7774157,Benign
192.168.137.97,33922,104.17.40.113,443,52,9309,27,2902,25,6407,2435.838683,400.6683453,57.94318486,127.9262527,Benign
192.168.137.97,47406,157.240.16.39,443,8,567,4,264,4,303,35.71198787,15.39141984,137.2193094,157.4903437,Benign
10.0.2.15,38833,119.254.87.201,80,11,1579,6,705,5,874,14458.15663,0.980795,5750.437145,7128.910731,Malicious
172.30.6.255,57835,157.240.16.39,443,19,1933,10,1125,9,808,4144.392063,60.739761,148.1731217,106.4212288,Benign
172.30.15.2240,51557,52.220.171.90,443,19,5271,10,3842,9,1429,4467.81949,9.912995,3100.576566,1153.23371,Benign
172.30.15.1439,50747,103.231.98.244,443,8,664,5,490,3,174,3501.344332,0.320565,12228.40921,4342.333068,Benign
172.30.15.1002,50308,8.41.222.241,443,7,402,4,228,3,174,3443.306715,3.955409,461.140681,351.9231513,Benign
192.168.43.224,34168,54.191.37.172,443,30,11539,17,5045,13,6494,156.5401217,20.52426599,1966.452785,2531.247648,Benign
172.30.1.136,50610,157.240.16.20,443,42,11883,22,4033,20,7850,1613.929695,56.084765,575.2720904,1119.733675,Benign
172.30.6.255,56296,52.84.110.150,80,9,534,5,294,4,240,569.161073,19.732807,119.1923683,97.29989251,Benign
192.168.43.224,51474,104.244.42.8,443,81,15471,42,5830,39,9641,37.81039392,906.9906259,51.42280269,85.03726257,Benign
172.30.15.866,50172,180.149.59.136,80,144,117907,61,5877,83,112030,3434.520276,2.523322,18632.58038,355182.5728,Benign
172.30.1.136,51876,13.107.4.52,80,11,1573,6,490,5,1083,4339.518598,0.324665,12073.98395,26685.96861,Benign
192.168.43.233,51325,52.222.134.188,443,9,534,5,294,4,240,3365.772442,14.786335,159.0657861,129.8496213,Benign
192.168.43.233,51491,23.43.115.95,443,29,9444,15,2319,14,7125,3818.936553,237.700762,78.04770941,239.7972961,Benign
172.30.15.502,49782,172.25.10.224,7680,3,198,3,198,0,0,1922.045772,9.028556,175.4433378,0,Benign
192.168.43.233,51339,157.240.16.39,443,85,14946,43,10030,42,4916,3079.263187,155.525997,515.9266074,252.8709075,Benign
172.30.6.255,56034,103.243.221.46,80,48,32058,28,27738,20,4320,252.837695,29.189374,7602.218533,1183.992504,Benign
192.168.43.224,47134,54.161.64.12,443,34,9632,19,2716,15,6916,545.1250378,76.66014398,283.4328097,721.730969,Benign
10.0.2.15,56823,119.254.87.201,80,11,1593,6,705,5,888,19260.67195,2.136108,2640.315939,3325.674545,Malicious
172.30.6.255,57415,103.243.221.109,80,6,340,4,228,2,112,2770.102654,22.928347,79.55218054,39.07826412,Benign
172.30.1.136,51513,13.107.18.11,443,1,54,0,0,1,54,113.650741,0,0,0,Benign
192.168.137.97,34058,172.217.161.3,443,612,330924,279,32850,333,298074,16.88251328,159.3995668,1648.68704,14959.8399,Benign
172.30.6.255,56640,103.243.221.17,80,33,19131,15,9278,18,9853,1024.850524,47.22386,1571.747841,1669.156227,Benign
10.0.2.15,40646,115.182.31.2,80,8,719,4,463,4,256,179.446118,0.567709,6524.469402,3607.482002,Malicious
192.168.43.224,42030,23.251.156.28,443,16,1816,9,1178,7,638,1401.407683,17.32151872,544.063148,294.662384,Benign
172.30.15.2121,51433,34.192.10.179,443,12,1416,6,904,6,512,4178.173098,9.456785,764.7419287,433.128172,Benign
192.168.137.97,53862,74.125.68.188,443,142,10832,73,5745,69,5087,342.6140622,2739.06959,16.77942034,14.85759988,Benign
192.168.43.224,40946,54.85.227.48,443,36,8355,18,2726,18,5629,26.98957547,61.93486119,352.1118734,727.0864766,Benign
172.30.6.255,56719,34.210.162.213,443,23,7670,13,2126,10,5544,1190.949358,41.886592,406.04879,1058.859121,Benign
192.168.137.97,55714,13.107.21.200,443,60,14844,31,4981,29,9863,345.6976961,147.2102863,270.6876062,535.9951536,Benign
10.0.2.15,34661,119.254.87.201,80,11,1582,6,705,5,877,12415.63244,1.647911,3422.51493,4257.51148,Malicious
192.168.43.224,36338,52.20.136.189,443,17,1874,10,1220,7,654,2852.680867,30.39119295,321.1456692,172.1551374,Benign
10.0.2.15,59636,119.254.87.201,80,11,1582,6,705,5,877,1992.500684,1.825764,3089.117761,3842.77486,Malicious
192.168.43.233,50879,172.217.166.206,443,22,6325,11,1663,11,4662,35.450495,30.047299,442.768583,1241.243015,Benign
192.168.42.240,51003,172.217.163.67,443,41,6550,21,4722,20,1828,354.153512,39.511133,956.0849596,370.1235295,Benign
172.30.15.1282,50590,87.248.118.22,443,28,5036,13,2357,15,2679,3469.750469,7.87334,2394.917532,2722.09761,Benign
192.168.43.224,53712,18.136.71.251,443,10,692,6,412,4,280,1203.104817,46.95848237,70.18966188,47.70171196,Benign
192.168.137.97,43104,52.84.110.229,443,111,76710,51,6172,60,70538,1041.92175,155.9882322,316.5366983,3617.606225,Benign
10.0.2.15,56669,119.254.87.201,80,11,1513,6,705,5,808,21693.22227,1.447764,3895.662553,4464.816089,Malicious
192.168.43.233,50931,54.239.35.198,443,64,18313,31,6479,33,11834,436.949593,65.424532,792.2410511,1447.041302,Benign
172.30.6.255,56571,210.176.156.41,80,101,68194,59,50127,42,18067,887.923032,262.30163,1528.835334,551.0297439,Benign
172.30.6.255,56440,13.251.188.142,80,14,2296,8,1475,6,821,700.568525,61.381874,192.2391617,107.0022724,Benign
192.168.43.224,51872,54.173.101.22,443,19,5750,11,1926,8,3824,41.81799416,21.53197745,715.5868538,1420.770576,Benign
172.30.15.786,50078,34.200.202.18,443,31,13250,18,8325,13,4925,2674.694069,4.107026,16216.11356,9593.316429,Benign
192.168.215.49,37896,158.85.224.176,443,32,9270,17,4318,15,4952,40.64901111,1.614103831,21401.34937,24543.65031,Benign
10.0.2.15,51262,119.254.87.201,80,11,1579,6,705,5,874,13496.84243,2.018818,2793.713945,3463.412749,Malicious
192.168.43.233,51223,13.32.226.189,443,143,87280,72,6188,71,81092,1292.963048,191.209318,258.8995166,3392.805365,Benign
172.30.1.136,50622,52.213.11.166,443,24,8953,14,1460,10,7493,1650.585508,62.168712,187.8758563,964.2149253,Benign
172.30.15.1463,50771,54.148.121.12,443,6,340,4,228,2,112,3504.997832,2.275433,801.6056724,393.7712075,Benign
192.168.43.224,40176,54.243.243.77,443,9,610,5,338,4,272,2530.845573,88.1956463,30.65910976,24.67241969,Benign
172.30.6.255,57524,103.243.220.231,80,23,13656,11,5329,12,8327,3122.85527,10.911839,3906.94914,6104.928784,Benign
10.0.2.15,38785,119.254.87.201,80,11,1579,6,705,5,874,21780.82905,1.48014,3810.450363,4723.877471,Malicious
10.0.2.15,52032,119.254.87.201,80,11,1513,6,705,5,808,9320.327662,1.904444,2961.494273,3394.166486,Malicious
192.168.137.97,36750,130.211.21.54,443,9,606,5,338,4,268,1767.173701,50.90695403,53.11651525,42.11605351,Benign
172.30.6.255,55838,103.243.221.75,80,63,50871,20,8569,43,42302,101.885505,20.452955,3351.691724,16546.06877,Benign
192.168.137.97,33530,172.217.161.5,443,46,6016,23,2953,23,3063,6065.132078,240.2386788,98.33553913,101.9985629,Benign
172.30.15.1320,50628,104.19.199.151,443,6,348,4,228,2,120,3488.480208,8.538511,213.6203842,112.4317811,Benign
10.0.2.15,40725,219.234.85.243,80,8,1325,4,1069,4,256,89.612825,0.309896,27596.35491,6608.668715,Malicious
172.30.1.136,50652,193.32.65.35,443,18,5489,11,1513,7,3976,1749.977782,16.159743,749.021813,1968.348135,Benign
172.30.15.1732,51043,161.202.1.35,443,6,348,4,228,2,120,3623.816732,3.314612,550.2906524,289.6266592,Benign
192.168.43.233,51631,13.107.4.52,80,15,5233,5,405,10,4828,832.733125,4.679218,692.4233921,8254.370709,Benign
172.30.6.255,57989,103.243.221.17,80,37,19923,19,12358,18,7565,4696.86268,25.242335,3916.594879,2397.559497,Benign
192.168.137.97,45784,54.251.174.92,443,7,478,5,338,2,140,349.9031051,13.85574827,195.1536609,80.83287731,Benign
192.168.43.233,51188,74.125.68.188,443,67,9195,36,3066,31,6129,638.204071,952.233945,25.758376,51.49154812,Benign
172.30.6.255,57314,103.243.221.17,80,46,29871,26,24759,20,5112,2467.835845,43.193389,4585.701761,946.8115595,Benign
192.168.215.49,50024,117.18.237.29,80,19,4766,11,1872,8,2894,279.5771631,135.3780585,110.6235395,171.0173735,Benign
172.30.6.255,57609,103.243.221.87,80,6,340,4,228,2,112,3385.840195,16.22385,112.427075,55.22733507,Benign
192.168.137.97,57600,169.60.79.147,443,9,598,5,338,4,260,7157.15903,123.9841129,21.80924586,16.77634297,Benign
172.30.6.255,58491,157.240.16.17,443,247,192712,109,8254,138,184458,5700.988235,8.077131,8175.180024,182696.554,Benign
172.30.15.2427,51761,14.139.45.128,443,3,198,3,198,0,0,5386.613654,9.001226,175.9760282,0,Benign
172.30.6.255,58129,172.217.166.197,443,33,8992,17,3973,16,5019,4903.838038,5.120253,6207.505762,7841.800005,Benign
172.30.6.255,56122,52.84.108.179,443,16,2608,9,1663,7,945,332.766194,78.848074,168.7295494,95.88059183,Benign
10.0.2.15,39487,119.254.87.201,80,11,1582,6,705,5,877,12503.33886,1.41452,3987.218279,4959.986426,Malicious
10.0.2.15,50818,119.254.87.201,80,11,1579,6,705,5,874,19744.19269,2.215405,2545.809908,3156.082071,Malicious
172.30.6.255,57474,103.243.220.231,80,19,7314,10,5273,9,2041,2991.85633,14.169983,2976.99722,1152.29496,Benign
192.168.43.224,37436,104.197.3.80,80,10,911,5,425,5,486,2789.540531,1.724817315,1971.223254,2254.151768,Benign
192.168.137.97,55862,172.217.161.14,443,21,6048,11,1437,10,4611,29.14584634,12.07601642,951.9695568,3054.649705,Benign
172.30.6.255,56188,54.169.126.196,80,16,4100,9,2196,7,1904,466.791484,64.326924,273.1049288,236.7904301,Benign
10.0.2.15,40448,119.254.87.201,80,11,1582,6,705,5,877,5027.830453,1.213831,4646.44584,5780.04681,Malicious
192.168.42.240,51020,104.108.212.173,80,18,2553,13,1128,5,1425,488.455066,97.798645,92.27121705,116.5660322,Benign
172.30.15.2090,51402,52.84.108.91,443,32,6966,17,2404,15,4562,4140.927226,6.450041,2981.686473,5658.258606,Benign
172.30.6.255,58219,52.175.39.99,443,23,5840,13,1338,10,4502,5164.261003,1.188594,9005.598211,30301.34764,Benign
10.0.2.15,33168,119.254.87.201,80,11,1582,6,705,5,877,673.033242,1.700729,3316.224984,4125.289802,Malicious
172.30.15.1124,50432,104.18.255.119,443,12,2051,7,1001,5,1050,3458.294702,8.650867,925.687564,971.0009413,Benign
172.30.6.255,57457,52.229.173.178,443,29,10103,16,2254,13,7849,2895.863541,72.439219,248.9259306,866.8232605,Benign
192.168.215.49,36944,52.84.110.252,443,241,207810,88,7073,153,200737,280.5728041,180.0652125,314.2417083,8918.413376,Benign
10.0.2.15,51703,219.234.85.243,80,2,138,1,74,1,64,187.673817,2.17522,272.1563796,235.3784905,Malicious
192.168.43.233,51216,172.217.160.229,443,7,403,4,229,3,174,1443.016607,61.894442,29.59878045,22.48990305,Benign
172.30.6.255,56922,54.149.58.94,80,12,2966,7,1986,5,980,1386.864684,32.778705,484.7049327,239.1796747,Benign
192.168.43.224,50362,34.205.118.138,443,9,598,5,338,4,260,2925.269109,90.20418218,29.97643718,23.05879783,Benign
10.0.2.15,49868,119.254.87.201,80,11,1582,6,705,5,877,13101.48654,2.212713,2548.907156,3170.768193,Malicious
10.0.2.15,58874,119.254.87.201,80,11,1582,6,705,5,877,22567.2495,1.529671,3687.06735,4586.607185,Malicious
172.30.6.255,58474,35.190.41.40,443,6,348,4,228,2,120,5680.848417,8.237611,221.42342,116.5386421,Benign
172.30.6.255,57423,172.217.166.206,443,17,1783,10,1154,7,629,2783.394245,136.779753,67.49536973,36.78907067,Benign
192.168.43.224,37410,34.201.177.231,443,36,10975,20,3468,16,7507,55.66812264,302.8604356,91.6065512,198.2959573,Benign
192.168.42.240,51029,13.35.129.69,443,86,41026,42,3596,44,37430,502.201717,106.170638,270.960037,2820.365457,Benign
172.30.15.1420,50728,52.4.175.160,443,6,348,4,228,2,120,3500.249249,6.964834,261.8870744,137.8353023,Benign
192.168.137.97,39728,192.168.125.6,80,15,4306,8,1122,7,3184,8292.894274,5.707831965,1572.576077,4462.640133,Benign
192.168.43.233,51310,117.18.232.102,443,1140,945939,439,25516,701,920423,2591.655863,343.960623,593.4632814,21407.63654,Benign
172.30.15.1311,50619,139.59.82.147,443,6,348,4,228,2,120,3487.176872,9.849886,185.1798082,97.46305693,Benign
10.0.2.15,36750,119.254.87.201,80,11,1544,6,705,5,839,15268.96763,1.573458,3584.46174,4265.763687,Malicious
172.30.15.1567,50876,54.169.137.62,443,11,1323,6,904,5,419,3557.468566,9.587635,754.3048938,349.6169806,Benign
192.168.137.97,57438,104.197.3.80,80,11,977,6,491,5,486,6023.812173,0.873325812,4497.748659,4451.946738,Benign
172.30.15.878,50184,205.185.216.42,80,46,34037,18,1396,28,32641,3436.885359,10.284796,1085.874722,25389.71118,Benign
192.168.137.97,49432,157.240.16.52,443,23,5454,13,1475,10,3979,6770.163531,20.77186198,568.0761797,1532.457708,Benign
192.168.215.49,47240,157.240.16.39,443,39,7730,18,3984,21,3746,725.7516306,85.3593273,373.3862603,351.080555,Benign
172.30.15.636,49923,52.84.110.188,443,33,15266,18,2367,15,12899,2393.426757,2.706939,6995.35527,38121.28755,Benign
192.168.43.233,51156,182.161.72.82,443,4,240,2,120,2,120,947.444716,10.960098,87.59045768,87.59045768,Benign
172.30.6.255,58370,103.243.221.51,80,16,5545,9,4317,7,1228,5484.891802,3.458925,9984.605043,2840.188787,Benign
10.0.2.15,48670,119.254.87.201,80,11,1579,6,705,5,874,10704.0072,1.216813,4635.058961,5746.158202,Malicious
172.30.15.1762,51074,157.240.16.39,443,282,242614,102,9606,180,233008,3638.572712,8.596274,8939.687125,216845.5775,Benign
192.168.137.97,39320,172.217.160.238,443,17,1174,9,618,8,556,7319.647531,91.95101925,53.76775636,48.37358015,Benign
192.168.137.97,60248,151.101.12.193,80,59,26880,31,2530,28,24350,5244.423878,422.706882,47.88187952,460.8394334,Benign
192.168.43.233,51268,52.114.132.73,443,26,11199,14,5974,12,5225,2484.944789,9.097484,5253.320588,4594.676946,Benign
10.0.2.15,40929,119.254.87.201,80,12,1634,7,779,5,855,26021.05167,3.853096,1617.400657,1775.195843,Malicious
10.0.2.15,36172,119.254.87.201,80,11,1560,6,705,5,855,22867.74659,0.993464,5677.105562,6885.000362,Malicious
172.30.1.136,50532,74.125.200.188,5228,29,2882,15,1612,14,1270,1130.695933,274.626774,46.95827654,36.99566452,Benign
192.168.215.49,34662,52.84.110.78,443,42,12679,21,2707,21,9972,510.5989504,180.0361632,120.2869447,443.1109762,Benign
172.30.15.1558,50867,54.169.137.62,443,54,41848,20,3066,34,38782,3557.004497,10.082783,2432.661697,30770.86951,Benign
192.168.137.97,48786,23.57.214.252,443,19,1266,10,668,9,598,902.8869877,308.7695845,17.30740419,15.49375405,Benign
172.30.6.255,57821,157.240.16.39,443,5,330,1,66,4,264,4083.087648,15.144064,34.86514584,139.4605834,Benign
10.0.2.15,48438,119.254.87.201,80,11,1585,6,705,5,880,4667.449612,1.872392,3012.189755,3759.896432,Malicious
192.168.43.224,51530,54.197.248.134,443,111,84932,48,6394,63,78538,615.4226678,63.44404462,806.2537675,9903.277821,Benign
172.30.6.255,56313,205.251.72.175,80,7,402,4,228,3,174,590.9417,15.12919,120.5616428,92.00756947,Benign
172.30.6.255,57210,103.243.221.75,80,18,6306,9,4498,9,1808,2103.849978,27.173471,1324.232742,532.2838588,Benign
172.30.15.2105,51417,34.196.221.221,443,6,348,4,228,2,120,4146.325469,1.370895,1330.517655,700.2724498,Benign
192.168.43.224,56604,172.217.161.10,443,47,8220,21,2586,26,5634,1151.984003,240.6970949,85.95035185,187.256103,Benign
172.30.15.2225,51541,52.220.171.90,443,24,8020,13,3208,11,4812,4449.300618,8.749855,2933.077177,4399.615765,Benign
10.0.2.15,59623,119.254.87.201,80,11,1513,6,705,5,808,19648.50393,1.588947,3549.520532,4068.102964,Malicious
192.168.137.97,53240,104.244.43.3,443,12,832,7,478,5,354,217.7555221,67.75779921,56.43630762,41.79592656,Benign
172.30.15.2433,51767,14.139.45.128,443,3,198,3,198,0,0,5412.894115,9.002078,175.9593729,0,Benign
172.30.6.255,57085,157.240.16.39,443,19,1933,10,1125,9,808,1704.096996,61.02877,147.4714303,105.9172584,Benign
192.168.43.224,57228,172.217.194.188,5228,115,19742,60,4840,55,14902,14.48397706,1519.047214,25.48966197,78.48077328,Benign
10.0.2.15,53966,119.254.87.201,80,11,1513,6,705,5,808,8449.430295,1.017797,5541.380059,6350.971756,Malicious
172.30.6.255,55632,157.240.16.36,443,88,21677,46,9455,42,12222,22.906631,35.696408,2118.980711,2739.099127,Benign
192.168.137.97,34798,172.217.161.19,443,53,9577,26,3599,27,5978,1754.648644,248.2511938,115.9793013,192.6435852,Benign
172.30.6.255,55664,35.190.43.164,80,14,3049,8,2261,6,788,38.087798,20.522149,881.3891762,307.1803055,Benign
10.0.2.15,54595,119.254.87.201,80,11,1579,6,705,5,874,23916.11861,4.06559,1387.252527,1719.799586,Malicious
192.168.43.233,51450,23.74.147.187,80,18,6319,10,3870,8,2449,3810.179362,7.602636,4072.271775,2577.000924,Benign
10.0.2.15,56374,124.95.142.227,80,19,6587,10,784,9,5803,52.349606,98.408693,63.7342069,471.7469421,Malicious
192.168.137.97,37854,117.18.237.70,443,55,15596,27,3007,28,12589,1480.560623,180.6518749,133.162194,557.4921382,Benign
192.168.43.224,57852,172.217.166.197,443,74,33730,31,6029,43,27701,2662.782971,242.1625103,199.1720351,915.1210058,Benign
10.0.2.15,39312,119.254.87.201,80,11,1569,6,705,5,864,13647.05015,2.192738,2572.12672,3152.223385,Malicious
172.30.6.255,57649,103.243.221.46,80,14,6798,10,5733,4,1065,3517.099466,3.533494,12979.78715,2411.211113,Benign
172.30.15.1897,51209,54.86.233.56,443,18,2911,10,1971,8,940,3983.610528,3.878388,4065.606639,1938.949894,Benign
10.0.2.15,54665,119.254.87.201,80,11,1579,6,705,5,874,15564.28714,1.700794,3316.098246,4111.021088,Malicious
172.30.15.1592,50901,130.211.5.208,443,30,8124,15,2709,15,5415,3572.493976,4.657308,4653.331925,9301.510658,Benign
10.0.2.15,35804,119.254.87.201,80,11,1579,6,705,5,874,9470.536542,2.667636,2114.231477,2621.047249,Malicious
10.0.2.15,41935,119.254.87.201,80,11,1513,6,705,5,808,18302.70794,2.018952,2793.528524,3201.66106,Malicious
192.168.43.233,50976,49.44.170.2,443,103,71009,47,5813,56,65196,502.149775,152.987913,303.9717262,3409.210504,Benign
172.30.15.1916,51228,64.74.232.52,443,7,402,4,228,3,174,3985.306781,2.228616,818.4451696,624.6028926,Benign
172.30.6.255,57108,103.231.98.53,80,39,17419,20,15673,19,1746,1800.856346,61.063312,2053.34424,228.7461905,Benign
192.168.43.224,57978,172.217.166.206,443,48,8802,23,2609,25,6193,16.73733354,242.3250984,86.13222543,204.4526148,Benign
192.168.43.233,51038,163.53.79.200,443,16,6873,9,1173,7,5700,820.077811,18.072297,519.2477746,2523.198905,Benign
10.0.2.15,57100,119.254.87.201,80,11,1579,6,705,5,874,11539.94574,4.52655,1245.982039,1544.664259,Malicious
172.30.15.495,49774,162.247.242.19,443,22,6369,10,2539,12,3830,1849.166756,6.789778,2991.555836,4512.665952,Benign
172.30.15.454,49728,172.217.166.200,443,63,39119,27,2791,36,36328,1636.058592,4.553521,4903.458225,63824.01662,Benign
192.168.43.233,51335,104.19.196.151,443,7,402,4,228,3,174,3077.011294,60.161768,30.31825793,23.1376179,Benign
172.30.15.1930,51242,34.201.201.2,443,70,15783,40,7245,30,8538,3991.667547,5.775856,10034.87622,11825.77959,Benign
192.168.137.97,51846,103.102.166.224,443,38,8006,20,2495,18,5511,5424.751167,231.1150013,86.36393088,190.7621736,Benign
192.168.137.97,51072,157.240.16.35,443,11,730,6,404,5,326,22.91137497,16.94859654,190.6942555,153.8770478,Benign
172.30.15.1542,50850,180.179.41.214,443,17,4019,9,2860,8,1159,3533.880468,0.221453,103317.634,41868.9293,Benign
10.0.2.15,59922,119.254.87.201,80,11,1513,6,705,5,808,16650.57137,1.221526,4617.175566,5291.741641,Malicious
192.168.42.240,50936,216.58.221.67,443,41,8282,22,2611,19,5671,160.538018,51.003335,409.5418466,889.5104604,Benign
172.30.6.255,57671,103.243.220.231,80,16,5526,9,4299,7,1227,3582.905859,35.136102,978.8222951,279.3707737,Benign
10.0.2.15,45449,119.254.87.201,80,11,1582,6,705,5,877,10668.9948,0.834372,6759.574866,8408.719372,Malicious
172.30.15.1627,50937,184.29.25.7,443,377,332367,145,33098,232,299269,3574.563915,12.935489,20469.57792,185083.9964,Benign
192.168.43.224,36206,43.245.63.29,443,22,7647,12,1410,10,6237,2469.922611,60.67143824,185.9194429,822.396855,Benign
192.168.137.97,34528,172.217.161.19,443,53,9407,23,2972,30,6435,346.8189219,240.6712799,98.79035012,213.901717,Benign
10.0.2.15,52647,119.254.87.201,80,11,1582,6,705,5,877,18176.99673,1.553394,3630.759485,4516.5618,Malicious
192.168.43.224,33640,18.211.245.141,443,11,730,6,404,5,326,1571.363173,139.2074489,23.21714841,18.73462965,Benign
10.0.2.15,38886,119.254.87.201,80,11,1552,6,705,5,847,8779.713824,1.879903,3000.154795,3604.441293,Malicious
192.168.137.97,59114,157.240.16.20,443,8,567,4,264,4,303,17.53600664,19.76198389,106.8718613,122.6597498,Benign
172.30.1.136,50792,34.225.100.237,443,10,564,7,390,3,174,1931.586011,28.532821,109.3477578,48.78592271,Benign
192.168.137.97,55220,172.217.161.16,80,59,29990,31,2748,28,27242,329.3173195,285.7450352,76.93571992,762.6939164,Benign
10.0.2.15,46685,119.254.87.201,80,11,1513,6,705,5,808,3886.503571,0.895524,6297.988664,7218.120341,Malicious
172.30.6.255,58102,157.240.16.39,443,27,5488,15,3433,12,2055,4876.081329,61.066927,449.736074,269.2128261,Benign
172.30.6.255,56520,23.198.119.247,443,12,3621,6,1123,6,2498,831.968176,41.616266,215.8771284,480.1968538,Benign
172.30.15.2098,51410,52.7.89.176,443,6,348,4,228,2,120,4145.095054,2.59982,701.5870329,369.2563331,Benign
192.168.137.97,57128,18.211.245.141,443,12,804,7,478,5,326,6799.137611,153.6983589,24.87990131,16.96830089,Benign
172.30.15.533,49817,104.113.219.221,443,172,135608,65,6038,107,129570,2248.098598,7.947605,6077.80583,130424.197,Benign
172.30.15.1438,50746,103.231.98.244,443,8,973,5,799,3,174,3501.242145,0.327031,19545.54767,4256.477215,Benign
172.30.6.255,58488,176.34.147.227,443,25,9657,13,3994,12,5663,5683.741253,5.489554,5820.50928,8252.765161,Benign
10.0.2.15,44824,119.254.87.201,80,11,1579,6,705,5,874,11692.58335,0.975403,5782.225398,7168.319146,Malicious
192.168.137.97,34724,172.217.161.3,443,46,6749,24,3891,22,2858,1054.055695,240.3787138,129.4956592,95.11657518,Benign
192.168.43.224,39592,52.84.110.101,443,47,9463,25,3398,22,6065,35.64652708,186.9209598,145.4304538,259.5749565,Benign
172.30.1.136,50588,104.113.230.86,443,18,1032,8,456,10,576,1595.629839,22.733962,160.4647707,202.692342,Benign
172.30.6.255,56896,103.15.158.129,80,9,4265,5,2751,4,1514,1384.856795,10.260273,2144.972166,1180.475412,Benign
10.0.2.15,41801,119.254.87.201,80,11,1582,6,705,5,877,2230.574974,7.343096,768.0684006,955.4553011,Malicious
192.168.42.240,50891,172.217.166.195,443,18,1237,8,460,10,777,27.880392,151.782934,24.24514999,40.95322074,Benign
192.168.137.97,55364,172.217.161.10,443,17,4968,9,1377,8,3591,421.0608926,45.37865961,242.7572805,633.072908,Benign
192.168.43.233,50961,163.53.78.128,443,221,148549,112,7662,109,140887,480.5258,98.837926,620.1667971,11403.47684,Benign
172.30.6.255,56248,210.176.156.35,80,26,6278,14,4852,12,1426,529.675176,301.136655,128.8982904,37.88313316,Benign
192.168.43.224,42276,18.211.245.141,443,6,412,4,272,2,140,3086.233893,26.50178351,82.10768152,42.26130667,Benign
192.168.43.224,42722,107.21.25.13,443,51,11312,28,5650,23,5662,56.76948164,63.35985458,713.3854757,714.9006307,Benign
172.30.15.357,49625,104.25.218.21,443,6,348,4,228,2,120,1334.553431,5.814248,313.7121086,165.1116361,Benign
172.30.1.136,51860,74.125.24.188,5228,25,2626,15,1620,10,1006,4081.793415,116.103369,111.6246678,69.31754065,Benign
172.30.15.2202,51514,77.88.21.119,443,6,348,4,228,2,120,4299.406894,8.269939,220.5578542,116.0830811,Benign
10.0.2.15,54603,119.254.87.201,80,12,1653,7,779,5,874,24393.7867,3.904761,1596.00037,1790.634561,Malicious
172.30.15.1685,50996,184.29.25.7,443,69,55591,28,7385,41,48206,3607.744023,9.384831,6295.2652,41092.69522,Benign
172.30.1.136,50475,172.217.161.3,443,32,8604,21,6878,11,1726,900.918202,21.781544,2526.175371,633.931185,Benign
10.0.2.15,41533,119.254.87.201,80,11,1579,6,705,5,874,939.060014,0.821123,6868.642091,8515.167642,Malicious
192.168.43.224,48538,49.44.150.17,443,49,21322,23,5127,26,16195,3250.856984,95.93130719,427.5559377,1350.549719,Benign
192.168.137.97,46962,172.217.167.10,80,12,832,7,478,5,354,5242.500357,65.52388143,58.36040107,43.2208828,Benign
172.30.1.136,51890,52.46.136.108,443,375,240251,192,217240,183,23011,4588.680203,25.898864,67104.10155,7107.95655,Benign
10.0.2.15,54300,119.254.87.201,80,11,1582,6,705,5,877,23738.4934,1.421749,3966.944939,4934.766967,Malicious
10.0.2.15,41829,119.254.87.201,80,11,1582,6,705,5,877,26078.69252,0.893455,6312.573101,7852.661858,Malicious
172.30.1.136,50524,172.217.161.14,443,20,1188,11,654,9,534,1039.250943,31.046471,168.5215688,137.6001801,Benign
172.30.15.527,49811,23.56.26.202,80,11,2515,6,553,5,1962,2241.964411,60.506489,73.11612478,259.4101932,Benign
192.168.215.49,46398,223.31.160.67,443,316,209573,147,12419,169,197154,293.0515134,17.23724648,5763.797608,91501.38928,Benign
172.30.15.1790,51102,52.37.171.77,443,15,5005,8,1087,7,3918,3643.147406,3.840626,2264.214219,8161.169559,Benign
192.168.215.49,36432,157.240.16.52,443,72,28794,37,3847,35,24947,25.36435913,84.06067331,366.116506,2374.189882,Benign
10.0.2.15,34955,119.254.87.201,80,11,1579,6,705,5,874,4607.42735,1.948369,2894.728873,3588.642603,Malicious
10.0.2.15,33947,119.254.87.201,80,11,1582,6,705,5,877,643.015737,0.825605,6831.353977,8498.01055,Malicious
172.30.6.255,56406,172.217.166.197,443,29,8218,16,5473,13,2745,665.456076,164.749801,265.7605638,133.293029,Benign
10.0.2.15,40071,119.254.87.201,80,11,1579,6,705,5,874,521.124221,1.217238,4633.440625,5744.151924,Malicious
192.168.43.233,51166,74.125.103.103,443,1149,909840,528,35624,621,874216,483.92708,80.665802,3532.996548,86700.03678,Benign
192.168.43.224,60828,35.171.73.174,443,51,12238,28,5429,23,6809,23.01066122,62.16281319,698.6813784,876.2795184,Benign
10.0.2.15,57487,119.254.87.201,80,12,1653,7,779,5,874,12115.39415,3.798425,1640.680019,1840.762948,Malicious
192.168.137.97,51792,172.217.161.3,443,190,62003,99,44652,91,17351,3833.556262,490.3832398,728.442514,283.060245,Benign
192.168.43.224,52054,54.236.156.42,443,9,610,5,338,4,272,2924.270754,91.20255485,29.64829225,23.85898074,Benign
172.30.15.991,50297,52.221.102.82,443,21,8037,11,2544,10,5493,3442.85446,4.206531,4838.190899,10446.61266,Benign
10.0.2.15,47979,119.254.87.201,80,11,1569,6,705,5,864,25660.55866,1.955722,2883.845455,3534.244642,Malicious
10.0.2.15,59890,119.254.87.201,80,13,1727,8,853,5,874,22441.63388,10.017491,681.2084982,697.9791646,Malicious
192.168.43.224,33938,52.84.108.93,443,2151,1857962,882,66471,1269,1791491,2848.410605,261.2405866,2035.548943,54861.03131,Benign
172.30.15.2081,51393,151.101.194.2,443,21,3235,10,1991,11,1244,4123.331528,4.037335,3945.176707,2464.992377,Benign
10.0.2.15,48986,119.254.87.201,80,11,1579,6,705,5,874,18447.28005,1.204259,4683.377911,5806.059992,Malicious
192.168.137.97,54558,104.244.46.231,443,23,5475,13,2091,10,3384,305.5264395,92.33260959,181.1710952,293.2008542,Benign
172.30.6.255,58297,157.240.16.39,443,82,55471,33,5307,49,50164,5325.149711,8.852112,4796.143564,45335.16973,Benign
10.0.2.15,33292,119.254.87.201,80,11,1513,6,705,5,808,13221.63018,1.834724,3074.031843,3523.145716,Malicious
10.0.2.15,38458,119.254.87.201,80,12,1587,7,779,5,808,11664.99671,6.972567,893.7884713,927.0617263,Malicious
172.30.6.255,58575,210.176.156.21,80,11,5363,6,3863,5,1500,5879.96668,0.526938,58648.26602,22773.07767,Benign
172.30.6.255,57733,69.173.144.141,80,402,253059,203,182724,199,70335,3780.029999,993.968726,1470.661965,566.0942697,Benign
172.30.6.255,56949,52.77.109.174,443,22,8086,12,3828,10,4258,1389.327567,64.926591,471.6711524,524.6540666,Benign
192.168.43.233,51150,74.125.158.168,443,24,8974,11,2619,13,6355,476.169068,7.441507,2815.55873,6831.949496,Benign
172.30.6.255,58455,172.217.166.206,443,17,1783,10,1154,7,629,5642.40979,83.059196,111.1496432,60.58329772,Benign
172.30.1.136,51847,172.217.160.227,443,9,511,5,283,4,228,3683.054276,56.099971,40.3565271,32.51338579,Benign
10.0.2.15,54139,119.254.87.201,80,12,1656,7,779,5,877,11149.49075,3.955765,1575.4222,1773.613953,Malicious
192.168.137.97,38592,157.240.16.16,443,48,9452,26,4116,22,5336,37.96461096,143.4349031,229.567555,297.6123599,Benign
192.168.42.240,50972,64.233.184.94,443,18,1056,10,588,8,468,287.980766,37.346585,125.9552915,100.25013,Benign
10.0.2.15,37405,119.254.87.201,80,12,1656,7,779,5,877,15896.90799,6.872725,906.7727866,1020.846898,Malicious
172.30.6.255,56937,34.233.6.212,80,12,3822,7,2441,5,1381,1387.827997,16.748899,1165.927384,659.6254476,Benign
10.0.2.15,50072,119.254.87.201,80,11,1579,6,705,5,874,548.62791,1.818198,3101.972392,3845.565774,Malicious
192.168.137.97,34380,172.217.161.3,443,9,622,5,350,4,272,281.0664866,23.66209738,118.3327055,91.96141682,Benign
10.0.2.15,57672,119.254.87.201,80,11,1582,6,705,5,877,16980.98013,2.470126,2283.284334,2840.340938,Malicious
172.30.15.548,49832,204.11.109.66,443,7,402,4,228,3,174,2252.041888,4.273847,426.781773,325.7018794,Benign
172.30.6.255,56179,172.217.166.206,443,38,6531,19,3895,19,2636,448.420761,161.790648,192.5945683,130.3412791,Benign
172.30.15.2119,51431,104.113.220.53,443,17,7130,10,1219,7,5911,4178.125279,9.222682,1057.393066,5127.358831,Benign
10.0.2.15,57944,119.254.87.201,80,11,1582,6,705,5,877,22263.95552,2.214579,2546.759452,3168.09651,Malicious
172.30.15.478,49753,172.217.166.196,443,24,6922,12,1440,12,5482,1730.055827,1.444591,7974.575503,30358.76591,Benign
172.30.1.136,50266,52.94.220.15,443,43,12835,20,2288,23,10547,481.528461,28.662138,638.6125138,2943.813891,Benign
192.168.43.224,35906,104.17.162.9,443,20,7163,12,1325,8,5838,36.92514507,12.95482313,818.228076,3605.143779,Benign
172.30.15.2156,51468,34.234.132.222,443,87,33311,47,18377,40,14934,4188.906622,8.717947,16863.60332,13704.14388,Benign
10.0.2.15,35670,119.254.87.201,80,11,1513,6,705,5,808,15023.73245,1.050019,5371.331376,6156.07908,Malicious
10.0.2.15,55621,119.254.87.201,80,11,1579,6,705,5,874,20191.60607,1.892328,2980.455819,3694.919697,Malicious
192.168.137.97,43506,157.240.16.39,443,6,412,4,272,2,140,3079.548486,1.168928337,1861.534134,958.1425692,Benign
172.30.6.255,57873,103.243.221.51,80,53,35452,32,30268,21,5184,4276.837454,27.210907,8898.784594,1524.094732,Benign
192.168.137.97,41186,23.57.218.60,443,28,6245,16,4569,12,1676,81.58813631,97.17444725,376.1482677,137.9786598,Benign
192.168.43.224,49942,34.196.177.243,443,70,10273,39,5048,31,5225,2053.827029,31.43237486,1284.789971,1329.839065,Benign
192.168.137.97,45554,104.197.3.80,80,10,911,5,425,5,486,462.8321665,1.429030811,2379.234915,2720.725103,Benign
172.30.6.255,57562,103.243.221.17,80,44,29588,19,10989,25,18599,3253.846241,28.221697,3115.050098,5272.255598,Benign
172.30.15.519,49802,23.9.250.106,443,28,8129,14,2441,14,5688,2126.080426,9.958816,1960.87567,4569.217867,Benign
192.168.43.233,51228,13.107.4.52,80,10,1476,5,393,5,1083,1628.867165,0.291352,10791.0706,29737.22507,Benign
172.30.15.470,49745,52.114.75.78,443,21,7974,11,3226,10,4748,1720.755854,1.575197,16383.98245,24113.80926,Benign
172.30.6.255,57625,103.231.98.53,80,29,12042,15,10802,14,1240,3436.84643,60.120211,1437.386838,165.0027476,Benign
172.30.1.136,50773,13.107.4.52,80,10,1519,5,436,5,1083,1919.586936,0.156024,22355.53505,55529.91847,Benign
172.30.6.255,57717,161.69.226.18,443,25,6472,14,3219,11,3253,3716.860703,269.715169,95.47850088,96.48697215,Benign
10.0.2.15,49204,119.254.87.201,80,11,1582,6,705,5,877,6797.527952,0.826101,6827.252358,8492.908252,Malicious
172.30.15.1603,50913,52.229.207.60,443,33,12561,19,3205,14,9356,3573.173214,5.691834,4504.699188,13150.06727,Benign
172.30.1.136,51889,52.46.136.108,443,88,22849,40,7548,48,15301,4588.399301,12.85104,4698.76368,9525.14349,Benign
10.0.2.15,57057,119.254.87.201,80,11,1582,6,705,5,877,21903.46414,6.66286,846.483342,1053.001264,Malicious
172.30.6.255,56330,203.174.85.172,80,18,5635,10,4795,8,840,591.895982,15.973915,2401.415057,420.6858494,Benign
10.0.2.15,44949,119.254.87.201,80,11,1513,6,705,5,808,22474.27183,1.819205,3100.255331,3553.200436,Malicious
172.30.6.255,57107,103.243.221.87,80,53,35659,23,13442,30,22217,1800.855733,41.175783,2611.632182,4316.517794,Benign
192.168.42.240,50962,104.237.191.1,443,15,834,9,498,6,336,228.033201,52.17948,76.35185326,51.5145034,Benign
172.30.6.255,57304,157.240.16.39,443,19,1933,10,1125,9,808,2436.085734,61.029534,147.4695842,105.9159324,Benign
192.168.137.97,52066,172.217.161.3,443,9,606,5,338,4,268,7354.299078,27.01846134,100.0797183,79.35314942,Benign
10.0.2.15,36538,119.254.87.201,80,11,1554,6,705,5,849,19413.8524,2.188107,2577.570475,3104.052955,Malicious
172.30.1.136,50771,157.240.16.16,443,4,264,1,66,3,198,1921.669672,8.938506,59.07027416,177.2108225,Benign
172.30.1.136,51905,157.240.16.39,443,36,8472,17,3238,19,5234,5320.355341,67.330484,384.7291518,621.8877025,Benign
192.168.43.233,50068,74.125.68.188,5228,4,242,2,110,2,132,18.029421,45.282687,19.43347576,23.32017091,Benign
192.168.137.97,52916,52.84.108.11,443,8,552,5,338,3,214,3707.185634,14.26569064,189.5456777,120.0082102,Benign
10.0.2.15,57611,119.254.87.201,80,11,1579,6,705,5,874,4064.92164,0.888493,6347.827164,7869.504881,Malicious
192.168.137.97,40168,157.240.16.20,443,16,5160,9,1183,7,3977,22.6608848,14.71421621,643.1875043,2162.262641,Benign
172.30.1.136,50323,104.244.46.103,443,16,996,9,558,7,438,568.129129,27.906824,159.9608755,125.5606872,Benign
192.168.137.97,41032,172.217.167.42,443,14,2280,8,1639,6,641,343.8433459,22.88975771,572.8326253,224.0303312,Benign
192.168.137.97,55016,198.252.206.25,443,111,13189,54,5334,57,7855,24.28441779,1795.846448,23.761497,34.99185582,Benign
172.30.1.136,51854,74.125.200.188,5228,29,3026,15,1634,14,1392,3864.274519,217.060585,60.22281751,51.3036487,Benign
172.30.6.255,58535,157.240.16.17,443,521,428362,218,17480,303,410882,5791.634274,7.459963,18745.40128,440626.3141,Benign
172.30.15.743,50032,158.85.224.180,443,26,8586,11,3810,15,4776,2547.61545,1.419781,21468.09966,26911.19264,Benign
172.30.6.255,56987,103.243.220.231,80,16,5443,9,4215,7,1228,1452.837084,27.736843,1215.711536,354.1859468,Benign
192.168.43.233,50871,204.79.197.200,443,35,11774,19,3601,16,8173,2.902996,64.406537,447.2837905,1015.176456,Benign
10.0.2.15,60345,119.254.87.201,80,11,1579,6,705,5,874,12921.22277,2.219235,2541.416299,3150.635241,Malicious
10.0.2.15,60096,119.254.87.201,80,11,1582,6,705,5,877,22384.12785,0.892165,6321.700582,7864.016185,Malicious
172.30.6.255,55757,172.217.166.206,443,55,8882,29,5245,26,3637,61.400881,108.781753,385.7264554,267.4713286,Benign
192.168.43.233,50923,52.84.103.186,443,150,83402,68,8308,82,75094,431.420674,221.638345,299.8759082,2710.505711,Benign
192.168.137.97,50540,192.0.73.2,443,25,8720,13,1339,12,7381,5243.725887,64.22572104,166.7867612,919.3824381,Benign
172.30.15.251,49519,172.217.194.189,443,30,9067,15,3534,15,5533,63.132334,1.370238,20632.91195,32303.87714,Benign
192.168.137.97,54644,52.84.108.88,443,12588,11300754,4940,360125,7648,10940629,382.9463095,345.8421974,8330.388894,253077.9432,Benign
192.168.137.97,60042,34.199.78.214,443,9,622,5,350,4,272,1767.183645,50.93016345,54.97724355,42.72517213,Benign
172.30.6.255,55848,54.194.27.245,443,6,348,4,228,2,120,103.0282,10.587205,172.2834308,90.6754899,Benign
10.0.2.15,50854,119.254.87.201,80,11,1582,6,705,5,877,22291.41477,1.501067,3757.327288,4674.008555,Malicious
172.30.15.1922,51234,54.169.69.65,443,27,8448,15,2399,12,6049,3987.707229,9.597202,1999.74951,5042.302955,Benign
10.0.2.15,53968,119.254.87.201,80,11,1582,6,705,5,877,7786.092232,0.829666,6797.91627,8456.414991,Malicious
172.30.6.255,57039,103.243.221.75,80,6,340,4,228,2,112,1594.088802,16.278841,112.0472889,55.04077348,Benign
172.30.6.255,57599,103.243.221.17,80,26,16648,11,4324,15,12324,3359.840558,16.196161,2135.814777,6087.368482,Benign
192.168.137.97,50938,172.217.160.234,80,74,39492,38,3107,36,36385,8274.169182,290.2022751,85.65060349,1003.024528,Benign
172.30.1.136,50203,23.58.57.98,443,22,3127,12,2079,10,1048,358.97587,22.69537,732.8366975,369.4145546,Benign
192.168.43.233,51173,151.101.153.176,443,9,534,5,294,4,240,1037.105888,15.659607,150.1953402,122.6084409,Benign
10.0.2.15,40405,119.254.87.201,80,11,1582,6,705,5,877,24967.40011,1.017264,5544.28349,6896.931377,Malicious
192.168.215.49,44680,172.217.161.5,443,30,6721,15,4200,15,2521,1651.727514,46.3315169,725.2082869,435.2976408,Benign
172.30.6.255,58204,103.243.221.46,80,54,37945,34,31998,20,5947,5150.829354,13.286384,19266.6417,3580.808744,Benign
10.0.2.15,34719,119.254.87.201,80,11,1551,6,705,5,846,10163.27124,0.990245,5695.56019,6834.672228,Malicious
192.168.43.224,51738,14.139.116.24,443,35,15231,18,2337,17,12894,1573.641335,61.65405054,303.2404171,1673.077423,Benign
192.168.137.97,53282,52.222.190.164,443,23,8427,13,1650,10,6777,306.6181113,10.91773517,1209.041966,4965.865094,Benign
172.30.15.2435,51769,14.139.45.128,80,158,150174,52,3203,106,146971,5418.299633,1.883811,13602.21381,624143.2925,Benign
172.30.15.880,50186,54.231.114.138,443,7,409,4,228,3,181,3436.998366,10.264138,177.7061064,141.0737073,Benign
192.168.137.97,50114,169.237.6.105,80,47,30145,24,2060,23,28085,1954.312946,1.448591186,11376.57067,155102.421,Benign
192.168.137.97,52064,172.217.161.3,443,184,127405,96,116838,88,10567,7354.048719,82.42743507,11339.71959,1025.580863,Benign
192.168.215.49,59230,223.31.160.61,443,20,5212,10,2429,10,2783,478.5931328,30.25235107,642.3302425,735.9428015,Benign
172.30.6.255,57670,103.243.221.75,80,6,340,4,228,2,112,3573.194211,11.265728,161.9069802,79.53325342,Benign
172.30.6.255,57066,103.243.221.17,80,17,5834,9,4552,8,1282,1679.879163,16.111964,2260.183799,636.5456129,Benign
192.168.215.49,56670,104.25.219.21,443,19,6540,11,1195,8,5345,80.32630766,0.255925556,37354.6126,167079.8363,Benign
192.168.137.97,50632,192.168.121.7,443,24,6110,14,3270,10,2840,2922.72538,9.553003663,2738.405733,2378.309566,Benign
10.0.2.15,52785,119.254.87.201,80,11,1569,6,705,5,864,11870.27241,9.172649,614.871451,753.5445867,Malicious
172.30.6.255,57268,103.243.220.231,80,9,514,6,348,3,166,2270.845612,18.225821,152.7503205,72.86365865,Benign
172.30.1.136,50427,52.84.103.186,443,3,198,3,198,0,0,833.405814,8.999758,176.0047326,0,Benign
172.30.6.255,58189,157.240.16.39,443,19,1933,10,1125,9,808,5059.390665,60.76312,148.1161599,106.3803175,Benign
172.30.6.255,56745,52.229.173.178,443,24,9101,13,1344,11,7757,1243.288024,0.746737,14398.6437,83102.88629,Benign
172.30.15.1245,50553,180.149.59.138,80,9,522,5,282,4,240,3469.510934,7.995644,282.1536327,240.1307512,Benign
172.30.15.2031,51343,34.196.221.221,443,19,7120,11,1285,8,5835,4090.575975,7.017175,1464.977003,6652.249659,Benign
172.30.6.255,58344,52.213.19.114,443,18,4641,10,3757,8,884,5420.598245,8.57543,3504.897131,824.6816778,Benign
172.30.15.1938,51250,52.6.46.142,443,6,348,4,228,2,120,3993.841882,3.61299,504.8450176,265.707904,Benign
10.0.2.15,44757,119.254.87.201,80,11,1513,6,705,5,808,2983.791689,1.877562,3003.895477,3442.762476,Malicious
172.30.6.255,57253,13.250.67.150,443,30,10016,15,2989,15,7027,2252.235496,85.54677,279.5196125,657.1376102,Benign
10.0.2.15,37553,119.254.87.201,80,11,1582,6,705,5,877,3133.910506,1.286187,4385.054428,5454.88331,Malicious
10.0.2.15,40592,119.254.87.201,80,11,1582,6,705,5,877,24934.37309,3.701632,1523.65227,1895.3802,Malicious
172.30.1.136,50598,157.240.16.20,443,15,834,8,444,7,390,1600.637505,52.331546,67.87492959,59.61987058,Benign
172.30.1.136,50437,157.240.16.20,443,351,223192,171,12775,180,210417,854.429835,100.325652,1018.68264,16778.71976,Benign
172.30.6.255,55666,122.15.34.33,80,6,348,4,228,2,120,38.297547,13.031323,139.9704389,73.66865206,Benign
192.168.43.233,51060,172.217.161.14,443,32,2553,15,1295,17,1258,10.372632,258.061252,40.14550778,38.99849327,Benign
10.0.2.15,43427,119.254.87.201,80,11,1579,6,705,5,874,12533.40018,1.891883,2981.156869,3695.788799,Malicious
192.168.137.97,39210,172.217.161.4,443,14,964,8,544,6,420,37.62573118,16.08366194,270.5851452,208.9076489,Benign
192.168.43.233,51124,52.216.17.48,443,7,409,4,228,3,181,920.420011,18.938259,96.31297154,76.45898179,Benign
10.0.2.15,54544,119.254.87.201,80,11,1579,6,705,5,874,11815.04912,1.479382,3812.402747,4726.297873,Malicious
172.30.6.255,56595,52.175.23.79,443,32,10536,18,2436,14,8100,914.667742,84.787374,229.8455428,764.2647359,Benign
10.0.2.15,54573,119.254.87.201,80,11,1569,6,705,5,864,4247.025799,0.959538,5877.828705,7203.466668,Malicious
172.30.6.255,57948,103.243.221.17,80,16,5537,9,4309,7,1228,4565.871129,21.180706,1627.518932,463.8183449,Benign
172.30.15.345,49613,172.30.24.126,7680,2,132,2,132,0,0,1089.061444,2.998236,352.2070978,0,Benign
192.168.43.233,51282,54.173.195.251,443,55,21536,30,11855,25,9681,2439.431319,93.009795,1019.677551,832.6864929,Benign
10.0.2.15,39934,119.254.87.201,80,11,1582,6,705,5,877,19143.55297,1.482362,3804.738654,4732.986949,Malicious
172.30.6.255,58537,172.217.166.226,80,10,1594,6,939,4,655,5801.805033,7.261023,1034.564964,721.6613967,Benign
172.30.15.1974,51286,64.74.232.52,443,16,5553,10,1219,6,4334,4076.588012,5.979869,1630.804956,5798.120327,Benign
10.0.2.15,46281,119.254.87.201,80,12,1625,7,779,5,846,23465.61734,5.121671,1216.79038,1321.443724,Malicious
192.168.137.97,60616,172.217.161.4,443,60,18024,35,11066,25,6958,9462.463477,77.01559203,1149.481523,722.7627359,Benign
192.168.43.224,40616,130.207.188.158,80,8,556,5,338,3,218,835.3487617,45.99921096,58.78361702,37.91369382,Benign
172.30.15.2414,51748,14.139.45.128,80,10,1379,5,647,5,732,5347.018652,0.393613,13149.97218,14877.5574,Benign
172.30.6.255,56102,18.195.210.3,80,7,402,4,228,3,174,305.961463,18.033826,101.1432627,77.1882794,Benign
172.30.6.255,58499,157.240.16.39,443,27,5501,15,3409,12,2092,5730.090377,61.048527,446.7265852,274.1425686,Benign
192.168.137.97,35218,104.198.143.177,80,11,985,6,499,5,486,7223.810803,5.005294417,797.5554817,776.7774832,Benign
192.168.43.233,50882,104.237.191.1,443,30,7383,15,2184,15,5199,66.376885,49.353469,354.0176679,842.7371134,Benign
172.30.6.255,55971,35.201.85.114,443,55,9816,25,3038,30,6778,166.387776,240.551219,101.0346158,225.415611,Benign
192.168.137.97,42558,104.16.103.29,443,70,15576,35,4275,35,11301,8288.312308,412.2225556,82.96489248,219.318421,Benign
172.30.6.255,56140,161.69.38.37,80,7,398,4,228,3,170,367.501561,0.597507,3052.683902,2276.123962,Benign
192.168.137.97,47026,52.84.110.71,443,54,16378,32,7825,22,8553,177.599217,112.0960114,558.4498432,610.4053046,Benign
172.30.15.863,50169,180.149.59.136,80,187,159953,75,7189,112,152764,3434.518974,12.45369,4618.069022,98132.52137,Benign
192.168.43.233,50851,172.217.166.195,443,2,108,1,54,1,54,3.007611,0.123897,3486.767234,3486.767234,Benign
172.30.6.255,56543,23.198.119.247,443,22,10157,11,1628,11,8529,832.254806,41.332861,315.100375,1650.793058,Benign
192.168.215.49,53018,104.198.143.177,80,10,911,5,425,5,486,1558.79976,0.78267993,4344.049042,4967.547846,Benign
10.0.2.15,56927,119.254.87.201,80,11,1569,6,705,5,864,22021.12529,2.083244,2707.31609,3317.902272,Malicious
172.30.6.255,57280,157.240.16.39,443,19,1933,10,1125,9,808,2314.094352,60.174031,149.5661808,107.4217547,Benign
172.30.15.1505,50813,64.74.232.52,443,14,3057,7,2167,7,890,3521.223434,5.3721,3227.043428,1325.366244,Benign
10.0.2.15,57109,119.254.87.201,80,11,1579,6,705,5,874,9112.165643,1.883644,2994.196356,3711.954064,Malicious
172.30.6.255,57992,103.243.221.75,80,27,20224,18,18122,9,2102,4697.090328,25.01523,5795.509376,672.2304772,Benign
172.30.6.255,58175,210.176.156.41,80,14,4353,7,3916,7,437,5023.847407,1.179922,26550.9076,2962.907718,Benign
192.168.215.49,59160,223.31.160.61,443,574,484362,228,27058,346,457304,279.5026653,13.3665803,16194.41886,273699.9232,Benign
172.30.6.255,56623,172.30.16.59,139,8,512,5,333,3,179,987.197841,0.272713,9768.511219,5250.941466,Benign
192.168.43.233,51403,172.217.161.14,443,19,5813,9,1285,10,4528,3626.702876,19.848706,517.9178935,1825.00562,Benign
10.0.2.15,33145,119.254.87.201,80,11,1579,6,705,5,874,13552.02442,3.127225,1803.515897,2235.848076,Malicious
172.30.1.136,50562,184.29.24.13,443,3,198,3,198,0,0,1474.243862,9.000829,175.9837899,0,Benign
172.30.15.1125,50433,180.149.59.145,80,6,348,4,228,2,120,3458.29567,8.736671,208.7751731,109.88167,Benign
192.168.137.97,35498,161.202.24.167,443,7,518,7,518,0,0,247.5661961,63.89130986,64.86015092,0,Benign
192.168.43.224,53710,18.136.71.251,443,28,8904,15,2134,13,6770,1202.853965,47.20942317,361.6227197,1147.228591,Benign
192.168.43.224,34170,54.191.37.172,443,7,478,4,272,3,206,156.5790954,20.49978393,106.1474603,80.39109123,Benign
10.0.2.15,55571,119.254.87.201,80,11,1582,6,705,5,877,17972.23937,2.19401,2570.635503,3197.79764,Malicious
172.30.15.1087,50393,108.59.8.1,80,6,348,4,228,2,120,3452.992316,4.328221,421.4202556,221.8001345,Benign
172.30.1.136,50825,52.230.84.217,443,34,12951,19,6727,15,6224,1973.553763,1.391329,38679.56465,35787.36589,Benign
172.30.15.2216,51531,13.107.21.200,443,142,68024,72,14826,70,53198,4438.967824,8.623025,13754.80182,49354.3739,Benign
10.0.2.15,43708,119.254.87.201,80,11,1579,6,705,5,874,763.152253,1.022865,5513.924125,6835.701681,Malicious
192.168.42.240,51002,172.217.163.67,443,41,6550,21,4722,20,1828,352.399247,41.256666,915.6338518,354.4639308,Benign
10.0.2.15,57404,119.254.87.201,80,11,1579,6,705,5,874,7816.114419,2.078042,2714.093363,3364.705814,Malicious
172.30.6.255,58295,35.171.73.174,443,6,348,4,228,2,120,5323.381826,0.805858,2263.426063,1191.276875,Benign
192.168.43.224,35902,172.217.166.206,443,1,74,1,74,0,0,15.33365432,0,0,0,Benign
10.0.2.15,41079,115.182.31.2,80,9,773,5,517,4,256,54.764442,62.451775,66.22710083,32.79330331,Malicious
10.0.2.15,57208,119.254.87.201,80,11,1579,6,705,5,874,21215.66543,1.448593,3893.433145,4826.75258,Malicious
172.30.15.720,50007,104.31.90.207,80,17,5718,10,4416,7,1302,2409.382308,6.845792,5160.542418,1521.51862,Benign
10.0.2.15,59671,119.254.87.201,80,11,1582,6,705,5,877,2775.270154,1.74623,3229.815087,4017.798343,Malicious
172.30.15.864,50170,180.149.59.136,80,107,80273,48,6092,59,74181,3434.51947,12.453244,3913.518437,47654.08917,Benign
172.30.6.255,56219,162.210.199.69,80,7,402,4,228,3,174,470.03193,6.022211,302.8787932,231.1443422,Benign
172.30.15.396,49668,62.210.213.13,80,6,348,4,228,2,120,1474.667595,5.949035,306.6043484,161.3707097,Benign
192.168.215.49,52408,5.39.67.10,443,30,11468,16,3104,14,8364,516.0946068,8.075232471,3075.08175,8286.077242,Benign
172.30.6.255,57237,103.243.221.87,80,7,406,5,294,2,112,2204.904976,21.127139,111.3260059,42.40990699,Benign
172.30.1.136,51859,13.107.4.52,80,10,1519,5,436,5,1083,4079.610565,0.290803,11994.3742,29793.36527,Benign
172.30.15.1824,51136,52.6.46.142,443,17,6976,9,1165,8,5811,3860.854424,0.738235,12624.70622,62971.81792,Benign
172.30.6.255,56114,103.243.221.87,80,7,414,5,294,2,120,323.859741,16.592522,141.7506031,57.85738901,Benign
10.0.2.15,50728,119.254.87.201,80,13,1727,8,853,5,874,6799.786126,10.403187,655.9528345,672.1017319,Malicious
172.30.15.969,50275,119.42.60.92,80,10,1652,6,837,4,815,3442.418287,4.750782,1409.45217,1372.405638,Benign
172.30.1.136,50786,34.225.100.237,443,1,66,1,66,0,0,1928.35605,0,0,0,Benign
10.0.2.15,49891,119.254.87.201,80,11,1579,6,705,5,874,18362.73412,1.240159,4547.803951,5637.986742,Malicious
172.30.6.255,55847,210.176.156.33,80,38,11127,20,9267,18,1860,103.112209,308.607192,240.2277132,48.21663391,Benign
172.30.6.255,57863,103.243.221.51,80,40,24332,23,20185,17,4147,4237.832604,39.194275,4119.989463,846.4501512,Benign
172.30.15.776,50068,34.200.202.18,443,72,58665,27,4421,45,54244,2657.850894,8.59346,4115.687977,50497.9368,Benign
192.168.215.49,56232,104.197.3.80,80,10,911,5,425,5,486,1258.793655,0.776608428,4378.01069,5006.383989,Benign
10.0.2.15,45746,119.254.87.201,80,11,1579,6,705,5,874,15929.67612,1.437135,3924.474736,4865.235347,Malicious
10.0.2.15,58869,119.254.87.201,80,11,1593,6,705,5,888,11990.36662,1.223105,4611.2149,5808.168555,Malicious
172.30.6.255,56574,103.243.221.109,80,10,577,6,337,4,240,888.119214,64.45568,41.8271904,29.78791008,Benign
10.0.2.15,57957,119.254.87.201,80,12,1659,7,779,5,880,10944.26606,3.841563,1622.256358,1832.587413,Malicious
192.168.43.224,36030,52.206.154.207,443,7,478,4,272,3,206,50.34588082,15.98303163,136.1443843,103.1093498,Benign
172.30.6.255,55840,173.241.248.220,80,81,46565,38,17038,43,29527,101.906916,309.852502,439.8996268,762.3498228,Benign
172.30.6.255,58264,172.217.167.2,80,22,5321,12,3001,10,2320,5269.837998,54.122641,443.5851532,342.9248769,Benign
192.168.43.224,42032,23.251.156.28,443,16,1816,9,1178,7,638,1401.416962,17.31216012,544.3572573,294.8216725,Benign
192.168.43.224,60268,172.217.194.189,443,16,5444,9,1377,7,4067,75.26821968,35.03359905,314.4410023,928.7084651,Benign
172.30.6.255,56483,52.109.120.4,443,17,8977,8,2132,9,6845,805.631647,7.271174,2345.700983,7531.108456,Benign
10.0.2.15,41157,119.254.87.201,80,11,1579,6,705,5,874,18357.25244,1.480698,3809.014397,4722.097281,Malicious
172.30.15.1397,50705,104.36.113.23,443,7,398,4,228,3,170,3498.877975,8.39391,217.3003999,162.022228,Benign
10.0.2.15,50304,119.254.87.201,80,11,1513,6,705,5,808,1634.245054,1.646047,3426.390619,3926.983859,Malicious
172.30.6.255,57285,103.243.220.231,80,37,22477,17,8730,20,13747,2336.875309,33.176454,2105.107436,3314.88109,Benign
10.0.2.15,38169,119.254.87.201,80,11,1582,6,705,5,877,21360.35646,1.58496,3558.449425,4426.610135,Malicious
172.30.1.136,51492,50.19.112.59,443,6,326,3,164,3,162,4.055356,91.878943,14.27965927,14.10551708,Benign
172.30.6.255,57250,192.168.1.44,7680,3,198,3,198,0,0,2239.047991,9.002414,175.9528055,0,Benign
10.0.2.15,52554,119.254.87.201,80,11,1579,6,705,5,874,13041.42706,1.223686,4609.025518,5713.884117,Malicious
172.30.1.136,50526,54.229.103.82,443,39,5743,21,3820,18,1923,1040.909813,87.511498,349.2112545,175.7940425,Benign
172.30.15.295,49558,209.197.3.15,443,18,6661,8,1087,10,5574,613.917972,6.36579,1366.051975,7004.943613,Benign
172.30.6.255,56505,52.109.120.4,443,18,9059,9,2214,9,6845,824.608475,48.974403,361.6583136,1118.135121,Benign
172.30.6.255,55976,52.89.235.78,80,6,348,4,228,2,120,175.002335,11.134191,163.8197153,86.2209028,Benign
10.0.2.15,43649,119.254.87.201,80,11,1579,6,705,5,874,2052.621222,1.978071,2851.26267,3534.756841,Malicious
172.30.6.255,57013,157.240.16.39,443,19,1933,10,1125,9,808,1521.092949,61.02036,147.4917552,105.9318562,Benign
172.30.6.255,56401,176.34.247.152,80,6,348,4,228,2,120,651.41425,25.639575,71.14002475,37.44211829,Benign
172.30.6.255,56029,199.166.0.200,443,27,13459,14,2041,13,11418,239.319932,0.621214,26284.01807,147041.1163,Benign
10.0.2.15,35792,119.254.87.201,80,11,1579,6,705,5,874,16740.65973,2.088275,2700.793717,3348.218027,Malicious
172.30.1.136,50402,157.240.16.20,443,26,5801,10,1145,16,4656,778.07688,119.016721,76.96397551,312.9644279,Benign
172.30.6.255,58473,216.58.196.162,80,7,402,4,228,3,174,5680.8347,8.252023,221.0367082,168.6859089,Benign
192.168.42.240,51000,172.217.163.67,443,28,5028,11,4014,17,1014,342.382384,51.273528,626.2880916,158.2102952,Benign
10.0.2.15,49854,119.254.87.201,80,11,1582,6,705,5,877,17126.09605,1.658833,3399.980589,4229.479399,Malicious
10.0.2.15,41925,119.254.87.201,80,11,1513,6,705,5,808,12355.57053,1.442515,3909.838026,4481.062589,Malicious
192.168.43.224,48506,151.139.105.121,443,33,11351,18,2783,15,8568,94.46215258,18.67125788,1192.421,3671.097065,Benign
192.168.43.224,50142,104.198.143.177,80,10,911,5,425,5,486,1414.561391,1.503525881,2261.351163,2585.921566,Benign
192.168.43.233,50972,182.50.136.239,80,14,3265,7,610,7,2655,491.979389,2.843262,1716.338487,7470.292924,Benign
10.0.2.15,35240,119.254.87.201,80,11,1582,6,705,5,877,999.085318,0.777233,7256.511239,9026.894123,Malicious
10.0.2.15,51419,119.254.87.201,80,11,1579,6,705,5,874,21630.61107,2.221532,2538.788548,3147.377575,Malicious
172.30.6.255,56703,172.217.166.195,443,71,13679,33,5561,38,8118,1158.386464,83.100857,535.349473,781.5081859,Benign
192.168.43.224,51810,54.173.101.22,443,20,5474,11,1515,9,3959,34.0490612,11.06879378,1094.970259,2861.377727,Benign
192.168.215.49,59862,54.148.63.115,443,31,4242,17,2796,14,1446,514.2278752,311.6478978,71.77330622,37.11881287,Benign
172.30.1.136,50192,172.217.161.3,443,30,8104,16,2498,14,5606,353.357507,22.090936,904.6244125,2030.153906,Benign
10.0.2.15,33845,119.254.87.201,80,11,1579,6,705,5,874,5416.228768,1.812408,3111.882093,3857.850992,Malicious
192.168.43.224,45418,192.0.73.2,443,46,13596,22,2305,24,11291,805.2721121,182.068396,101.2806198,496.1212488,Benign
172.30.6.255,58211,103.231.98.53,80,19,6478,10,5744,9,734,5155.886353,8.155493,5634.484635,720.0055227,Benign
172.30.1.136,50201,172.217.161.14,443,14,864,8,492,6,372,358.100301,18.043098,218.1443564,164.9384158,Benign
172.30.6.255,57493,103.243.221.51,80,40,24324,23,20179,17,4145,3057.842745,15.186775,10629.77492,2183.478718,Benign
172.30.6.255,57516,172.217.166.206,443,17,1779,10,1150,7,629,3075.421418,64.749199,142.0866998,77.7152471,Benign
192.168.137.97,53530,104.17.161.9,443,36,13938,19,2356,17,11582,26.37229294,11.00272237,1713.030591,8421.188586,Benign
192.168.137.97,60764,172.217.161.3,80,16,1132,12,840,4,292,3776.204862,71.60505192,93.84812691,32.6233965,Benign
10.0.2.15,45761,119.254.87.201,80,11,1579,6,705,5,874,19919.00895,2.161165,2609.703563,3235.292076,Malicious
172.30.6.255,55708,52.84.110.25,443,8,480,5,294,3,186,53.40552,5.175226,454.4729061,287.5236753,Benign
10.0.2.15,58535,119.254.87.201,80,11,1579,6,705,5,874,7395.629759,1.62101,3479.312281,4313.360189,Malicious
172.30.6.255,57175,103.243.221.46,80,33,18644,16,9316,17,9328,2007.851714,26.429681,2819.85999,2823.49227,Benign
172.30.6.255,55961,8.41.222.241,443,32,13039,15,2352,17,10687,165.858187,87.767323,214.385028,974.121086,Benign
10.0.2.15,40878,119.254.87.201,80,12,1587,7,779,5,808,3404.198831,4.711174,1322.81253,1372.057156,Malicious
192.168.137.97,50124,169.237.6.105,80,15,3541,8,1422,7,2119,1955.419984,1.86464883,6100.880668,9091.256073,Benign
172.30.1.136,50530,157.240.16.16,443,40,8539,19,3089,21,5450,1086.731111,65.895687,375.0169567,661.6518013,Benign
192.168.43.233,51197,52.175.18.194,443,33,17023,17,6561,16,10462,684.002555,73.523798,713.8913036,1138.35251,Benign
192.168.137.97,42334,35.194.103.20,443,6,412,4,272,2,140,374.8051269,16.13156457,134.8908217,69.42909938,Benign
192.168.43.233,51152,103.243.221.51,443,7,402,4,228,3,174,926.955361,13.077951,139.4713897,106.4386921,Benign
172.30.6.255,55741,103.231.98.48,80,15,4913,8,3727,7,1186,58.19651,0.46368,64302.96756,20462.38785,Benign
172.30.1.136,50239,104.17.162.9,443,15,5749,8,1025,7,4724,433.62242,17.508249,468.3506615,2158.52539,Benign
172.30.6.255,57359,103.243.221.17,80,28,14350,15,9557,13,4793,2527.858485,7.001793,10919.48877,5476.311568,Benign
10.0.2.15,47032,119.254.87.201,80,11,1579,6,705,5,874,15206.13355,1.216097,4637.78794,5749.541361,Malicious
192.168.43.233,51507,13.107.21.200,443,31,11080,17,1921,14,9159,3897.621957,128.672553,119.4349505,569.4454512,Benign
192.168.43.224,58024,52.23.187.58,443,27,7681,16,1805,11,5876,83.64597981,23.11399278,624.7297964,2033.746417,Benign
172.30.6.255,57872,172.217.163.133,443,31,8380,17,5538,14,2842,4271.403352,78.808731,562.1712143,288.4959536,Benign
172.30.15.235,49504,23.198.126.238,443,17,6644,8,1325,9,5319,52.605377,0.642332,16502.36949,66246.11572,Benign
172.30.6.255,58528,172.217.166.206,443,26,5628,14,3270,12,2358,5784.415654,0.473508,55247.21863,39838.82004,Benign
172.30.15.2424,51758,14.139.45.128,443,3,198,3,198,0,0,5364.716237,9.000174,175.9965974,0,Benign
10.0.2.15,36769,119.254.87.201,80,11,1582,6,705,5,877,7880.880446,0.844551,6678.104697,8307.372793,Malicious
172.30.15.1434,50742,103.231.98.43,443,50,17590,18,9164,32,8426,3501.165904,5.904198,12416.92775,11416.96129,Benign
192.168.43.224,50110,104.198.143.177,80,10,911,5,425,5,486,814.562038,1.899005086,1790.411213,2047.387882,Benign
172.30.15.2373,51707,14.139.45.128,80,10,1406,5,668,5,738,5334.5473,0.187435,28511.21722,31498.91963,Benign
192.168.43.233,51224,13.32.226.189,443,9,534,5,294,4,240,1292.963259,27.119901,86.72598031,70.79671862,Benign
192.168.43.224,58286,162.213.83.13,443,10,664,6,404,4,260,253.0676772,105.2019366,30.7218679,19.77149914,Benign
192.168.137.97,50696,205.185.208.52,80,13,878,7,478,6,400,8274.429563,19.23175441,198.8378136,166.3914759,Benign
192.168.43.233,51330,172.217.161.8,443,9,534,5,294,4,240,3366.159524,12.929612,181.9080109,148.4963354,Benign
172.30.15.540,49824,64.106.240.4,443,6,344,4,228,2,116,2249.264078,7.006619,260.3252724,132.4461912,Benign
172.30.15.1885,51197,52.26.114.97,443,70,56872,28,2919,42,53953,3967.715062,5.821631,4011.24702,74141.42188,Benign
192.168.137.97,59524,52.84.110.171,443,2659,1105942,1286,375143,1373,730799,355.9294648,786.3878791,3816.366045,7434.488953,Benign
172.30.1.136,50504,157.240.16.20,443,23,1266,12,660,11,606,965.667442,54.038405,97.70828728,89.71397287,Benign
172.30.1.136,50604,172.217.161.5,443,32,7016,14,2852,18,4164,1610.365353,53.092224,429.7427812,627.436515,Benign
172.30.15.1881,51193,52.84.108.203,443,20,7844,11,1285,9,6559,3967.451001,0.407928,25200.52558,128630.5426,Benign
192.168.137.97,55728,5.101.152.77,80,2990,2468414,1222,81177,1768,2387237,3917.100938,96.39856926,6736.780483,198113.8947,Benign
192.168.137.97,39708,192.168.125.6,80,64,41303,33,2828,31,38475,8277.026755,15.86345122,1426.171372,19403.09178,Benign
172.30.15.1554,50863,151.101.2.2,443,35,13902,17,4252,18,9650,3554.608403,2.404969,14144.04926,32100.20587,Benign
192.168.137.97,46026,172.82.254.215,443,5,342,3,214,2,128,84.34128071,13.53040227,126.529867,75.68141579,Benign
10.0.2.15,56324,119.254.87.201,80,12,1634,7,779,5,855,13554.47203,12.832879,485.6275821,533.0058828,Malicious
172.30.6.255,57504,54.194.27.245,443,467,176961,275,147766,192,29195,3059.195037,1714.833523,689.35438,136.19981,Benign
10.0.2.15,41154,119.254.87.201,80,11,1579,6,705,5,874,15238.9257,1.15971,4863.284787,6029.09348,Malicious
172.30.6.255,57986,13.78.168.230,443,24,6439,14,1487,10,4952,4694.32558,1.523376,7808.971652,26005.39854,Benign
192.168.43.233,51686,54.255.158.169,443,26,2894,13,1852,13,1042,894.913419,125.821124,117.7544718,66.25278598,Benign
172.30.6.255,57771,103.243.221.51,80,17,6946,10,5264,7,1682,3975.898923,3.583287,11752.33801,3755.211346,Benign
192.168.137.97,45566,192.168.121.7,8080,69,50844,28,3480,41,47364,2904.441817,91.09710942,305.6079406,4159.429453,Benign
192.168.137.97,49134,52.84.109.5,443,14,1509,9,1159,5,350,3745.9511,50.15568803,184.8643766,55.82617067,Benign
192.168.43.233,51187,151.101.153.170,443,19,7662,9,1108,10,6554,1082.055097,20.70648,428.0785532,2532.154186,Benign
10.0.2.15,44405,119.254.87.201,80,11,1579,6,705,5,874,23946.12388,2.118038,2662.841743,3301.168345,Malicious
192.168.43.233,51431,104.131.222.33,80,116,90248,49,7387,67,82861,3790.804783,35.71551,1654.631279,18560.22776,Benign
172.30.1.136,50772,157.240.16.16,443,4,264,1,66,3,198,1921.843799,3.393781,155.5786894,466.7360681,Benign
192.168.137.97,40104,172.217.161.14,443,41,5917,22,3219,19,2698,7794.572775,241.5555178,106.6090323,89.35419979,Benign
192.168.137.97,47780,54.85.227.48,443,11,730,6,404,5,326,6793.441468,154.4995518,20.91915453,16.88030787,Benign
10.0.2.15,37297,119.254.87.201,80,11,1561,6,705,5,856,2290.615997,0.958305,5885.391394,7145.950402,Malicious
172.30.6.255,57382,103.243.221.17,80,32,16038,15,8540,17,7498,2648.871473,16.190737,4219.696732,3704.834437,Benign
192.168.137.97,50868,103.211.218.251,443,218,158456,105,14999,113,143457,592.7925303,28.52369379,4206.748288,40235.18162,Benign
10.0.2.15,41499,119.254.87.201,80,11,1579,6,705,5,874,2895.417506,1.886629,2989.458977,3706.081058,Malicious
172.30.15.214,49490,162.125.34.129,443,5,330,1,66,4,264,10.904616,7.337954,71.95466202,287.8186481,Benign
10.0.2.15,33612,119.254.87.201,80,11,1582,6,705,5,877,14605.57245,1.494415,3774.052054,4694.81369,Malicious
10.0.2.15,36704,119.254.87.201,80,11,1579,6,705,5,874,11179.53801,1.326927,4250.422216,5269.317754,Malicious
192.168.137.97,43838,157.240.16.36,443,106,27211,58,12308,48,14903,155.3796422,93.19516219,1056.535529,1279.293873,Benign
172.30.6.255,57187,103.243.221.75,80,21,10601,10,4552,11,6049,2043.864905,29.165184,1248.612044,1659.238632,Benign
172.30.15.2222,51537,104.121.244.70,443,697,592094,292,50301,405,541793,4443.553296,24.482115,16436.8152,177041.2401,Benign
192.168.43.233,51015,172.82.241.224,443,23,4959,11,3460,12,1499,697.819796,35.939081,770.1922039,333.6757554,Benign
172.30.6.255,58414,52.213.19.114,443,17,3809,9,2925,8,884,5552.039598,7.164182,3266.24868,987.1329344,Benign
10.0.2.15,35497,119.254.87.201,80,11,1579,6,705,5,874,6829.820062,0.817738,6897.074613,8550.415903,Malicious
172.30.6.255,55663,172.217.166.200,80,10,1332,6,802,4,530,37.983567,20.633592,310.9492521,205.4901541,Benign
172.30.6.255,56840,103.243.221.46,80,6,348,4,228,2,120,1332.861577,20.197757,90.30705736,47.53003019,Benign
192.168.215.49,60892,35.153.14.242,443,32,8033,17,3228,15,4805,142.3728051,101.2663411,255.0106947,379.593057,Benign
172.30.6.255,57659,103.243.221.75,80,40,24302,23,20155,17,4147,3556.834541,15.21782,10595.47294,2180.075727,Benign
172.30.6.255,58178,103.243.221.51,80,25,14098,11,5347,14,8751,5023.861216,17.669055,2420.955733,3962.181339,Benign
192.168.43.233,51073,172.217.166.206,443,20,6711,10,1351,10,5360,909.146479,13.979317,773.1422072,3067.388772,Benign
192.168.43.224,39020,103.37.200.184,443,70,40936,36,4204,34,36732,2460.536927,18.35882046,1831.925972,16006.25709,Benign
172.30.6.255,56453,103.243.221.75,443,22,8201,12,4544,10,3657,707.092922,40.366422,900.5504625,724.7607925,Benign
10.0.2.15,44792,119.254.87.201,80,11,1582,6,705,5,877,4843.516902,1.291158,4368.171827,5433.881833,Malicious
172.30.6.255,55727,54.169.20.177,80,6,348,4,228,2,120,57.825865,0.833389,2188.653798,1151.923052,Benign
192.168.43.224,59122,172.82.254.215,443,51,12656,26,6334,25,6322,49.88063504,467.9885985,108.2761421,108.0710089,Benign
172.30.1.136,51507,131.253.61.82,443,1,54,0,0,1,54,50.754249,0,0,0,Benign
172.30.15.1783,51095,13.107.21.200,443,30,10576,14,2526,16,8050,3642.254349,4.912795,4113.340776,13108.62757,Benign
192.168.215.49,47322,173.241.248.143,443,6,362,4,236,2,126,612.8564169,17.95159885,105.1716906,56.15098734,Benign
172.30.1.136,50596,157.240.16.20,443,335,206218,150,20506,185,185712,1600.386276,91.39654,1794.903833,16255.49501,Benign
10.0.2.15,59995,119.254.87.201,80,11,1582,6,705,5,877,4963.490556,1.95425,2886.017654,3590.124089,Malicious
172.30.1.136,51506,13.107.21.200,443,1,54,0,0,1,54,106.24218,0,0,0,Benign
172.30.15.2003,51315,157.240.16.39,443,16,4988,9,1091,7,3897,4079.553446,2.696666,3236.589181,11560.94229,Benign
192.168.43.224,36152,136.146.210.117,443,18,1974,9,1221,9,753,110.1722851,30.62623145,318.9422771,196.6941316,Benign
172.30.15.1007,50313,52.85.51.95,80,12,2666,7,884,5,1782,3443.612361,3.628298,1949.123253,3929.114973,Benign
10.0.2.15,38036,119.254.87.201,80,11,1587,6,705,5,882,1689.859272,1.820123,3098.691682,3876.661083,Malicious
172.30.6.255,57398,103.243.221.17,80,15,5419,9,4245,6,1174,2709.839125,3.503953,9691.910822,2680.40125,Benign
192.168.43.233,51182,52.230.7.59,443,56,15860,27,7480,29,8380,634.44425,1124.714644,53.20460645,59.60623022,Benign
172.30.6.255,55828,54.169.20.177,80,15,3450,8,1648,7,1802,91.295697,60.632687,217.4404707,237.7595438,Benign
192.168.137.97,51160,119.81.16.4,443,7,466,4,272,3,194,3532.588577,27.33098307,79.61660195,56.78537051,Benign
172.30.15.2009,51321,52.26.114.97,443,6,348,4,228,2,120,4081.819156,0.824491,2212.273997,1164.354735,Benign
192.168.43.233,51053,49.44.170.52,443,6965,5931180,2797,187358,4168,5743822,889.510646,333.858251,4489.522112,137634.9869,Benign
172.30.6.255,55756,103.231.98.48,443,12,6047,5,799,7,5248,58.414575,0.188321,33942.04576,222938.4933,Benign
10.0.2.15,51751,119.254.87.201,80,11,1582,6,705,5,877,14663.30569,1.458402,3867.246479,4810.744911,Malicious
10.0.2.15,42148,119.254.87.201,80,11,1579,6,705,5,874,11782.64978,1.34397,4196.522244,5202.49708,Malicious
172.30.6.255,58174,103.231.98.53,80,19,6478,10,5744,9,734,5023.847089,43.357222,1059.8465,135.4330312,Benign
192.168.137.97,45496,23.57.214.252,443,104,19763,55,13575,49,6188,403.8970299,1542.937976,70.38520126,32.08424496,Benign
192.168.43.224,42678,107.21.25.13,443,21,5877,12,1992,9,3885,39.0572742,48.37822791,329.4043765,642.4377523,Benign
192.168.43.224,33552,18.211.245.141,443,8,544,4,272,4,272,1153.619905,67.68778464,32.14760258,32.14760258,Benign
192.168.215.49,50250,217.12.15.83,443,23,8825,13,2344,10,6481,612.4822966,18.12716262,1034.469674,2860.238036,Benign
10.0.2.15,56258,119.254.87.201,80,11,1579,6,705,5,874,16885.79756,1.554791,3627.497201,4497.067452,Malicious
192.168.43.233,51247,172.217.160.229,443,12,709,7,415,5,294,1950.029696,61.148803,54.2937856,38.46354932,Benign
10.0.2.15,46608,119.254.87.201,80,11,1582,6,705,5,877,21270.24658,4.440693,1270.072036,1579.933582,Malicious
172.30.15.2214,51529,13.107.21.200,443,26,10443,14,1470,12,8973,4438.95327,8.535813,1377.724653,8409.743747,Benign
192.168.43.233,51121,52.216.17.48,443,38,8462,18,2234,20,6228,920.277169,17.202374,1038.926371,2896.344423,Benign
10.0.2.15,48387,119.254.87.201,80,11,1582,6,705,5,877,6649.636454,1.945129,2899.550621,3606.958716,Malicious
192.168.137.97,50706,104.197.3.80,80,11,977,6,491,5,486,42.31528836,1.235854873,3178.366721,3146.000461,Benign
172.30.6.255,55608,172.217.194.189,443,5,283,3,163,2,120,15.170379,43.481068,29.99006372,22.07857452,Benign
172.30.6.255,56731,157.240.16.39,443,20,2063,11,1255,9,808,1216.39988,25.06468,400.5636617,257.8927798,Benign
192.168.43.233,51336,52.84.110.243,443,9,534,5,294,4,240,3077.088853,60.167581,39.09081869,31.9108724,Benign
192.168.137.97,57364,104.244.46.135,443,54,10936,28,2964,26,7972,680.2034636,600.3274678,39.49844255,106.2353522,Benign
172.30.6.255,57685,103.243.220.231,80,34,22038,16,8395,18,13643,3641.854056,37.167088,1806.975031,2936.576575,Benign
172.30.6.255,55628,157.240.16.37,443,16,5369,9,1103,7,4266,14.479696,0.449343,19637.55973,75950.8883,Benign
192.168.215.49,50834,172.217.161.3,443,53,12632,26,6114,27,6518,93.47565153,240.4703389,203.4013851,216.8417121,Benign
172.30.15.846,50149,157.240.16.52,443,398,354151,143,9729,255,344422,3316.145715,10.740664,7246.479361,256536.8398,Benign
172.30.15.972,50278,147.75.111.32,80,17,7539,10,6366,7,1173,3442.484429,4.152581,12264.1798,2259.799387,Benign
192.168.43.224,35274,52.84.108.195,443,12,840,7,478,5,362,1900.921725,13.87275004,275.6483025,208.7545722,Benign
172.30.15.657,49944,172.217.160.226,80,130,110719,53,4007,77,106712,2396.538756,9.670583,3314.794982,88277.6147,Benign
192.168.43.224,54524,54.85.227.48,443,9,647,5,306,4,341,16.0673931,12.20163817,200.6287981,223.5765365,Benign
172.30.15.839,50142,34.232.42.95,443,20,5230,11,2996,9,2234,3230.464685,6.653599,3602.260972,2686.06509,Benign
172.30.6.255,56013,18.210.163.206,443,6,348,4,228,2,120,228.151607,10.719408,170.1586506,89.5571845,Benign
172.30.15.2238,51555,52.220.171.90,443,6,348,4,228,2,120,4462.655324,5.016546,363.5967855,191.3667292,Benign
172.30.15.1894,51206,52.218.208.200,443,33,7695,16,1965,17,5730,3977.620528,7.958359,1975.281588,5759.981423,Benign
172.30.6.255,58415,52.213.19.114,443,12,1416,6,904,6,512,5552.312706,6.879944,1051.171347,595.3536831,Benign
172.30.1.136,50439,157.240.16.17,443,24,5758,6,917,18,4841,855.372517,122.944624,59.66914015,315.0036068,Benign
172.30.1.136,51850,74.125.200.188,5228,20,6058,10,1378,10,4680,3834.80017,19.912409,553.6246267,1880.234581,Benign
192.168.137.97,37176,140.98.193.112,443,4,264,2,132,2,132,3.088527445,1.747386417,604.3311255,604.3311255,Benign
10.0.2.15,59870,119.254.87.201,80,13,1661,8,853,5,808,4395.221637,9.833303,693.9682424,657.35796,Malicious
172.30.6.255,57342,13.228.208.99,443,20,7631,9,1141,11,6490,2476.03141,35.476734,257.2953869,1463.494357,Benign
172.30.6.255,56413,103.243.221.75,80,43,29214,21,10683,22,18531,676.865519,21.186337,4033.92054,6997.339842,Benign
172.30.15.1512,50820,184.29.24.49,443,45,35346,16,2098,29,33248,3524.113182,2.923609,5740.849751,90977.96593,Benign
172.30.6.255,57933,157.240.16.39,443,18,1879,10,1125,8,754,4510.083375,61.058806,147.3988862,98.79000909,Benign
10.0.2.15,37692,119.254.87.201,80,11,1582,6,705,5,877,17816.61031,1.751409,3220.26437,4005.917521,Malicious
172.30.15.313,49576,14.139.45.149,80,29,18832,11,1027,18,17805,729.352497,0.141105,58226.14365,1009461.04,Benign
172.30.6.255,56488,103.243.221.109,80,25,12258,14,10047,11,2211,817.860414,12.97706,6193.698727,1363.020592,Benign
192.168.43.233,50951,104.237.191.1,443,12,696,5,294,7,402,465.557823,17.450935,134.7778787,184.2881198,Benign
172.30.6.255,56864,103.243.220.231,80,73,48868,39,25367,34,23501,1375.860939,28.923001,7016.422673,6500.293659,Benign
192.168.137.97,41180,23.57.218.60,443,34,8592,20,6328,14,2264,81.57255412,103.1531783,490.765295,175.5835379,Benign
172.30.15.1328,50636,34.233.218.142,443,6,340,4,228,2,112,3488.682205,8.678854,210.1659966,103.2394369,Benign
172.30.15.273,49536,23.198.119.161,80,14,5564,7,603,7,4961,206.380496,60.449955,79.80154824,656.5430859,Benign
172.30.15.1991,51303,151.101.66.2,443,22,9336,12,1294,10,8042,4077.455764,4.792564,2160.012887,13424.12955,Benign
172.30.6.255,57200,103.243.221.109,80,48,33899,29,29634,19,4265,2087.838226,12.187847,19451.50772,2799.510037,Benign
172.30.15.979,50285,199.166.0.201,80,7,402,4,228,3,174,3442.629255,4.541068,401.6676253,306.5358193,Benign
10.0.2.15,42936,119.254.87.201,80,11,1579,6,705,5,874,4032.504105,1.4913,3781.935224,4688.526789,Malicious
192.168.43.224,60176,151.101.153.2,443,19,5827,11,1352,8,4475,912.8382703,13.49644459,801.396244,2652.550438,Benign
172.30.6.255,57193,103.243.221.109,80,51,35315,31,30998,20,4317,2072.840145,15.186192,16329.57097,2274.171168,Benign
192.168.43.224,45862,54.237.193.74,443,34,9416,19,2724,15,6692,2423.620915,26.47844568,823.0090339,2021.870945,Benign
172.30.1.136,50613,157.240.16.17,443,10,660,3,198,7,462,1618.364909,34.883495,45.40829409,105.9526862,Benign
10.0.2.15,45658,119.254.87.201,80,11,1579,6,705,5,874,3045.634616,1.716077,3286.565813,4074.409249,Malicious
192.168.137.97,38612,157.240.16.16,443,82,29806,46,17994,36,11812,53.08788966,131.6377858,1093.546197,717.8485981,Benign
172.30.15.934,50240,13.228.208.99,80,10,1352,6,832,4,520,3440.981513,6.079883,1094.757909,684.2236931,Benign
172.30.15.2104,51416,52.30.52.254,443,22,7990,11,1828,11,6162,4146.269085,11.364068,1286.86312,4337.88323,Benign
192.168.43.233,50705,151.101.152.188,443,3497,2547868,1650,108599,1847,2439269,1843.189411,26.301676,33031.81136,741935.685,Benign
192.168.137.97,59420,119.81.119.5,443,6,412,4,272,2,140,3079.100634,1.754578756,1240.183715,638.3298533,Benign
10.0.2.15,39089,119.254.87.201,80,12,1656,7,779,5,877,1539.645423,4.91458,1268.063599,1427.588929,Malicious
172.30.15.2452,51786,14.139.45.128,80,138,113209,58,3860,80,109349,5420.580547,2.559184,12066.34615,341824.5816,Benign
172.30.6.255,57036,103.243.221.51,80,21,10343,10,4270,11,6073,1593.842125,16.525421,2067.11829,2939.955357,Benign
10.0.2.15,45332,119.254.87.201,80,11,1579,6,705,5,874,13284.15718,1.687163,3342.88981,4144.235026,Malicious
172.30.6.255,56527,23.198.119.247,443,13,3675,7,1177,6,2498,831.966108,41.619664,226.2392123,480.1576486,Benign
192.168.137.97,43102,52.84.110.229,443,12,1532,7,1038,5,494,1041.921443,12.13202475,684.4694244,325.7494178,Benign
172.30.6.255,58388,172.217.166.197,443,54,23050,28,4869,26,18181,5512.837971,6.218506,6263.883962,23389.54083,Benign
172.30.15.1013,50319,52.0.128.155,443,21,8454,11,1821,10,6633,3444.357195,2.905114,5014.605279,18265.72038,Benign
10.0.2.15,33160,119.254.87.201,80,11,1579,6,705,5,874,17518.62662,1.164272,4844.22884,6005.469512,Malicious
10.0.2.15,52926,119.254.87.201,80,11,1582,6,705,5,877,3942.389842,1.754497,3214.596548,3998.866912,Malicious
172.30.15.1575,50884,52.84.109.95,443,46,27881,23,4069,23,23812,3560.719028,1.245382,26138.16484,152961.9025,Benign
192.168.43.233,51508,13.107.21.200,443,42,13421,22,2436,20,10985,3898.252703,126.762755,153.7360087,693.2635694,Benign
192.168.43.233,51273,151.101.152.188,443,18428,13306768,8827,595021,9601,12711747,1989.920233,1052.729344,4521.739635,96600.30527,Benign
10.0.2.15,37627,119.254.87.201,80,11,1513,6,705,5,808,25059.93637,0.891157,6328.851145,7253.491809,Malicious
172.30.15.1184,50492,52.86.241.228,80,11,2027,6,1404,5,623,3464.493241,3.149139,3566.689181,1582.654815,Benign
10.0.2.15,36535,119.254.87.201,80,11,1579,6,705,5,874,1599.737155,0.893289,6313.746167,7827.254114,Malicious
192.168.137.97,50650,192.168.121.7,443,430,400496,149,12330,281,388166,2953.552774,9.288940558,10619.07969,334303.7864,Benign
172.30.6.255,56294,139.162.49.205,80,10,1165,5,748,5,417,569.654552,0.469395,12748.32497,7107.020739,Benign
172.30.6.255,55604,172.217.166.206,443,3,162,2,108,1,54,60.128736,0.041894,20623.4783,10311.73915,Benign
172.30.1.136,50135,104.17.162.9,443,160,76846,75,6092,85,70754,113.048923,269.089082,181.1147433,2103.51158,Benign
172.30.6.255,55612,157.240.16.39,443,5,347,2,108,3,239,57.099484,0.032248,26792.35922,59290.49864,Benign
172.30.6.255,55994,103.231.98.48,443,28,12129,12,5224,16,6905,183.921387,43.47641,961.2569207,1270.574088,Benign
10.0.2.15,41862,119.254.87.201,80,11,1513,6,705,5,808,19561.04573,1.785224,3159.267408,3620.834136,Malicious
192.168.137.97,53238,104.244.43.3,443,23,6235,14,1547,9,4688,217.5545031,5.541878163,2233.177929,6767.380822,Benign
172.30.15.1671,50982,52.175.23.79,443,26,9971,13,2121,13,7850,3593.625455,125.688833,135.00006,499.6466154,Benign
10.0.2.15,41725,119.254.87.201,80,11,1582,6,705,5,877,19050.37458,1.413596,3989.824533,4963.228532,Malicious
172.30.6.255,56524,23.198.119.247,443,13,3881,7,1179,6,2702,831.968358,41.617109,226.6375591,519.4017682,Benign
192.168.137.97,33198,172.217.161.5,443,62,8063,31,4300,31,3763,3559.769498,249.6015915,137.8196341,120.6082054,Benign
10.0.2.15,42141,119.254.87.201,80,11,1579,6,705,5,874,2444.899346,1.122379,5025.040561,6229.624752,Malicious
172.30.15.1823,51135,157.240.16.52,443,29,9917,15,1798,14,8119,3844.45383,2.654553,5418.614735,24468.14963,Benign
10.0.2.15,53874,119.254.87.201,80,11,1579,6,705,5,874,13251.68963,1.672972,3371.245903,4179.388537,Malicious
10.0.2.15,35281,119.254.87.201,80,11,1579,6,705,5,874,3073.875475,0.823834,6846.039372,8487.146682,Malicious
10.0.2.15,47381,119.254.87.201,80,11,1513,6,705,5,808,2651.04521,1.430305,3943.214909,4519.31581,Malicious
172.30.6.255,56302,34.226.179.16,443,6,348,4,228,2,120,569.402157,19.68841,92.64333687,48.75965098,Benign
192.168.43.224,45416,52.76.199.39,443,23,7614,13,2684,10,4930,2301.921422,104.3039813,205.8598313,378.1255471,Benign
10.0.2.15,49957,119.254.87.201,80,13,1730,8,853,5,877,18387.25308,14.355247,475.3662546,488.7411551,Malicious
172.30.6.255,57585,103.243.221.17,80,24,13685,11,5329,13,8356,3319.868256,40.199848,1060.501522,1662.89186,Benign
192.168.137.97,57146,18.211.245.141,443,25,3193,14,1923,11,1270,6976.159617,61.22844304,251.2557765,165.9359523,Benign
10.0.2.15,59945,119.254.87.201,80,12,1653,7,779,5,874,3255.864636,3.896938,1599.204298,1794.229213,Malicious
192.168.137.97,58360,13.228.153.206,443,18,5261,10,1311,8,3950,1766.984593,50.74162285,206.6942169,622.7628962,Benign
172.30.6.255,56792,103.243.221.51,80,18,9776,10,4574,8,5202,1253.885746,1.541295,23741.07488,27000.67151,Benign
172.30.6.255,58074,176.34.147.227,443,6,348,4,228,2,120,4828.525327,10.642333,171.3909911,90.20578477,Benign
10.0.2.15,37834,119.254.87.201,80,11,1569,6,705,5,864,16770.6995,1.090237,5173.187114,6339.90591,Malicious
192.168.137.97,39648,192.168.125.7,8380,189,115292,96,7921,93,107371,8299.729607,828.6474436,76.47160501,1036.590418,Benign
192.168.42.240,51028,54.182.215.114,443,29,1676,14,806,15,870,502.102311,104.579367,61.6565216,66.5523248,Benign
192.168.43.233,51149,74.125.158.121,443,11,642,6,348,5,294,476.082454,25.408549,109.5694209,92.56726939,Benign
172.30.6.255,56467,103.243.221.75,80,25,11030,15,8796,10,2234,762.865936,55.187904,1275.062014,323.8390789,Benign
172.30.6.255,57884,103.243.221.87,80,39,24285,23,20192,16,4093,4303.846626,41.184171,3922.283637,795.0627439,Benign
172.30.6.255,57663,210.176.156.21,80,60,36423,30,27545,30,8878,3556.890893,122.653333,1796.608332,579.0629432,Benign
10.0.2.15,43225,119.254.87.201,80,11,1582,6,705,5,877,18269.59811,0.970515,5811.347583,7229.151533,Malicious
10.0.2.15,36115,119.254.87.201,80,11,1513,6,705,5,808,2801.245159,0.942887,5981.628764,6855.540484,Malicious
10.0.2.15,48233,119.254.87.201,80,11,1582,6,705,5,877,14578.24712,1.122787,5023.214554,6248.736403,Malicious
172.30.6.255,57596,103.243.221.51,80,39,24251,23,20150,16,4101,3359.833855,16.205832,9947.036351,2024.456381,Benign
192.168.137.97,60266,172.217.161.4,443,9,598,6,404,3,194,5227.832677,63.29395904,51.06332498,24.52050754,Benign
172.30.6.255,55670,172.217.161.2,80,98,94885,26,3498,72,91387,39.410526,19.167667,1459.958585,38142.14844,Benign
192.168.43.224,45968,54.173.101.22,443,35,6658,18,3806,17,2852,1002.861027,61.74658897,493.1122594,369.5102901,Benign
172.30.15.738,50026,158.85.224.180,443,1401,526852,725,59473,676,467379,2499.592954,3001.454189,158.5178284,1245.740153,Benign
10.0.2.15,36116,119.254.87.201,80,11,1513,6,705,5,808,4725.454475,0.817876,6895.910872,7903.398559,Malicious
172.30.6.255,57711,210.176.156.21,80,14,4342,7,3905,7,437,3713.847524,0.928219,33655.85061,3766.352553,Benign
172.30.15.1354,50662,119.42.60.92,443,26,8218,14,2016,12,6202,3492.474726,4.631651,3482.127647,10712.3788,Benign
192.168.43.233,50964,163.53.78.128,443,7,402,4,228,3,174,480.663299,14.234585,128.1386145,97.78999528,Benign
172.30.6.255,55739,103.15.158.128,80,13,4797,6,1931,7,2866,58.294681,10.240045,1508.58712,2239.05266,Benign
172.30.1.136,51490,50.19.112.59,443,8,465,4,218,4,247,4.368907,96.647627,18.04493348,20.44540628,Benign
10.0.2.15,54797,119.254.87.201,80,11,1582,6,705,5,877,20309.17295,4.642298,1214.915544,1511.320471,Malicious
192.168.43.224,44790,172.82.254.215,443,47,9030,26,6083,21,2947,2298.86379,510.3816323,95.34825887,46.19288491,Benign
192.168.215.28,54942,104.113.233.68,80,5,300,0,0,5,300,235.9583014,1.808014836,0,1327.422736,Benign
172.30.15.1288,50596,151.101.66.202,80,7,402,5,282,2,120,3471.020035,6.603848,341.6190076,145.3697905,Benign
172.30.15.1086,50392,145.239.8.193,80,15,4935,9,1877,6,3058,3452.962261,6.005766,2500.263913,4073.418778,Benign
10.0.2.15,34926,119.254.87.201,80,11,1579,6,705,5,874,24399.19779,1.150441,4902.467836,6077.669346,Malicious
192.168.43.233,51303,13.107.21.200,443,42,15107,23,5220,19,9887,2901.827484,61.688903,676.9450901,1282.175499,Benign
172.30.6.255,58346,52.213.19.114,443,12,1416,6,904,6,512,5420.803409,8.37347,863.6801708,489.1639906,Benign
172.30.15.1433,50741,103.231.98.244,443,8,973,5,799,3,174,3501.149082,0.286395,22318.8254,4860.420049,Benign
10.0.2.15,56744,119.254.87.201,80,11,1582,6,705,5,877,23555.87216,4.029819,1399.566581,1741.021123,Malicious
172.30.15.1240,50548,173.241.248.143,80,6,535,4,228,2,307,3468.791558,8.83261,206.5074763,278.0605053,Benign
192.168.43.233,51121,13.107.21.200,443,1,54,0,0,1,54,20.66149,0,0,0,Benign
192.168.43.233,51399,172.217.161.14,443,27,9329,13,2300,14,7029,3626.455451,20.096131,915.599127,2798.150549,Benign
192.168.43.233,50938,54.239.35.198,443,28,7800,13,1531,15,6269,452.010382,28.617003,427.9972994,1752.524539,Benign
172.30.6.255,57776,103.243.221.75,80,6,340,4,228,2,112,3978.015273,17.033887,107.0806681,52.60102994,Benign
192.168.215.49,54232,157.240.16.20,443,18,5378,10,1261,8,4117,118.5949302,23.71909013,425.311424,1388.586148,Benign
192.168.43.224,55978,172.217.166.196,80,15,1006,8,536,7,470,3069.212025,192.0949432,22.32229506,19.57365425,Benign
172.30.1.136,50668,172.217.161.4,443,24,3879,11,2331,13,1548,1798.172781,0.553753,33675.66406,22363.76146,Benign
10.0.2.15,53720,119.254.87.201,80,11,1582,6,705,5,877,20549.45108,4.713704,1196.511279,1488.426087,Malicious
172.30.15.509,49791,23.9.250.106,443,280,192338,127,77969,153,114369,2027.356593,8.573284,72755.31757,106721.2984,Benign
10.0.2.15,37742,119.254.87.201,80,11,1579,6,705,5,874,9768.069346,1.962193,2874.334992,3563.359975,Malicious
10.0.2.15,54186,119.254.87.201,80,11,1579,6,705,5,874,7938.822207,2.191133,2574.010797,3191.043173,Malicious
172.30.15.988,50294,52.85.51.95,80,10,1572,6,818,4,754,3442.741825,4.498372,1454.748518,1340.929563,Benign
172.30.1.136,51835,74.125.24.188,5228,29,3305,15,1900,14,1405,3320.536794,164.771406,92.24901558,68.21571942,Benign
10.0.2.15,56421,119.254.87.201,80,11,1582,6,705,5,877,2260.587602,1.667982,3381.331453,4206.280404,Malicious
10.0.2.15,58867,119.254.87.201,80,11,1559,6,705,5,854,4365.216791,1.988332,2836.548424,3436.045892,Malicious
192.168.43.224,33314,125.56.228.164,443,51,13383,27,5415,24,7968,1202.706497,321.3884053,134.7901769,198.3394514,Benign
172.30.1.136,50654,193.32.65.35,443,8,456,4,228,4,228,1750.116712,27.718172,65.80520534,65.80520534,Benign
172.30.6.255,57138,172.217.166.197,443,17,1779,10,1150,7,629,1867.426312,62.745767,146.6234368,80.19664498,Benign
192.168.137.97,49136,52.84.109.5,443,15,1563,9,1159,6,404,3746.201735,49.90509027,185.7926706,64.76293265,Benign
172.30.15.2485,51819,14.139.45.128,80,269,256211,90,5291,179,250920,5429.359967,4.883301,8667.907221,411066.203,Benign
10.0.2.15,53037,119.254.87.201,80,11,1579,6,705,5,874,21816.46047,1.819414,3099.899198,3842.995602,Malicious
10.0.2.15,54345,119.254.87.201,80,11,1579,6,705,5,874,8806.991283,1.852061,3045.256069,3775.253623,Malicious
192.168.43.224,40630,52.84.110.84,443,34,6908,18,4871,16,2037,1577.998247,180.5319636,215.850973,90.26656374,Benign
172.30.15.921,50227,184.29.24.49,443,76,60242,29,2863,47,57379,3440.031465,6.959688,3290.952123,65955.8302,Benign
192.168.43.233,51155,182.161.72.82,443,16,6189,7,1910,9,4279,947.192849,13.15406,1161.618542,2602.390441,Benign
172.30.6.255,56818,103.231.98.53,80,38,16344,21,13750,17,2594,1286.851563,26.48721,4152.947781,783.472476,Benign
192.168.43.224,49992,52.201.103.234,443,10,692,6,412,4,280,935.5006938,12.84518228,256.5942568,174.3844464,Benign
10.0.2.15,33963,119.254.87.201,80,12,1625,7,779,5,846,7250.224118,4.156412,1499.37013,1628.327509,Malicious
172.30.1.136,50597,157.240.16.20,443,13,1742,7,971,6,771,1600.395188,17.997244,431.6216416,342.7191408,Benign
172.30.15.293,49556,180.149.59.12,443,17,5141,10,1351,7,3790,574.812109,5.131563,2106.180904,5908.531182,Benign
172.30.15.1580,50889,184.29.25.7,443,310,283346,114,23264,196,260082,3567.691722,9.3759,19850.04106,221915.3361,Benign
172.30.6.255,55645,122.15.34.40,80,148,163902,31,4879,117,159023,36.77495,21.801847,1790.307032,58352.12035,Benign
172.30.1.136,50341,104.244.46.103,443,12,732,7,426,5,306,599.910305,16.331863,208.6718459,149.8910443,Benign
172.30.15.2162,51474,104.24.0.12,443,27,8246,14,1888,13,6358,4227.994014,9.519944,1586.563955,5342.888572,Benign
192.168.43.224,45538,172.217.166.196,443,7,466,4,272,3,194,1254.246342,25.66232333,84.79356964,60.47776658,Benign
172.30.6.255,56842,115.114.126.194,443,17,6860,10,1174,7,5686,1338.777785,15.478787,606.7658919,2938.731569,Benign
192.168.43.233,51327,137.117.84.54,443,66,36783,30,8528,36,28255,3365.98653,152.879332,446.2604533,1478.551725,Benign
172.30.6.255,56207,157.240.16.39,443,61,17173,31,4421,30,12752,469.26986,161.821049,218.5624195,630.4247848,Benign
10.0.2.15,54721,119.254.87.201,80,11,1513,6,705,5,808,10008.35728,2.045663,2757.052359,3159.855753,Malicious
172.30.15.696,49983,54.248.216.124,443,21,4111,12,2201,9,1910,2402.410653,4.586211,3839.334911,3331.726342,Benign
192.168.42.240,50979,172.217.163.67,443,72,14576,28,4775,44,9801,296.178424,51.909848,735.8911935,1510.464835,Benign
172.30.6.255,57000,103.243.221.51,80,16,5527,9,4299,7,1228,1483.851996,14.17641,2426.00207,692.9822148,Benign
10.0.2.15,54536,119.254.87.201,80,11,1582,6,705,5,877,24153.50052,5.078251,1110.618597,1381.578028,Malicious
10.0.2.15,42079,219.234.85.243,80,8,940,4,684,4,256,242.198296,62.169671,88.01719411,32.94210774,Malicious
192.168.43.224,42076,157.240.16.39,443,229,137367,114,36855,115,100512,7.748637308,74.11441955,3978.173233,10849.38673,Benign
192.168.43.224,35096,34.232.42.95,443,6,412,4,272,2,140,3244.795809,19.89455574,109.376657,56.29680876,Benign
172.30.6.255,57453,103.243.221.17,80,23,10808,11,4618,12,6190,2890.855399,31.176551,1184.99317,1588.373262,Benign
192.168.43.224,50560,49.44.150.71,443,145,54331,78,29742,67,24589,2279.988373,526.8252613,451.6412129,373.3913584,Benign
172.30.6.255,57257,52.84.110.11,443,33,7232,17,2070,16,5162,2252.357429,181.802777,91.08771754,227.1472454,Benign
172.30.6.255,56263,192.99.18.118,443,34,9255,18,2145,16,7110,530.107792,181.161628,94.72204566,313.9737737,Benign
192.168.215.49,38320,158.85.224.176,443,7,478,4,272,3,206,1231.073657,14.42655487,150.8329618,114.2337873,Benign
172.30.15.2186,51498,180.149.59.77,443,6,348,4,228,2,120,4274.39337,3.185446,572.6042758,301.3706715,Benign
172.30.6.255,58221,204.79.197.219,443,47,17083,20,6214,27,10869,5166.250423,123.986227,400.9477601,701.3037021,Benign
192.168.43.224,45972,54.173.101.22,443,11,754,6,416,5,338,1003.097786,70.94474214,46.90974834,38.11417053,Benign
192.168.43.224,40694,52.84.108.164,443,25,4725,13,2419,12,2306,3114.492041,178.7997679,108.2328027,103.1768677,Benign
192.168.137.97,40422,192.0.73.2,443,68,14840,34,4114,34,10726,8.510719808,182.4212704,180.4175573,470.3837431,Benign
192.168.43.224,34090,34.224.176.220,443,42,9308,22,3840,20,5468,2927.352196,62.33885707,492.7905554,701.7132179,Benign
192.168.215.49,53450,159.153.191.240,443,6,356,4,236,2,120,1497.827337,20.2875423,93.06203641,47.31967953,Benign
172.30.6.255,57017,103.243.221.51,80,16,5799,9,4216,7,1583,1522.840919,12.090946,2789.525319,1047.395299,Benign
172.30.1.136,50541,172.217.161.14,443,9,534,5,294,4,240,1325.439232,11.655474,201.793595,164.7294653,Benign
10.0.2.15,44061,119.254.87.201,80,11,1582,6,705,5,877,11840.25176,1.161316,4856.559283,6041.421973,Malicious
192.168.215.49,42254,111.119.15.1,443,19,5514,10,1311,9,4203,509.9605964,11.20332261,936.1508515,3001.252501,Benign
10.0.2.15,54919,119.254.87.201,80,11,1513,6,705,5,808,7125.451585,2.155091,2617.058862,2999.409306,Malicious
172.30.15.1404,50712,23.8.186.54,443,19,6876,10,1894,9,4982,3499.880836,7.131939,2124.527425,5588.382066,Benign
192.168.137.97,48520,23.57.214.252,443,67,18330,36,9902,31,8428,7.422934492,672.699352,117.7584009,100.2290247,Benign
10.0.2.15,40615,119.254.87.201,80,11,1582,6,705,5,877,14603.29778,1.29501,4355.178724,5417.718782,Malicious
192.168.215.24,49220,192.168.215.49,2987,6,356,3,194,3,162,1038.798175,1.03397012,1501.010493,1253.421134,Benign
172.30.15.1720,51031,184.29.25.7,443,80,58524,35,8732,45,49792,3619.377412,7.704169,9067.298498,51703.95405,Benign
10.0.2.15,47777,119.254.87.201,80,11,1582,6,705,5,877,21395.90422,2.147916,2625.801009,3266.421964,Malicious
172.30.1.136,50582,157.240.16.39,443,14,4632,7,720,7,3912,1593.64835,0.840456,6853.422428,37236.92852,Benign
172.30.15.1789,51101,52.37.171.77,443,15,5005,8,1087,7,3918,3643.127922,3.859627,2253.06746,8120.992003,Benign
10.0.2.15,34803,119.254.87.201,80,11,1579,6,705,5,874,19137.91996,1.690154,3336.974027,4136.901134,Malicious
172.30.15.1310,50618,23.58.57.98,443,18,3872,10,2691,8,1181,3487.116297,9.917577,2170.69149,952.6520439,Benign
172.30.15.1676,50987,161.202.1.35,443,6,348,4,228,2,120,3596.831258,10.268003,177.6392157,93.49432407,Benign
172.30.6.255,57309,103.243.221.51,80,17,5853,9,4216,8,1637,2439.853824,14.035317,2403.080743,933.0747571,Benign
172.30.15.2508,51842,14.139.45.128,80,10,1400,5,672,5,728,5475.875743,0.149037,36071.57954,39077.5445,Benign
192.168.43.224,60182,151.101.153.2,443,8,552,5,338,3,214,913.9768309,12.57662113,215.0021037,136.1255923,Benign
10.0.2.15,36343,119.254.87.201,80,11,1579,6,705,5,874,21210.18503,1.288814,4376.116336,5425.142806,Malicious
192.168.43.224,36102,107.21.25.13,443,6,412,4,272,2,140,56.02250095,16.33314344,133.2260387,68.57222579,Benign
10.0.2.15,41183,119.254.87.201,80,11,1579,6,705,5,874,16407.35125,1.02107,5523.617382,6847.71857,Malicious
10.0.2.15,43756,119.254.87.201,80,11,1561,6,705,5,856,24183.55658,1.467776,3842.548182,4665.562048,Malicious
192.168.43.224,57082,172.217.166.197,443,32,4773,17,3230,15,1543,34.7554635,293.0048461,88.18966766,42.12899604,Benign
172.30.15.2207,51522,104.24.0.12,443,27,9585,15,1939,12,7646,4432.726231,4.963033,3125.508132,12324.7216,Benign
10.0.2.15,38392,119.254.87.201,80,11,1579,6,705,5,874,16019.81602,2.153447,2619.056796,3246.887432,Malicious
10.0.2.15,54965,119.254.87.201,80,11,1579,6,705,5,874,6139.163732,1.321098,4269.176094,5292.567243,Malicious
192.168.137.97,57458,104.198.143.177,80,11,977,6,491,5,486,162.8332384,1.442790518,2722.501951,2694.777898,Benign
172.30.6.255,56123,172.64.128.2,443,20,7901,10,1169,10,6732,333.0944,0.479756,19493.2424,112257.064,Benign
10.0.2.15,36143,119.254.87.201,80,11,1579,6,705,5,874,8929.922047,1.851135,3046.779408,3777.142132,Malicious
172.30.6.255,56241,172.217.166.206,443,30,4540,17,3255,13,1285,506.499277,103.992472,250.4027407,98.8533093,Benign
192.168.137.97,43272,108.177.122.94,443,9,618,5,338,4,280,341.4657823,14.55187032,185.8180385,153.9321029,Benign
172.30.1.136,50766,13.107.4.52,80,12,1639,6,502,6,1137,1916.227463,3.361336,1194.763035,2706.066873,Benign
172.30.15.2463,51797,14.139.45.128,80,64,51425,26,1909,38,49516,5422.002728,1.900095,8037.492862,208477.9972,Benign
172.30.15.647,49934,146.88.138.85,80,67,56971,24,1652,43,55319,2395.415136,4.692341,2816.504598,94313.69118,Benign
10.0.2.15,43232,119.254.87.201,80,11,1579,6,705,5,874,22561.72066,1.483277,3802.391596,4713.886887,Malicious
192.168.43.233,51130,117.18.237.29,80,2,108,1,54,1,54,12.523597,0.000238,0,0,Benign
10.0.2.15,35802,119.254.87.201,80,11,1513,6,705,5,808,7037.807239,0.876382,6435.549794,7375.779055,Malicious
192.168.215.49,38274,158.85.224.176,443,7,478,4,272,3,206,650.037952,75.98207792,28.63833235,21.68932524,Benign
172.30.6.255,56423,85.114.159.93,80,11,1430,6,758,5,672,679.144747,0.923423,6566.871304,5821.817304,Benign
172.30.1.136,50600,157.240.16.39,443,17,942,9,498,8,444,1600.932189,52.037023,76.56087474,68.25909315,Benign
172.30.6.255,57877,173.241.248.220,80,108,53422,56,26435,52,26987,4276.885719,497.123269,425.4075663,434.2906749,Benign
172.30.15.300,49563,162.125.32.135,443,30,14367,16,8620,14,5747,664.637244,440.181515,156.662644,104.4478208,Benign
172.30.6.255,56791,103.243.221.51,80,13,5319,9,4254,4,1065,1253.885348,11.159256,3049.665677,763.4917597,Benign
172.30.6.255,57647,103.243.221.46,80,25,14205,11,5329,14,8876,3516.848187,40.213737,1060.135247,1765.764768,Benign
10.0.2.15,33304,119.254.87.201,80,11,1582,6,705,5,877,26286.01317,5.306148,1062.917959,1322.239787,Malicious
192.168.43.224,37266,104.197.3.80,80,10,911,5,425,5,486,1289.541488,1.586576801,2142.978517,2450.558963,Benign
172.30.15.441,49715,23.9.250.106,443,14,4791,8,1099,6,3692,1629.655704,0.158959,55309.85978,185808.9193,Benign
10.0.2.15,34962,119.254.87.201,80,11,1585,6,705,5,880,26141.14851,1.36194,4141.151593,5169.097023,Malicious
192.168.43.224,42244,23.251.156.28,443,41,22197,20,2481,21,19716,2442.098609,71.89295124,276.0771349,2193.928574,Benign
10.0.2.15,38378,119.254.87.201,80,11,1579,6,705,5,874,25237.66318,1.356458,4157.887675,5154.601175,Malicious
192.168.43.233,51421,23.100.69.251,443,26,9640,11,1848,15,7792,3650.711096,124.49687,118.7499734,500.703351,Benign
192.168.43.233,51286,104.244.42.8,443,76,8946,39,4939,37,4007,2474.949878,797.078703,49.57101457,40.21685673,Benign
172.30.6.255,56327,54.169.155.247,80,15,3674,8,1622,7,2052,591.169262,60.87344,213.1635735,269.6742619,Benign
10.0.2.15,59857,119.254.87.201,80,11,1579,6,705,5,874,24098.77971,3.875702,1455.220241,1804.060271,Malicious
172.30.15.1598,50907,104.244.43.80,443,8,480,5,294,3,186,3572.943698,4.278167,549.7681601,347.8125094,Benign
10.0.2.15,57175,119.254.87.201,80,11,1582,6,705,5,877,23312.53773,0.819577,6881.598678,8560.513533,Malicious
192.168.43.233,51334,137.117.84.54,443,48,27654,22,4707,26,22947,3370.826951,149.594325,251.7207788,1227.158851,Benign
172.30.15.1325,50633,169.38.89.75,443,6,348,4,228,2,120,3488.598608,8.434094,216.2650784,113.8237255,Benign
172.30.15.1427,50735,74.217.250.126,443,22,10405,11,1808,11,8597,3500.62087,6.582427,2197.365804,10448.42579,Benign
192.168.43.233,51297,216.239.32.21,80,27,3576,13,1099,14,2477,2528.12294,287.607088,30.56948304,68.89955369,Benign
10.0.2.15,33557,119.254.87.201,80,11,1582,6,705,5,877,16285.00462,2.029832,2778.555073,3456.443686,Malicious
10.0.2.15,50357,119.254.87.201,80,11,1513,6,705,5,808,5356.174559,1.843327,3059.685015,3506.702826,Malicious
10.0.2.15,50034,119.254.87.201,80,11,1582,6,705,5,877,17161.24597,2.095652,2691.28653,3347.884095,Malicious
172.30.6.255,58142,157.240.16.17,443,6,348,4,228,2,120,4935.892719,15.98581,114.1011935,60.05325973,Benign
172.30.6.255,56629,172.30.6.35,139,3,198,3,198,0,0,1011.380834,9.002294,175.955151,0,Benign
192.168.137.97,46814,52.84.110.231,443,33,7007,17,4060,16,2947,1334.610899,211.8103198,153.3447475,111.3071357,Benign
10.0.2.15,56481,119.254.87.201,80,11,1582,6,705,5,877,20459.33005,2.489667,2265.363199,2818.047554,Malicious
172.30.6.255,57500,35.190.43.164,80,137,38509,70,28241,67,10268,3057.874604,852.994008,264.8646976,96.30079371,Benign
172.30.15.790,50082,52.84.108.93,443,11,1344,6,906,5,438,2674.815809,1.502167,4825.029441,2332.630127,Benign
172.30.1.136,50479,157.240.16.16,443,181,16262,89,9200,92,7062,920.454985,686.862886,107.1538461,82.25222406,Benign
172.30.1.136,50316,157.240.16.39,443,13,726,6,336,7,390,567.153824,28.985842,92.734929,107.6387569,Benign
192.168.43.233,51443,23.74.147.187,80,108,83552,45,5939,63,77613,3802.293378,22.75113,2088.335832,27291.12796,Benign
172.30.15.2011,51323,52.84.108.203,443,26,8483,13,1828,13,6655,4085.806261,1.668231,8766.172071,31914.04548,Benign
172.30.6.255,58377,35.190.43.164,80,10,1629,6,1175,4,454,5485.105241,3.960344,2373.531188,917.0920506,Benign
192.168.42.240,51008,216.58.221.46,443,227,67508,98,39915,129,27593,382.851235,225.399032,1416.687539,979.3475954,Benign
172.30.6.255,56630,103.243.221.109,80,31,18482,18,16162,13,2320,1011.873944,13.198077,9796.578699,1406.265473,Benign
10.0.2.15,60398,119.254.87.201,80,11,1579,6,705,5,874,310.993082,1.714605,3289.387352,4077.907156,Malicious
10.0.2.15,48498,119.254.87.201,80,12,1653,7,779,5,874,15359.06062,7.045696,884.5116224,992.3788934,Malicious
172.30.15.1578,50887,52.84.110.128,443,16,3721,9,1715,7,2006,3561.989263,4.991273,2748.797752,3215.211831,Benign
10.0.2.15,55046,119.254.87.201,80,11,1582,6,705,5,877,1664.17199,1.09387,5156.005741,6413.924872,Malicious
172.30.15.526,49810,23.56.26.202,80,12,2525,7,617,5,1908,2241.963897,60.51521,81.56627069,252.2341078,Benign
192.168.137.97,51976,172.217.161.3,443,21,2419,12,1580,9,839,6555.133073,207.8829229,60.80345527,32.28740441,Benign
192.168.215.49,44164,172.217.161.5,443,16,5200,8,1287,8,3913,1528.495372,12.57134964,819.005142,2490.106543,Benign
172.30.6.255,58557,54.194.27.245,443,15,3005,8,2307,7,698,5816.261268,2.938354,6281.067564,1900.383684,Benign
10.0.2.15,35585,119.254.87.201,80,11,1579,6,705,5,874,3043.845327,1.751302,3220.46112,3992.458183,Malicious
10.0.2.15,34701,119.254.87.201,80,11,1568,6,705,5,863,12085.33284,1.504974,3747.573048,4587.454667,Malicious
192.168.137.97,34684,172.217.161.3,443,59,7858,29,4204,30,3654,397.4457916,254.4784493,132.1605035,114.8702379,Benign
172.30.1.136,50628,52.214.173.82,443,29,10015,15,2270,14,7745,1714.762317,21.801904,832.9547731,2841.95362,Benign
172.30.15.1280,50588,157.240.16.20,443,15,4923,8,1025,7,3898,3469.554959,7.393449,1109.089952,4217.787936,Benign
172.30.15.1582,50891,184.29.25.7,443,133,117414,50,10720,83,106694,3568.122602,8.945122,9587.348278,95420.94563,Benign
172.30.6.255,55937,35.201.85.114,80,24,3571,13,1947,11,1624,152.568713,259.075415,60.12149011,50.14756032,Benign
172.30.6.255,57949,157.240.16.39,443,18,1879,9,1071,9,808,4571.083538,61.069131,140.3000151,105.8472569,Benign
172.30.6.255,57160,103.243.220.231,80,24,10521,14,8286,10,2235,1941.907064,20.121255,3294.426714,888.6125642,Benign
192.168.43.233,51195,104.24.19.71,443,9,534,5,294,4,240,1139.36505,21.53275,109.2289652,89.16650219,Benign
192.168.43.233,51168,104.237.191.1,443,30,9059,16,2990,14,6069,486.687278,51.910305,460.7948268,935.30562,Benign
192.168.43.224,50360,34.205.118.138,443,35,5496,18,3096,17,2400,2925.086191,12.11722358,2044.032598,1584.521394,Benign
172.30.6.255,56717,103.243.221.46,80,23,12377,13,10220,10,2157,1172.238124,18.777453,4354.158149,918.9744743,Benign
192.168.137.97,40102,172.217.161.14,443,11,750,6,416,5,334,7794.407435,60.67133383,54.85292295,44.04056795,Benign
192.168.137.97,54704,172.217.161.3,443,14,987,7,462,7,525,39.8600215,147.4126495,25.0724752,28.4914491,Benign
172.30.1.136,50190,172.217.161.3,443,26,7335,14,1861,12,5474,353.356892,14.848041,1002.691197,2949.345304,Benign
10.0.2.15,42514,119.254.87.201,80,11,1579,6,705,5,874,10373.56042,0.848903,6643.868616,8236.512299,Malicious
172.30.15.362,49630,195.154.150.142,80,26,9754,13,1849,13,7905,1399.654975,2.301048,6428.375245,27483.12943,Benign
10.0.2.15,49201,119.254.87.201,80,11,1582,6,705,5,877,13374.27292,1.482738,3803.773829,4731.786735,Malicious
172.30.1.136,50299,119.81.119.5,443,11,618,7,390,4,228,508.383629,23.116998,134.9656214,78.90297867,Benign
172.30.6.255,57572,103.243.221.51,80,6,340,4,228,2,112,3256.656462,25.411659,71.77807635,35.25940593,Benign
172.30.6.255,56545,23.198.119.247,443,19,8821,11,1360,8,7461,832.258219,41.3296,263.2495838,1444.19496,Benign
192.168.43.224,44748,172.82.254.215,443,20,5355,10,1311,10,4044,2279.987808,16.80432713,624.1249599,1925.218412,Benign
172.30.1.136,51520,52.230.85.180,443,34,8149,22,3059,12,5090,18.922042,719.668049,34.00456646,56.58164213,Benign
10.0.2.15,48575,119.254.87.201,80,11,1582,6,705,5,877,25029.8961,1.033783,5455.690411,6786.7241,Malicious
192.168.43.224,60350,104.19.195.151,443,96,43585,49,3725,47,39860,3032.612388,400.601473,74.38814384,796.0030641,Benign
10.0.2.15,53425,119.254.87.201,80,11,1579,6,705,5,874,20615.15472,1.425402,3956.778509,4905.282861,Malicious
172.30.15.213,49489,162.125.82.3,443,23,6288,12,1656,11,4632,9.867013,1523.616768,8.695099895,24.32107652,Benign
172.30.1.136,50419,172.217.161.14,443,7,402,4,228,3,174,827.599789,3.801877,479.7630223,366.1349381,Benign
192.168.43.224,54086,151.101.194.217,443,24,10247,13,2005,11,8242,65.96240963,13.84669826,1158.398898,4761.857214,Benign
192.168.43.224,45464,54.173.101.22,443,91,20052,47,8547,44,11505,44.23043999,72.92292136,937.6475698,1262.154591,Benign
172.30.15.715,50002,151.139.104.116,443,31,12037,16,1975,15,10062,2406.274132,10.02049,1576.7692,8033.140096,Benign
172.30.15.881,50187,122.15.34.17,80,10,1641,6,1165,4,476,3437.206914,9.765675,954.3631137,389.9372035,Benign
192.168.43.224,48820,34.227.208.227,443,59,12334,32,5891,27,6443,368.581385,103.0809346,457.1941475,500.0342713,Benign
10.0.2.15,56461,219.234.85.222,80,11,1631,6,796,5,835,17.886664,3.886574,1638.46102,1718.737376,Malicious
172.30.15.1629,50939,184.29.25.7,443,1087,982430,403,106806,684,875624,3574.565289,32.472151,26313.25532,215723.0668,Benign
172.30.15.1353,50661,35.189.131.178,443,33,16283,18,3721,15,12562,3492.432449,4.689117,6348.316751,21431.75357,Benign
172.30.15.2369,51703,205.185.208.52,80,6,348,4,228,2,120,5333.132335,4.890134,372.9959138,196.3136388,Benign
172.30.15.1647,50957,184.29.25.7,443,37,19786,16,4322,21,15464,3577.213753,10.291048,3359.813306,12021.32183,Benign
10.0.2.15,55007,119.254.87.201,80,11,1582,6,705,5,877,19834.24711,1.930053,2922.199546,3635.133336,Malicious
10.0.2.15,51882,119.254.87.201,80,11,1579,6,705,5,874,6194.584773,1.813427,3110.133466,3855.68319,Malicious
172.30.6.255,57334,52.213.19.114,443,19,6444,10,1207,9,5237,2468.840131,42.761419,225.8110284,979.7616866,Benign
10.0.2.15,47888,119.254.87.201,80,11,1582,6,705,5,877,8987.220618,1.547855,3643.75216,4532.724318,Malicious
192.168.43.224,46456,216.58.221.42,443,15,4623,8,1146,7,3477,19.0175198,10.88420802,842.3212771,2555.629215,Benign
172.30.6.255,57955,103.243.221.17,80,16,5482,9,4255,7,1227,4586.854296,15.239376,2233.687259,644.1208616,Benign
172.30.6.255,58438,103.243.221.51,80,22,13478,10,5291,12,8187,5616.847948,2.379559,17788.16999,27524.42785,Benign
10.0.2.15,37466,119.254.87.201,80,11,1579,6,705,5,874,15744.47329,2.114805,2666.912552,3306.214994,Malicious
172.30.15.494,49773,23.9.250.106,443,19,3840,10,2349,9,1491,1848.4851,7.284709,2579.650059,1637.4024,Benign
192.168.43.224,45420,192.0.73.2,443,6,356,4,236,2,120,805.3593314,28.9065562,65.31390273,33.21045902,Benign
172.30.6.255,55809,35.187.221.61,80,11,1668,6,939,5,729,91.006016,11.010395,682.2643511,529.6812694,Benign
10.0.2.15,58803,119.254.87.201,80,11,1582,6,705,5,877,12323.25521,1.661223,3395.08904,4223.394451,Malicious
172.30.6.255,57062,103.243.221.17,80,16,5472,9,4245,7,1227,1679.858579,16.133089,2104.990557,608.4389666,Benign
192.168.42.240,50953,172.217.166.206,443,21,1266,11,654,10,612,208.128372,18.725002,279.4125202,261.4685969,Benign
192.168.137.97,56614,172.217.161.14,443,32,6700,17,1756,15,4944,2478.566272,191.8059753,73.24067971,206.208383,Benign
172.30.15.2166,51478,13.107.21.200,443,50,16109,24,4470,26,11639,4242.176061,5.282728,6769.229837,17625.74185,Benign
172.30.6.255,58135,216.58.196.194,80,22,5310,12,3005,10,2305,4910.822042,8.092571,2970.625775,2278.633082,Benign
172.30.15.1448,50756,103.231.98.244,443,17,6428,8,1087,9,5341,3501.921874,1.115954,7792.435889,38288.31654,Benign
172.30.6.255,57976,52.229.207.60,443,63,41873,26,7405,37,34468,4689.288327,3.46262,17108.43234,79634.49642,Benign
172.30.15.1150,50458,87.248.118.22,443,20,7306,10,1195,10,6111,3458.546585,8.398826,1138.254323,5820.813528,Benign
192.168.43.233,50984,74.207.230.33,443,40,22552,17,2035,23,20517,509.044695,70.308664,231.5504103,2334.506029,Benign
172.30.6.255,57286,103.243.220.231,80,28,22570,10,5275,18,17295,2336.875762,0.91066,46340.01713,151933.7623,Benign
172.30.6.255,56823,103.243.221.51,80,30,19796,16,8613,14,11183,1311.845817,16.715973,4122.045423,5352.00673,Benign
172.30.15.1201,50509,184.29.25.121,80,12,1786,7,894,5,892,3465.470423,1.678406,4261.185911,4251.653057,Benign
10.0.2.15,60418,119.254.87.201,80,11,1582,6,705,5,877,13612.11213,6.000109,939.9829236,1169.312091,Malicious
172.30.6.255,57122,161.69.226.29,443,27,6916,15,3646,12,3270,1855.272102,363.296241,80.28709551,72.00735116,Benign
10.0.2.15,56975,119.254.87.201,80,11,1579,6,705,5,874,17936.69587,1.234831,4567.426636,5662.313304,Malicious
192.168.43.224,41720,34.232.42.95,443,228,193073,86,13412,142,179661,28.97009231,81.69999413,1313.292628,17592.26564,Benign
192.168.43.233,51451,49.44.178.248,80,58,39940,25,3088,33,36852,3810.40594,234.275386,105.448551,1258.416452,Benign
192.168.215.49,54342,204.79.197.200,443,39,11219,19,2753,20,8466,610.4072603,135.5420003,162.4883796,499.6827541,Benign
192.168.43.233,51027,52.138.216.83,443,28,7649,15,2601,13,5048,805.733646,3.761457,5531.898942,10736.26523,Benign
172.30.1.136,50168,23.21.249.197,443,12,688,7,394,5,294,184.593444,196.873824,16.01025436,11.94673803,Benign
192.168.137.97,57340,104.197.3.80,80,11,977,6,491,5,486,4823.813589,0.82261308,4775.027404,4726.40187,Benign
172.30.15.1810,51122,180.149.59.203,443,995,1011316,298,17174,697,994142,3737.568397,6.001116,22894.40831,1325276.165,Benign
192.168.42.240,50910,146.185.181.89,80,5,271,3,163,2,108,10.241651,3.418242,381.4826452,252.7615072,Benign
172.30.15.1936,51248,34.201.201.2,443,15,4765,9,1153,6,3612,3991.670146,5.528558,1668.427825,5226.679362,Benign
172.30.6.255,56437,103.243.221.75,80,17,5445,9,4164,8,1281,697.842958,11.223374,2968.091414,913.0944046,Benign
192.168.137.97,59984,180.149.59.77,443,22,5607,12,1575,10,4032,1121.97604,79.46337015,158.5636247,405.9228792,Benign
192.168.43.224,40002,13.107.21.200,443,21,8697,11,1224,10,7473,93.04485046,13.20634671,741.4616786,4526.914317,Benign
172.30.6.255,55737,52.32.41.162,80,6,396,1,66,5,330,58.294633,15.831864,33.35046334,166.7523167,Benign
192.168.137.97,49448,157.240.16.52,443,11,737,6,404,5,333,6794.904409,105.8181409,30.54296713,25.17526746,Benign
192.168.43.224,55816,172.217.167.10,443,17,4834,9,1224,8,3610,87.43636628,23.23342947,421.4616706,1243.036463,Benign
172.30.6.255,58000,52.229.171.86,443,30,10173,17,2324,13,7849,4737.756869,93.659286,198.506745,670.4300522,Benign
172.30.6.255,56035,103.243.221.75,80,25,12653,11,4617,14,8036,252.843557,29.183354,1265.653016,2202.899639,Benign
192.168.43.224,36932,172.217.166.202,443,27,2882,14,1736,13,1146,278.4335011,286.1746236,48.52980961,32.03638353,Benign
172.30.6.255,56808,157.240.16.16,443,319,61577,142,18961,177,42616,1271.588343,1823.334361,83.1926405,186.9805162,Benign
10.0.2.15,34850,119.254.87.201,80,11,1579,6,705,5,874,11542.45224,1.440982,3913.997538,4852.246593,Malicious
172.30.15.1746,51058,104.122.123.186,443,15,2539,8,1448,7,1091,3635.779212,1.248295,9279.857726,6991.937002,Benign
10.0.2.15,34368,119.254.87.201,80,11,1579,6,705,5,874,7906.205257,2.056269,2742.831799,3400.333322,Malicious
10.0.2.15,53465,119.254.87.201,80,11,1582,6,705,5,877,21182.63673,1.03252,5462.363925,6795.025762,Malicious
172.30.6.255,58408,35.190.43.164,80,10,1629,6,1175,4,454,5550.911908,8.130072,1156.201323,446.7365111,Benign
172.30.15.1417,50725,207.244.67.99,443,7,402,4,228,3,174,3500.219322,2.071693,880.4393315,671.9142267,Benign
172.30.6.255,58062,103.243.221.46,80,23,11542,12,10126,11,1416,4826.834567,12.36844,6549.572945,915.879448,Benign
192.168.43.224,39120,103.37.200.184,443,16,1800,8,1108,8,692,2595.891823,113.8436607,77.86116455,48.62809194,Benign
10.0.2.15,56608,119.254.87.201,80,11,1582,6,705,5,877,11690.1202,2.595514,2172.979995,2703.12547,Malicious
172.30.6.255,58110,103.243.221.87,80,25,14338,11,5347,14,8991,4891.848771,7.24879,5901.122808,9922.759523,Benign
172.30.6.255,58323,172.217.167.2,80,9,1555,6,939,3,616,5372.999214,6.037753,1244.171466,816.1976815,Benign
172.30.6.255,58188,157.240.16.39,443,27,5329,15,3275,12,2054,5059.390665,60.762879,431.1843091,270.4282659,Benign
192.168.43.224,48192,151.101.153.2,443,322,155517,153,19166,169,136351,300.3936626,640.6571143,239.3292708,1702.63933,Benign
10.0.2.15,59525,119.254.87.201,80,11,1579,6,705,5,874,13464.35308,2.115479,2666.062863,3305.161621,Malicious
192.168.137.97,56580,151.101.1.176,443,66,25474,35,3871,31,21603,20.91754858,282.3793974,109.6680575,612.0276536,Benign
172.30.1.136,50584,172.217.161.3,443,12,698,7,404,5,294,1593.94289,110.007765,29.37974424,21.38030893,Benign
172.30.6.255,56812,172.30.20.1,139,4,252,3,198,1,54,1275.764382,6.542994,242.091006,66.02481983,Benign
172.30.6.255,57756,103.243.221.87,80,6,348,4,228,2,120,3860.864158,21.203277,86.02443858,45.27602031,Benign
172.30.6.255,58149,103.243.221.87,80,15,5491,9,4317,6,1174,4957.836172,1.245004,27739.66991,7543.750863,Benign
10.0.2.15,36767,119.254.87.201,80,11,1513,6,705,5,808,22143.75674,3.015732,1870.192709,2143.426538,Malicious
172.30.6.255,56308,103.243.221.46,80,23,16209,8,3726,15,12483,588.858292,17.180627,1734.977425,5812.593452,Benign
192.168.43.224,35728,151.101.153.177,443,8,552,5,338,3,214,1275.19411,10.89722532,248.1365596,157.1042123,Benign
10.0.2.15,46939,119.254.87.201,80,11,1579,6,705,5,874,8086.385588,1.506044,3744.910507,4642.626643,Malicious
10.0.2.15,38928,119.254.87.201,80,11,1582,6,705,5,877,21540.5869,2.021638,2789.81697,3470.453167,Malicious
192.168.215.49,44982,132.72.23.98,443,1300,1061134,582,39563,718,1021571,825.5723671,52.5572218,6022.083915,155498.4781,Benign
192.168.215.49,49434,172.217.161.14,443,18,6024,9,1389,9,4635,112.2973955,13.40161212,829.1539781,2766.831309,Benign
172.30.6.255,56637,103.243.221.109,80,77,61766,51,53907,26,7859,1024.841932,47.233213,9130.354947,1331.097251,Benign
10.0.2.15,36246,119.254.87.201,80,11,1579,6,705,5,874,4062.524325,0.831688,6781.389175,8406.998778,Malicious
172.30.1.136,50802,74.125.68.188,5228,3,198,3,198,0,0,1938.608698,9.001365,175.9733107,0,Benign
10.0.2.15,37920,119.254.87.201,80,11,1582,6,705,5,877,23072.30788,0.959912,5875.538591,7309.003325,Malicious
172.30.15.2446,51780,14.139.45.128,80,10,1394,5,664,5,730,5420.423135,0.212944,24945.52558,27425.05072,Benign
172.30.6.255,56150,103.243.221.87,80,23,15062,9,2921,14,12141,393.848726,12.178801,1918.743889,7975.169313,Benign
192.168.137.97,56338,52.205.114.175,443,24,6508,14,1713,10,4795,1766.932323,50.79370397,269.7972175,755.2117093,Benign
192.168.43.224,55980,172.217.166.196,80,14,940,8,536,6,404,3069.215283,192.0902705,22.32283806,16.82542271,Benign
172.30.1.136,50784,172.217.161.4,443,1,66,1,66,0,0,1928.294376,0,0,0,Benign
172.30.6.255,58424,35.190.41.40,443,56,15962,27,4910,29,11052,5572.424771,6.627234,5927.057955,13341.31253,Benign
172.30.15.510,49792,162.247.242.19,443,27,8033,13,3920,14,4113,2029.176691,7.065674,4438.359313,4656.880575,Benign
192.168.137.97,48658,54.255.158.169,443,16,5129,9,1245,7,3884,347.7463285,15.42747072,645.6016142,2014.069614,Benign
10.0.2.15,33084,119.254.87.201,80,11,1558,6,705,5,853,8151.15325,2.168052,2601.413619,3147.525982,Malicious
10.0.2.15,35579,119.254.87.201,80,11,1579,6,705,5,874,14002.62444,1.116508,5051.464029,6262.382356,Malicious
192.168.43.233,51227,104.104.182.224,443,21,7081,10,1349,11,5732,1628.720538,2.29941,4693.377866,19942.50699,Benign
172.30.15.1496,50804,169.38.89.75,443,15,2930,8,1755,7,1175,3520.98514,6.052618,2319.657378,1553.046962,Benign
172.30.1.136,50603,172.217.161.5,443,137,38814,67,21108,70,17706,1610.365196,185.705952,909.3084965,762.7542277,Benign
172.30.6.255,57131,103.243.220.231,80,37,27845,15,8093,22,19752,1861.842826,14.190394,4562.52307,11135.4202,Benign
10.0.2.15,44987,119.254.87.201,80,11,1579,6,705,5,874,24579.45954,5.101984,1105.45231,1370.447261,Malicious
192.168.43.224,58026,52.23.187.58,443,25,7411,15,1613,10,5798,83.87543372,22.88912426,563.761193,2026.464598,Benign
10.0.2.15,59243,119.254.87.201,80,11,1579,6,705,5,874,6587.338523,1.019682,5531.136178,6857.039744,Malicious
192.168.215.49,36964,52.221.126.200,443,22,3760,13,2582,9,1178,611.4593031,114.2910458,180.7315688,82.45615339,Benign
10.0.2.15,52919,119.254.87.201,80,11,1579,6,705,5,874,971.531391,0.820486,6873.974693,8521.778556,Malicious
10.0.2.15,58392,119.254.87.201,80,11,1513,6,705,5,808,13947.42361,1.478095,3815.722264,4373.196581,Malicious
172.30.15.466,49740,172.25.10.224,7680,3,198,3,198,0,0,1684.651208,9.024084,175.530281,0,Benign
172.30.15.2382,51716,14.139.45.128,80,10,1379,5,647,5,732,5334.740175,1.483834,3488.260816,3946.533103,Benign
172.30.6.255,57468,103.243.221.17,80,18,6306,9,4498,9,1808,2950.859944,41.171892,873.994326,351.3076348,Benign
172.30.6.255,55790,172.217.166.206,443,16,5628,8,1219,8,4409,80.056203,10.566094,922.9522281,3338.225081,Benign
172.30.15.342,49610,52.229.168.53,443,29,10110,16,2260,13,7850,1054.772573,75.596154,239.1656062,830.7300924,Benign
172.30.6.255,56196,54.85.156.219,80,6,348,4,228,2,120,466.86151,24.210619,75.33884202,39.65202211,Benign
172.30.6.255,57749,103.243.221.46,80,64,46209,38,39961,26,6248,3845.094867,36.972341,8646.67996,1351.929541,Benign
192.168.137.97,52224,172.217.161.3,443,223,26452,90,9627,133,16825,8399.145866,899.0127661,85.66730407,149.7197872,Benign
172.30.6.255,56782,184.29.25.174,443,40,30788,16,1435,24,29353,1246.302422,0.464105,24735.78177,505971.709,Benign
192.168.137.97,57564,169.60.79.147,443,31,7910,18,3090,13,4820,6798.085375,3.277429758,7542.495744,11765.31699,Benign
192.168.137.97,34382,172.217.161.3,443,77,24080,46,16243,31,7837,281.0667106,58.69782705,2213.778713,1068.114497,Benign
192.168.137.97,57704,104.197.3.80,80,11,977,6,491,5,486,9023.813354,1.225693827,3204.715495,3172.080918,Benign
172.30.6.255,56622,172.30.16.59,445,5,345,3,225,2,120,987.018879,0.176621,10191.3136,5435.367255,Benign
10.0.2.15,49976,119.254.87.201,80,11,1582,6,705,5,877,6827.558315,1.294353,4357.389368,5420.468759,Malicious
172.30.1.136,50499,157.240.16.39,443,140,69704,80,48659,60,21045,964.302568,90.222232,4314.590665,1866.058911,Benign
172.30.6.255,57364,103.243.221.51,80,100,71949,60,60105,40,11844,2580.845801,68.202416,7050.190128,1389.276298,Benign
172.30.15.2319,51649,52.84.108.208,443,56,34928,26,5008,30,29920,5040.854138,6.835757,5860.945613,35015.87315,Benign
172.30.15.930,50236,172.217.160.226,80,14,3861,8,1769,6,2092,3440.934681,6.072247,2330.603482,2756.146119,Benign
172.30.1.136,50507,104.113.230.86,443,22,2805,9,1595,13,1210,966.12537,33.330941,382.8274755,290.4208435,Benign
172.30.15.1664,50975,184.29.25.7,443,244,223668,86,19405,158,204263,3588.559859,8.821261,17598.39098,185246.0776,Benign
10.0.2.15,41012,119.254.87.201,80,12,1587,7,779,5,808,15173.91736,13.091754,476.0248321,493.7459106,Malicious
192.168.137.97,50340,104.237.191.1,443,107,15869,51,7141,56,8728,3585.297426,703.0687989,81.25520587,99.31318259,Benign
172.30.6.255,56297,104.20.68.222,80,14,1745,8,844,6,901,569.160645,63.128558,106.9563477,114.1797029,Benign
172.30.6.255,58146,35.190.41.40,443,361,93807,149,23084,212,70723,4950.837232,163.412867,1130.094609,3462.297739,Benign
172.30.15.967,50273,104.113.219.221,80,10,1888,6,1031,4,857,3442.416535,4.574768,1802.932957,1498.655232,Benign
172.30.6.255,55755,104.193.80.60,80,2,132,1,66,1,66,58.419291,0.292803,1803.260212,1803.260212,Benign
10.0.2.15,60350,119.254.87.201,80,11,1582,6,705,5,877,7605.879672,2.154027,2618.351581,3257.155087,Malicious
172.30.1.136,50347,172.217.161.14,443,18,2105,10,1256,8,849,615.558696,9.402543,1068.647067,722.3577707,Benign
172.30.6.255,58042,143.204.192.51,80,63,44376,28,4715,35,39661,4816.434471,56.23086,670.8060307,5642.595543,Benign
172.30.15.1205,50513,199.166.0.200,443,22,9321,11,1826,11,7495,3466.348713,1.330231,10981.55132,45074.87797,Benign
172.30.15.2430,51764,52.55.184.84,443,6,348,4,228,2,120,5402.843151,5.213967,349.8296019,184.1208431,Benign
192.168.43.224,41522,172.217.166.193,443,9,610,5,338,4,272,29.04066267,13.75664101,196.5596106,158.1781482,Benign
172.30.15.2368,51702,14.139.45.128,80,122,104430,48,3319,74,101111,5333.096742,0.662772,40062.04245,1220461.939,Benign
192.168.43.233,50875,172.217.166.197,443,82,47056,34,6241,48,40815,28.184042,242.742389,205.6830709,1345.129713,Benign
172.30.6.255,56529,23.198.119.247,443,13,3675,7,1177,6,2498,831.969744,41.61588,226.2597835,480.2013078,Benign
10.0.2.15,41656,119.254.87.201,80,11,1582,6,705,5,877,16465.23957,0.864087,6527.120533,8119.552776,Malicious
192.168.43.233,51261,49.44.170.2,443,150,87979,63,17206,87,70773,1950.263864,333.901068,412.241868,1695.663938,Benign
10.0.2.15,34679,119.254.87.201,80,11,1582,6,705,5,877,6229.141776,1.35621,4158.647997,5173.240132,Malicious
172.30.6.255,55302,172.217.194.188,443,5,283,3,163,2,120,16.168816,44.281546,29.44793301,21.67945988,Benign
172.30.15.1910,51222,204.79.197.200,443,31,11775,14,2290,17,9485,3984.937436,2.315175,7913.008736,32775.0602,Benign
172.30.6.255,58114,35.190.43.164,80,10,1629,6,1175,4,454,4891.866221,7.087029,1326.366803,512.4855564,Benign
172.30.6.255,58510,103.231.98.53,80,19,6478,10,5744,9,734,5747.880014,1.237139,37143.76477,4746.435122,Benign
192.168.42.240,51019,54.239.25.128,443,52,16239,25,4248,27,11991,488.067424,2.895713,11735.96969,33127.59241,Benign
10.0.2.15,48971,119.254.87.201,80,11,1513,6,705,5,808,21666.2904,2.025988,2783.826953,3190.542096,Malicious
172.30.15.940,50246,52.0.136.218,80,10,1565,6,929,4,636,3441.02031,6.243207,1190.413837,814.96577,Benign
172.30.15.1061,50367,157.240.16.20,443,6,348,4,228,2,120,3450.06777,7.080616,257.6047056,135.581424,Benign
10.0.2.15,59451,119.254.87.201,80,11,1579,6,705,5,874,8596.779114,1.969391,2863.829478,3550.336119,Malicious
10.0.2.15,35737,119.254.87.201,80,11,1582,6,705,5,877,8781.76293,2.019831,2792.312822,3473.557936,Malicious
172.30.6.255,56958,52.221.102.82,443,23,7437,13,2742,10,4695,1390.449886,63.804388,343.8008057,588.674246,Benign
192.168.43.224,58830,174.129.238.218,443,300,243459,128,16852,172,226607,3244.976905,93.52270336,1441.532325,19384.12744,Benign
10.0.2.15,33749,119.254.87.201,80,13,1727,8,853,5,874,17999.29849,10.426618,654.4787581,670.5913653,Malicious
172.30.1.136,50225,172.217.161.14,443,3,198,3,198,0,0,385.334579,9.00249,175.9513201,0,Benign
172.30.15.1602,50912,172.217.166.198,443,6,348,4,228,2,120,3573.04142,4.078388,447.2355254,235.3871186,Benign
172.30.6.255,57638,103.243.221.75,80,71,48123,42,40102,29,8021,3496.839664,20.231125,15857.54623,3171.746504,Benign
172.30.6.255,56157,103.243.221.17,80,31,21376,13,3418,18,17958,406.952649,4.840153,5649.40819,29681.70634,Benign
192.168.137.97,39792,172.217.167.10,443,21,5268,12,1603,9,3665,152.1681049,22.74224236,563.8845895,1289.23083,Benign
172.30.6.255,57592,157.240.16.39,443,5,330,1,66,4,264,3351.100432,15.057906,35.06463648,140.2585459,Benign
192.168.43.224,34428,52.4.148.116,443,89,18051,43,4948,46,13103,2888.38024,458.460876,86.34106436,228.6432834,Benign
172.30.15.2445,51779,14.139.45.128,80,12,2294,7,1548,5,746,5420.417922,2.070328,5981.660877,2882.635022,Benign
172.30.15.997,50303,34.241.15.178,80,6,348,4,228,2,120,3443.096481,4.165513,437.8812406,230.4638108,Benign
172.30.15.2529,51863,188.125.66.33,443,29,8115,15,1997,14,6118,5492.594423,5.435915,2938.971636,9003.819964,Benign
192.168.137.97,51150,119.81.16.4,443,27,8425,15,2825,12,5600,3532.580412,52.54128826,430.1379115,852.6627626,Benign
172.30.15.898,50204,103.243.220.231,80,13,4618,8,3550,5,1068,3438.496365,8.765493,3239.977489,974.7312558,Benign
10.0.2.15,47935,119.254.87.201,80,11,1554,6,705,5,849,3462.073976,1.755205,3213.299871,3869.633462,Malicious
192.168.43.233,51034,163.53.79.200,443,16,6873,9,1173,7,5700,819.938648,18.211024,515.2922757,2503.97781,Benign
172.30.6.255,56822,103.243.220.231,80,28,16749,17,14529,11,2220,1289.123611,22.941734,5066.39995,774.1350327,Benign
172.30.6.255,57639,103.243.221.46,80,26,11295,14,8233,12,3062,3496.84767,20.223117,3256.866882,1211.287063,Benign
192.168.43.233,51325,172.217.166.197,443,43,7630,21,4913,22,2717,3074.919011,197.322854,199.1862534,110.1544984,Benign
192.168.137.97,49070,117.18.237.29,80,10,660,5,342,5,318,11.13600707,131.1021613,20.86922117,19.40471443,Benign
172.30.6.255,56669,103.243.221.17,80,26,11347,14,8532,12,2815,1132.853221,17.391491,3924.677878,1294.886103,Benign
192.168.43.233,51092,182.22.24.124,443,5,294,3,174,2,120,916.767483,10.900134,127.7048521,88.07231177,Benign
192.168.137.97,56016,13.107.21.200,443,43,13475,22,3498,21,9977,1754.595008,135.9764424,205.8003541,586.9840288,Benign
192.168.43.233,51252,151.101.153.176,443,12,1425,6,904,6,521,1931.293425,14.188811,509.6973947,293.7525914,Benign
10.0.2.2,53473,10.0.2.15,5555,9,706,5,362,4,344,0,36789.0159,0.078719148,0.074804937,Malicious
192.168.43.233,51263,49.44.170.2,443,122,65169,53,15649,69,49520,1950.280804,333.884127,374.9564291,1186.519418,Benign
172.30.6.255,57606,103.243.221.87,80,66,49219,25,13354,41,35865,3375.88673,26.176736,4081.181091,10960.87763,Benign
172.30.6.255,57643,103.243.221.46,80,16,5442,9,4214,7,1228,3500.864458,16.206331,2080.174717,606.1828553,Benign
172.30.6.255,55918,70.42.146.149,80,6,535,4,228,2,307,122.051777,30.018912,60.76169583,81.81509043,Benign
192.168.43.233,50971,49.44.170.2,443,618,512369,256,16855,362,495514,490.014722,328.704112,410.2169552,12059.81871,Benign
192.168.137.97,33162,172.217.161.5,443,1625,1103017,730,117022,895,985995,3496.126306,313.2399701,2988.686277,25181.8438,Benign
10.0.2.15,45596,119.254.87.201,80,12,1656,7,779,5,877,17819.00629,4.528517,1376.16796,1549.293069,Malicious
10.0.2.15,52703,119.254.87.201,80,11,1582,6,705,5,877,8236.612428,2.023788,2786.853168,3466.766282,Malicious
172.30.6.255,56798,180.149.59.210,80,139,90846,88,67992,51,22854,1254.161207,728.688674,746.4586996,250.9055054,Benign
192.168.43.233,51251,52.229.207.60,443,37,15301,22,3617,15,11684,2196.854399,1.560107,18547.44578,59913.83924,Benign
172.30.6.255,55795,172.217.166.206,443,16,5627,8,1219,8,4408,80.059884,10.564389,923.1011846,3338.00658,Benign
172.30.15.2321,51651,52.4.148.116,443,83,13179,37,4268,46,8911,5041.8157,454.015977,75.20440189,157.0165008,Benign
192.168.43.233,51424,52.114.158.91,443,20,8365,11,3671,9,4694,3669.416997,5.764279,5094.826257,6514.604862,Benign
192.168.43.233,51374,13.107.42.254,443,37,9517,20,1953,17,7564,3211.164615,1.185291,13181.57313,51052.44197,Benign
172.30.1.136,50147,172.217.167.34,443,18,5466,9,1790,9,3676,120.470621,11.583835,1236.205454,2538.710194,Benign
192.168.137.97,46668,49.44.90.17,443,16,5025,9,1183,7,3842,133.1807074,10.93119492,865.7790907,2811.769456,Benign
192.168.43.224,58590,174.129.238.218,443,10,664,6,404,4,260,1804.13443,152.3851138,21.20942078,13.64962724,Benign
172.30.6.255,55891,52.69.18.116,443,6,348,4,228,2,120,113.43032,11.054869,164.9951709,86.83956363,Benign
10.0.2.15,45564,119.254.87.201,80,11,1582,6,705,5,877,12563.43285,2.246913,2510.110538,3122.506301,Malicious
172.30.15.236,49505,23.198.126.238,443,17,6653,8,1326,9,5327,52.605754,0.653671,16228.34729,65194.87632,Benign
192.168.215.49,33792,103.229.205.254,443,49,12769,28,6058,21,6711,516.5927123,463.3655278,104.5912937,115.8653305,Benign
192.168.137.97,41838,172.217.161.5,443,881,598176,374,50707,507,547469,0.551786765,298.848472,1357.396935,14655.42712,Benign
192.168.43.233,50732,172.217.166.206,443,29,8099,13,2568,16,5531,1857.299723,0.654086,31408.71384,67648.59667,Benign
172.30.6.255,57467,103.243.221.17,80,21,10671,10,4552,11,6119,2950.857008,41.174481,884.4313059,1188.891731,Benign
10.0.2.15,56532,119.254.87.201,80,11,1579,6,705,5,874,11572.47084,1.652117,3413.801807,4232.145786,Malicious
172.30.15.2282,51601,104.19.199.151,443,65,28318,33,3167,32,25151,4560.930195,8.028462,3155.77255,25061.83625,Benign
172.30.6.255,57078,103.243.221.75,80,24,12604,13,10394,11,2210,1681.085775,14.906266,5578.325249,1186.078391,Benign
192.168.137.97,40328,172.217.161.14,443,20,2430,11,1772,9,658,10885.3714,43.5276689,325.6779046,120.9345718,Benign
172.30.15.905,50211,173.241.248.220,80,6,535,4,228,2,307,3438.745835,8.424387,216.5142698,291.5345651,Benign
10.0.2.15,44548,119.254.87.201,80,11,1582,6,705,5,877,17218.30395,4.318159,1306.112165,1624.76648,Malicious
10.0.2.15,32945,119.254.87.201,80,11,1579,6,705,5,874,5533.954588,2.091386,2696.776205,3343.237451,Malicious
172.30.15.615,49902,192.0.77.32,443,40,13713,22,2259,18,11454,2390.908583,5.266537,3431.476889,17398.90938,Benign
10.0.2.15,54768,119.254.87.201,80,12,1653,7,779,5,874,2110.380502,6.161645,1011.418217,1134.761902,Malicious
172.30.6.255,56078,157.240.16.39,443,28,5421,15,3273,13,2148,301.10273,60.690445,431.4352943,283.1417697,Benign
172.30.6.255,58190,172.217.161.2,80,6,348,4,228,2,120,5068.233876,13.64532,133.6722041,70.35379163,Benign
172.30.15.379,49647,62.210.213.13,80,28,15200,13,1926,15,13274,1452.543072,8.008187,1924.030995,13260.42961,Benign
192.168.43.224,46278,52.20.114.147,443,7,474,5,346,2,128,41.11379985,17.23492847,160.6040898,59.41422975,Benign
172.30.6.255,55649,122.15.34.40,80,130,140819,29,1993,101,138826,36.775036,21.803275,731.2662891,50937.66877,Benign
10.0.2.15,45125,119.254.87.201,80,11,1582,6,705,5,877,5746.520754,1.689121,3339.014789,4153.639674,Malicious
192.168.43.224,51646,54.197.248.134,443,23,7471,13,1485,10,5986,1274.82499,12.05129947,985.7858095,3973.679364,Benign
172.30.6.255,56567,35.190.43.164,80,69,20383,36,15175,33,5208,887.901767,262.192993,463.0177131,158.9058484,Benign
172.30.6.255,55826,35.187.221.61,80,6,348,4,228,2,120,91.00623,11.014968,165.5928551,87.15413427,Benign
192.168.43.233,51445,23.74.147.187,80,25,8188,13,2785,12,5403,3802.424822,240.609297,92.59825068,179.6439312,Benign
10.0.2.15,57926,119.254.87.201,80,11,1582,6,705,5,877,6889.886095,2.153105,2619.472808,3258.549862,Malicious
172.30.15.2326,51657,52.55.184.84,443,6,348,4,228,2,120,5075.105063,2.775839,657.0986286,345.8413835,Benign
172.30.15.563,49847,151.101.0.84,443,22,8651,11,2139,11,6512,2253.894657,2.311592,7402.69044,22536.84906,Benign
192.168.137.97,50876,103.211.218.251,443,91,56375,47,6980,44,49395,593.7387099,9.159731875,6096.248314,43141.00078,Benign
172.30.6.255,56411,103.243.221.75,80,16,5142,9,3914,7,1228,676.858656,21.1932,1477.455033,463.5449106,Benign
172.30.1.136,51530,172.217.161.3,443,74,17510,34,8855,40,8655,300.321232,253.290059,279.6793537,273.3624852,Benign
172.30.15.1214,50522,172.217.166.198,443,12,672,6,336,6,336,3466.846216,10.667697,251.9756607,251.9756607,Benign
172.30.15.831,50132,34.232.42.95,443,17,4484,10,2599,7,1885,3199.139926,7.943576,2617.460952,1898.38934,Benign
10.0.2.15,39053,119.254.87.201,80,11,1582,6,705,5,877,14518.19019,0.944661,5970.395729,7427.002914,Malicious
172.30.6.255,57531,103.243.220.231,80,17,5527,9,4245,8,1282,3133.846314,14.188761,2393.443656,722.8256223,Benign
172.30.6.255,58466,157.240.16.39,443,19,1933,10,1125,9,808,5669.088269,61.067036,147.3790213,105.8508882,Benign
172.30.6.255,56232,18.214.153.193,80,6,348,4,228,2,120,476.416732,14.643494,124.5604362,65.55812431,Benign
172.30.6.255,55616,157.240.16.20,443,15,4921,8,1025,7,3896,2.597465,11.790041,695.5022463,2643.587075,Benign
10.0.2.15,55896,119.254.87.201,80,11,1579,6,705,5,874,18687.56657,1.657198,3403.335027,4219.169948,Malicious
192.168.215.49,51800,195.8.215.136,443,70,47062,34,10753,36,36309,508.8155523,21.35105056,4029.028912,13604.57647,Benign
192.168.43.224,43974,205.185.208.52,80,27,10657,14,1181,13,9476,804.2731737,30.0741246,314.1571077,2520.705125,Benign
192.168.215.49,57302,50.19.229.252,443,28,9121,15,2040,13,7081,281.2536293,152.3456622,107.1248093,371.8386149,Benign
192.168.43.233,50886,54.239.25.120,443,53,15944,24,5193,29,10751,115.704391,12.037109,3451.327059,7145.237282,Benign
192.168.43.224,45502,54.173.101.22,443,6,412,4,272,2,140,52.79271555,14.18881501,153.3602347,78.93541493,Benign
192.168.43.224,54246,23.60.211.179,443,17,1146,9,602,8,544,690.1336469,211.7238744,22.74660811,20.55507444,Benign
192.168.43.224,41716,34.226.175.200,443,9,598,5,338,4,260,304.1132737,44.34132591,60.98148724,46.90883634,Benign
172.30.15.1352,50660,52.221.149.123,443,6,348,4,228,2,120,3492.419691,4.672669,390.3550626,205.4500329,Benign
172.30.15.497,49776,23.9.250.106,443,27,6451,14,2999,13,3452,1858.730308,7.050065,3403.089191,3917.127005,Benign
192.168.137.97,39672,172.217.161.14,443,38,7990,20,1970,18,6020,3621.045738,291.2382971,54.11376236,165.3628677,Benign
10.0.2.15,42906,119.254.87.201,80,11,1582,6,705,5,877,18717.59964,1.676871,3363.407203,4183.983145,Malicious
172.30.6.255,56515,23.198.119.247,443,18,9577,9,1168,9,8409,831.967943,41.616777,224.5248353,1616.463476,Benign
172.30.6.255,57174,103.243.221.46,80,53,38169,21,9587,32,28582,2007.84976,26.431801,2901.656228,8650.791522,Benign
172.30.1.136,51824,52.230.84.217,443,53,12435,28,5469,25,6966,3070.207033,1689.549504,25.89566029,32.98394032,Benign
192.168.43.224,50958,23.251.156.28,443,17,7264,10,1311,7,5953,2651.716147,11.02600247,951.206027,4319.244454,Benign
172.30.6.255,56136,157.240.16.39,443,19,1933,10,1125,9,808,362.08887,61.029262,147.4702414,105.9164045,Benign
172.30.15.954,50260,52.77.33.157,80,6,348,4,228,2,120,3441.954804,5.106379,357.2002783,188.0001465,Benign
10.0.2.15,60500,119.254.87.201,80,11,1582,6,705,5,877,22146.81278,0.823688,6847.252843,8517.788289,Malicious
172.30.15.948,50254,35.203.66.107,443,7,402,4,228,3,174,3441.230854,6.033459,302.3141452,230.7134266,Benign
172.30.6.255,58116,54.194.27.245,443,25,8971,13,3428,12,5543,4893.328381,7.249999,3782.621211,6116.414637,Benign
10.0.2.15,41036,119.254.87.201,80,11,1582,6,705,5,877,26321.37689,0.817707,6897.336087,8580.090424,Malicious
172.30.15.2351,51685,139.59.82.147,443,18,6891,10,1174,8,5717,5321.478199,6.292215,1492.638125,7268.664532,Benign
10.0.2.15,39285,119.254.87.201,80,11,1579,6,705,5,874,9978.353591,1.959714,2877.970969,3567.867556,Malicious
172.30.1.136,50216,52.84.103.186,443,9,534,5,294,4,240,370.570885,12.046277,195.247046,159.3853437,Benign
172.30.15.1285,50593,50.23.131.235,443,6,348,4,228,2,120,3469.809842,7.921212,230.2677924,121.1935749,Benign
172.30.1.136,50368,157.240.16.20,443,298,130015,125,13873,173,116142,655.401034,117.906723,941.2864439,7880.263113,Benign
192.168.43.233,51401,172.217.161.14,443,19,5813,10,1339,9,4474,3626.701938,19.717171,543.2828066,1815.270558,Benign
192.168.43.233,50897,104.214.119.36,443,19,6036,11,1711,8,4325,179.422505,148.594084,92.11672249,232.8491086,Benign
172.30.6.255,57905,103.243.221.75,80,17,5506,9,4225,8,1281,4417.840767,16.242746,2080.928927,630.9278,Benign
192.168.43.224,34180,54.191.37.172,443,24,5071,14,3680,10,1391,197.6875897,102.6037037,286.9292134,108.4561239,Benign
10.0.2.15,49515,119.254.87.201,80,11,1559,6,705,5,854,14783.47275,1.542179,3657.163014,4430.095339,Malicious
172.30.15.571,49855,144.2.194.65,443,6,360,3,198,3,162,2255.082369,1.075133,1473.306093,1205.432258,Benign
172.30.6.255,56031,157.240.16.39,443,19,1933,10,1125,9,808,240.100381,61.029234,147.4703091,105.9164531,Benign
172.30.6.255,58148,35.190.43.164,80,10,1573,6,1119,4,454,4957.832071,1.1219,7979.320795,3237.365184,Benign
172.30.6.255,57167,103.243.221.46,80,20,10572,10,4552,10,6020,1982.860408,25.164546,1447.115319,1913.803651,Benign
10.0.2.15,50251,119.254.87.201,80,11,1552,6,705,5,847,11119.46243,3.75017,1503.931822,1806.851423,Malicious
172.30.1.136,50457,157.240.16.39,443,3,198,3,198,0,0,857.557753,9.002072,175.9594902,0,Benign
10.0.2.15,37064,119.254.87.201,80,11,1579,6,705,5,874,4275.161216,1.817692,3102.835904,3846.636284,Malicious
192.168.137.97,44270,140.98.193.112,443,39,20949,21,7589,18,13360,79.26333326,17.95686908,3380.99029,5952.03983,Benign
192.168.43.233,50723,172.217.166.202,443,9,534,5,294,4,240,1844.838247,12.485537,188.3779608,153.7779272,Benign
192.168.43.233,51306,13.107.54.254,443,7,434,4,252,3,182,2930.149192,127.270538,15.84027248,11.44019679,Benign
192.168.43.224,60164,151.101.153.2,443,19,5934,11,1352,8,4582,879.9080729,32.92416793,328.5124783,1113.346284,Benign
192.168.42.240,50932,172.217.161.14,443,19,5607,10,1175,9,4432,107.0296,50.855166,184.8386455,697.1956399,Benign
192.168.43.233,51347,139.59.46.160,443,155,111995,67,15941,88,96054,3083.951928,188.091313,678.0111105,4085.419936,Benign
172.30.15.351,49619,204.4.185.73,80,3,198,3,198,0,0,1158.362181,9.00011,175.9978489,0,Benign
192.168.137.97,37124,52.206.174.32,443,65,8219,36,4827,29,3392,3031.628941,48.37277735,798.3002447,560.9766791,Benign
172.30.15.308,49571,54.86.32.187,80,6,348,4,228,2,120,710.647502,4.565594,399.5098995,210.2683681,Benign
172.30.15.2125,51437,64.74.232.52,443,7,402,4,228,3,174,4178.296553,9.3756,194.547549,148.4704979,Benign
172.30.15.753,50043,34.213.23.47,443,22,9049,12,2408,10,6641,2578.471676,7.693213,2504.025301,6905.827253,Benign
192.168.43.224,43194,185.199.109.153,80,6,412,4,272,2,140,2602.859094,17.22042863,126.3615469,65.03903148,Benign
172.30.15.2275,51594,52.84.108.223,443,11,1408,7,961,4,447,4537.864497,9.643868,797.1905049,370.805573,Benign
192.168.137.97,56474,172.217.161.14,443,35,7439,17,1929,18,5510,1382.260058,285.4400719,54.06388774,154.4282122,Benign
172.30.6.255,57595,157.240.16.39,443,29,5597,16,3451,13,2146,3351.45208,60.674777,455.0160934,282.9511841,Benign
172.30.1.136,50167,23.21.249.197,443,29,8160,16,2032,13,6128,184.387617,197.187556,82.43927928,248.6160942,Benign
10.0.2.15,59570,119.254.87.201,80,11,1582,6,705,5,877,17939.25449,1.049001,5376.543969,6688.268171,Malicious
172.30.15.2053,51365,54.246.156.84,443,25,6449,13,1992,12,4457,4094.167617,3.426011,4651.473682,10407.43886,Benign
192.168.43.224,39022,103.37.200.184,443,132,87791,67,7021,65,80770,2460.538342,50.08289989,1121.500555,12901.80883,Benign
172.30.15.2151,51463,52.229.170.171,443,30,10152,17,2303,13,7849,4182.472821,79.334533,232.2317823,791.4838296,Benign
172.30.6.255,55781,195.201.82.80,80,268,284439,68,13392,200,271047,63.790599,38.259749,2800.227466,56675.12351,Benign
10.0.2.15,35340,119.254.87.201,80,11,1587,6,705,5,882,18146.9861,2.018425,2794.257899,3495.794989,Malicious
192.168.137.97,57764,104.197.3.80,80,13,1109,6,503,7,606,10523.81405,3.657438492,1100.223561,1325.517848,Benign
172.30.6.255,58164,35.190.43.164,80,22,5364,13,4164,9,1200,4962.504408,151.490409,219.895109,63.37034842,Benign
10.0.2.15,54550,119.254.87.201,80,11,1579,6,705,5,874,20945.30104,1.02475,5503.78141,6823.127592,Malicious
10.0.2.15,46953,119.254.87.201,80,11,1582,6,705,5,877,6407.09973,2.024357,2786.069848,3465.791854,Malicious
172.30.6.255,57228,161.69.36.37,80,7,398,4,228,3,170,2167.76897,0.663918,2747.32723,2048.445742,Benign
10.0.2.15,43761,119.254.87.201,80,11,1558,6,705,5,853,23077.91473,3.154213,1788.084698,2163.45567,Malicious
172.30.6.255,57530,104.25.219.21,443,134,48751,63,5529,71,43222,3133.674763,402.388473,109.923626,859.3089097,Benign
10.0.2.15,47240,119.254.87.201,80,11,1582,6,705,5,877,25294.68618,1.222788,4612.410328,5737.707599,Malicious
192.168.43.233,51666,54.255.158.169,443,13,1533,8,1024,5,509,870.210776,23.328116,351.1642346,174.5533158,Benign
172.30.1.136,50470,74.125.24.188,443,21,4862,14,4424,7,438,881.086318,73.032187,484.6082454,47.97884527,Benign
172.30.15.865,50171,180.149.59.136,80,47,34967,21,3052,26,31915,3434.51988,2.523371,9675.945392,101182.1092,Benign
10.0.2.15,59684,119.254.87.201,80,11,1582,6,705,5,877,23853.12468,5.041279,1118.763711,1391.710318,Malicious
172.30.6.255,55704,180.149.59.210,80,6,348,4,228,2,120,53.405653,5.167913,352.9471181,185.7616411,Benign
172.30.6.255,58239,103.243.221.109,80,17,5606,10,4371,7,1235,5221.882947,37.67515,928.1449443,262.2418225,Benign
172.30.6.255,56106,75.98.70.37,80,6,348,4,228,2,120,306.397014,17.660454,103.2816031,54.35873846,Benign
10.0.2.15,38912,119.254.87.201,80,11,1579,6,705,5,874,22657.39277,1.544518,3651.624649,4526.978643,Malicious
192.168.43.233,50854,172.217.166.206,443,3,162,2,108,1,54,3.006212,0.124562,6936.304812,3468.152406,Benign
192.168.43.224,51236,23.213.88.167,443,33,8347,17,2880,16,5467,727.2592672,70.96003819,324.6897915,616.3469062,Benign
192.168.215.49,47940,54.255.158.169,443,54,15673,30,4414,24,11259,479.9186368,60.32370326,585.3752024,1493.144405,Benign
172.30.1.136,50186,172.217.161.5,443,111,31302,51,18712,60,12590,353.058017,30.445132,4916.910855,3308.246455,Benign
172.30.15.1624,50934,104.244.42.133,443,11,1376,7,958,4,418,3574.180184,2.796047,2741.01258,1195.974174,Benign
172.30.6.255,56451,52.68.71.55,443,27,9325,16,2423,11,6902,700.570026,46.889536,413.3971383,1177.576165,Benign
192.168.215.49,43750,103.243.221.109,443,27,11769,16,5453,11,6316,613.8452149,25.21215248,1730.2767,2004.112899,Benign
10.0.2.15,56408,119.254.87.201,80,11,1579,6,705,5,874,10611.50851,0.831847,6780.092974,8405.391857,Malicious
172.30.6.255,58291,13.228.208.99,443,20,7631,9,1141,11,6490,5320.936471,3.104454,2940.291594,16724.35797,Benign
192.168.43.233,51225,13.32.226.189,443,23,9354,12,1441,11,7913,1293.023742,25.575159,450.7498859,2475.214328,Benign
172.30.15.1472,50780,35.201.123.46,443,21,3546,11,2333,10,1213,3508.482558,8.541569,2185.078643,1136.091039,Benign
192.168.43.224,42242,172.217.160.226,443,23,5499,13,1649,10,3850,2808.537576,6.032698935,2186.749271,5105.509214,Benign
192.168.137.97,39774,192.168.125.6,80,371,289083,186,14788,185,274295,8327.371289,44.12171389,2681.310166,49734.24208,Benign
172.30.15.844,50147,192.168.1.44,7680,3,198,3,198,0,0,3256.834415,9.001746,175.9658626,0,Benign
10.0.2.15,36094,119.254.87.201,80,13,1717,8,853,5,864,2534.982337,321.721982,21.21086025,21.48438834,Malicious
192.168.215.49,47362,157.240.16.39,443,29,5761,15,3197,14,2564,1470.326437,65.13324643,392.6719671,314.9236546,Benign
10.0.2.15,55266,119.254.87.201,80,11,1579,6,705,5,874,21150.23642,1.819111,3100.415533,3843.63571,Malicious
10.0.2.15,40635,119.254.87.201,80,11,1579,6,705,5,874,9442.543425,1.044483,5399.800667,6694.220969,Malicious
192.168.43.233,50970,49.44.170.2,443,9,534,5,294,4,240,489.891704,14.365642,163.7239742,133.6522238,Benign
192.168.137.97,60738,23.57.218.60,443,21,1393,11,702,10,691,43.90400693,360.067133,15.59709144,15.35269258,Benign
192.168.137.97,41114,104.17.161.9,443,43,5709,22,2312,21,3397,9545.325559,402.1181259,45.9964344,67.58213133,Benign
172.30.6.255,55772,195.201.82.80,80,212,208221,64,17154,148,191067,62.619236,39.434059,3480.037396,38761.82262,Benign
192.168.43.233,51371,192.28.144.75,443,31,9042,15,2266,16,6776,3473.54307,152.644721,118.7594296,355.1252847,Benign
10.0.2.15,59922,119.254.87.201,80,11,1582,6,705,5,877,19984.41954,2.107097,2676.668421,3329.699582,Malicious
172.30.1.136,51518,52.84.108.242,443,17,1681,8,1015,9,666,10.218044,15.303118,530.6108206,348.1643414,Benign
192.168.43.224,54162,23.60.211.179,443,7,478,4,272,3,206,44.88417406,12.19478938,178.4368662,135.1396854,Benign
192.168.137.97,54826,52.84.108.88,443,13,1663,8,1106,5,557,1839.626247,63.90851364,138.4479077,69.72466963,Benign
192.168.43.224,33992,104.19.199.151,443,146,74032,75,5094,71,68938,71.85164772,400.5389649,101.7429104,1376.904742,Benign
192.168.137.97,58362,13.228.153.206,443,18,5273,10,1323,8,3950,1766.985891,50.74038676,208.5912362,622.7780673,Benign
192.168.137.97,45316,104.244.42.193,443,1614,1015116,725,147641,889,867475,143.3608474,1656.650225,712.9616028,4189.055658,Benign
172.30.1.136,50343,104.113.230.86,443,292,197110,135,10767,157,186343,608.799849,120.812104,712.9749185,12339.35964,Benign
172.30.6.255,57674,157.240.16.39,443,27,5352,15,3298,12,2054,3595.09741,61.017964,432.3972527,269.2977432,Benign
172.30.1.136,50594,157.240.16.39,443,1134,656528,537,136149,597,520379,1598.740589,197.015154,5528.46813,21130.51669,Benign
10.0.2.15,54215,119.254.87.201,80,11,1582,6,705,5,877,23588.32731,2.049463,2751.940386,3423.335771,Malicious
172.30.15.1329,50637,157.240.16.39,443,29,5819,15,4242,14,1577,3489.615763,7.403274,4583.917872,1704.110911,Benign
192.168.43.224,38146,157.240.16.35,443,6,412,4,272,2,140,35.04187176,10.63266185,204.6524221,105.3358055,Benign
10.0.2.15,41612,119.254.87.201,80,12,1661,7,779,5,882,758.830128,315.692335,19.74073903,22.35087526,Malicious
10.0.2.15,45003,119.254.87.201,80,11,1579,6,705,5,874,14182.85711,1.415989,3983.081789,4937.891467,Malicious
172.30.15.1484,50792,52.220.69.147,443,16,3034,8,1732,8,1302,3520.938763,6.119542,2264.221734,1702.088163,Benign
192.168.137.97,47606,157.240.16.39,443,42,12657,23,9342,19,3315,96.00693403,65.91482044,1133.826953,402.3374383,Benign
172.30.6.255,56024,184.84.52.113,80,9,534,5,294,4,240,233.034686,19.926658,118.0328382,96.35333732,Benign
192.168.215.49,59338,180.149.59.81,443,15,5181,9,1377,6,3800,6.607420636,18.76149375,587.1600709,1622.045686,Benign
172.30.6.255,58056,151.139.104.15,80,22,14868,8,1870,14,12998,4819.999528,5.997888,2494.211296,17336.76921,Benign
172.30.15.2506,51840,14.139.45.128,80,10,1406,5,675,5,731,5475.870778,0.153999,35065.16276,37974.27256,Benign
172.30.15.1814,51126,162.247.242.19,443,24,7207,12,3381,12,3826,3743.387526,3.890034,6953.152595,7868.311691,Benign
172.30.15.335,49603,104.25.219.21,443,18,6485,10,1145,8,5340,972.879796,7.25637,1262.339159,5887.241141,Benign
10.0.2.15,48169,119.254.87.201,80,11,1582,6,705,5,877,9948.424618,0.85303,6611.725262,8224.798659,Malicious
172.30.1.136,51787,52.220.54.9,443,9,534,5,294,4,240,2974.59413,37.370054,62.93809476,51.37803654,Benign
10.0.2.15,37692,119.254.87.201,80,11,1513,6,705,5,808,5113.627065,1.747158,3228.099577,3699.722635,Malicious
172.30.6.255,57244,18.211.245.141,443,6,348,4,228,2,120,2206.313838,19.761961,92.29853252,48.57817501,Benign
172.30.6.255,55686,104.25.171.105,443,37,16046,17,1904,20,14142,42.744949,15.871733,959.6935634,7128.144104,Benign
172.30.1.136,51916,52.84.108.135,443,4250,3697946,1680,98454,2570,3599492,5787.102634,395.066657,1993.668628,72888.80367,Benign
172.30.15.1009,50315,35.190.91.160,80,12,1911,7,1015,5,896,3443.639118,3.368835,2410.328793,2127.738521,Benign
192.168.137.97,37518,172.217.160.227,443,18,1263,9,606,9,657,22.97339568,193.5330362,25.04998678,27.15815399,Benign
172.30.1.136,50533,74.125.200.188,5228,7,403,4,229,3,174,1130.846327,55.463494,33.0307355,25.09758942,Benign
10.0.2.15,55303,219.234.85.243,80,8,944,4,688,4,256,250.727829,0.644352,8541.914978,3178.386969,Malicious
172.30.15.1321,50629,169.38.89.75,443,20,8479,11,1762,9,6717,3488.534083,8.492534,1659.810841,6327.440079,Benign
172.30.6.255,58013,103.231.98.53,80,39,17419,20,15673,19,1746,4761.845377,12.103867,10359.00345,1154.011359,Benign
172.30.6.255,58453,52.138.216.83,443,27,7412,14,2530,13,4882,5640.644086,1.373702,14733.90881,28431.20269,Benign
172.30.6.255,56280,103.243.221.46,80,50,37628,19,12573,31,25055,566.864445,22.193504,4532.136971,9031.471551,Benign
172.30.15.648,49935,50.17.52.222,443,6,348,4,228,2,120,2395.559904,0.782298,2331.592309,1227.153847,Benign
192.168.215.49,60598,103.231.98.244,443,22,6695,11,1067,11,5628,612.7743937,1.6366989,5215.375901,27509.03052,Benign
172.30.6.255,56252,202.241.208.4,80,11,1970,6,808,5,1162,529.951741,36.410052,177.5333911,255.3141094,Benign
192.168.42.240,50941,172.217.166.206,443,33,7985,14,2119,19,5866,170.708608,11.645363,1455.686697,4029.758454,Benign
172.30.6.255,56609,172.30.16.59,80,3,198,3,198,0,0,959.370644,9.004836,175.9054801,0,Benign
172.30.1.136,50248,52.94.220.15,443,3,198,3,198,0,0,451.786234,9.001146,175.9775922,0,Benign
172.30.15.1388,50696,184.29.24.49,443,27,14530,12,1782,15,12748,3495.665028,1.353026,10536.38289,75374.75259,Benign
172.30.6.255,58132,172.217.166.197,443,30,6666,16,4038,14,2628,4909.833223,9.131529,3537.633183,2302.352651,Benign
192.168.137.97,56180,172.217.161.14,443,9,618,5,338,4,280,342.2783678,13.65011637,198.0935492,164.101165,Benign
172.30.6.255,56197,185.86.137.17,80,7,394,4,228,3,166,466.863094,24.141848,75.5534539,55.00821644,Benign
172.30.6.255,56057,23.198.119.161,80,15,5642,7,615,8,5027,275.5389,60.451058,81.3881537,665.265445,Benign
192.168.215.49,58512,104.113.219.181,443,37,6674,19,3691,18,2983,612.554396,367.2630367,80.40014117,64.97795207,Benign
172.30.15.2537,51871,192.168.121.146,80,236,206012,93,7084,143,198928,5500.381574,3.223589,17580.40495,493680.8011,Benign
192.168.43.233,51361,45.79.77.20,443,33,8847,17,3451,16,5396,3137.371404,134.874744,204.693623,320.0599217,Benign
172.30.15.1111,50419,208.100.17.187,80,9,2655,5,1069,4,1586,3458.270339,4.81014,1777.91083,2637.761063,Benign
192.168.43.224,54596,216.58.221.42,443,22,6625,12,1595,10,5030,357.9306568,12.78302265,998.1989668,3147.925268,Benign
172.30.15.1667,50978,103.254.155.35,443,19,8786,10,2449,9,6337,3591.143001,6.310872,3104.483818,8033.121255,Benign
192.168.137.97,46428,172.217.160.227,443,155,16145,71,7593,84,8552,4203.834176,494.2931918,122.8906265,138.4117789,Benign
172.30.1.136,50257,104.17.162.9,443,1,66,1,66,0,0,460.95724,0,0,0,Benign
10.0.2.15,54490,119.254.87.201,80,11,1579,6,705,5,874,18116.93656,2.279082,2474.680595,3067.901901,Malicious
172.30.15.1979,51291,35.172.175.129,443,26,13120,14,1483,12,11637,4076.76812,5.480682,2164.694102,16986.20719,Benign
172.30.6.255,57652,172.217.166.206,443,18,1883,11,1242,7,641,3521.412767,106.010516,93.72655068,48.37255957,Benign
172.30.6.255,56145,172.217.161.1,80,11,3009,6,822,5,2187,370.375184,41.267448,159.3507793,423.9661246,Benign
172.30.6.255,58104,216.58.196.194,80,14,2828,8,1623,6,1205,4890.918208,8.001986,1622.59719,1204.700933,Benign
172.30.1.136,50564,184.29.24.13,443,3,198,3,198,0,0,1474.546257,9.001169,175.9771425,0,Benign
172.30.6.255,57888,103.243.221.87,80,63,42124,37,35077,26,7047,4344.838005,17.231618,16284.94782,3271.66027,Benign
172.30.1.136,50211,52.84.103.186,443,432,325922,189,15489,243,310433,370.268848,190.449373,650.6296033,13040.02193,Benign
192.168.43.224,56178,185.199.108.153,80,34,5362,17,1548,17,3814,804.3439907,369.569512,33.50925766,82.56092294,Benign
172.30.6.255,57014,103.243.221.51,80,40,24224,23,20079,17,4145,1522.833585,12.09828,13277.25925,2740.885481,Benign
192.168.43.224,37566,192.229.237.182,443,47,12155,26,3204,21,8951,3025.984827,190.4365064,134.5960419,376.0203406,Benign
10.0.2.15,49213,119.254.87.201,80,11,1582,6,705,5,877,23826.00776,1.023284,5511.66636,6856.356593,Malicious
172.30.6.255,57417,103.243.221.17,80,31,18480,17,15289,14,3191,2770.894706,22.136241,5525.418701,1153.221995,Benign
172.30.15.947,50253,208.100.17.187,80,6,531,4,228,2,303,3441.195314,6.06847,300.5699954,399.4417044,Benign
10.0.2.15,38138,119.254.87.201,80,11,1579,6,705,5,874,8326.674198,1.025081,5502.004232,6820.924395,Malicious
172.30.6.255,56828,103.243.220.231,80,51,34665,31,29561,20,5104,1313.679142,14.796056,15983.17822,2759.65433,Benign
172.30.1.136,50273,54.194.87.27,443,322,126920,172,111014,150,15906,482.441982,148.838132,5966.965509,854.9421999,Benign
172.30.1.136,51795,54.255.158.169,443,13,1560,7,1009,6,551,2977.307597,3.325575,2427.249423,1325.485066,Benign
172.30.15.1422,50730,119.42.60.92,443,18,2862,10,1679,8,1183,3500.256249,6.836021,1964.885713,1384.431089,Benign
192.168.42.240,50975,172.217.161.14,443,16,5627,8,1219,8,4408,295.146319,14.641649,666.0451975,2408.471887,Benign
192.168.43.233,51349,139.59.46.160,443,891,817480,315,31467,576,786013,3083.952645,188.128249,1338.108452,33424.56028,Benign
172.30.6.255,58355,184.29.25.174,443,51,34537,21,2939,30,31598,5459.377062,62.570635,375.7673228,4039.978178,Benign
172.30.6.255,56456,103.243.221.75,80,23,15666,10,4560,13,11106,708.853313,1.56921,23247.36651,56619.57291,Benign
10.0.2.15,56762,119.254.87.201,80,11,1579,6,705,5,874,8990.009263,1.699287,3319.039103,4114.666916,Malicious
10.0.2.15,33297,119.254.87.201,80,11,1582,6,705,5,877,26105.78458,0.886033,6365.4514,7918.440961,Malicious
172.30.15.429,49703,18.204.234.216,443,40,11344,20,3379,20,7965,1623.020754,7.684981,3517.510323,8291.497403,Benign
192.168.43.233,51189,40.77.226.13,443,36,11320,20,4360,16,6960,642.093717,117.878509,295.8978723,472.3507319,Benign
172.30.6.255,55671,35.186.249.84,443,40,8232,17,2850,23,5382,39.923057,18.934373,1204.159229,2273.959639,Benign
10.0.2.15,53006,119.254.87.201,80,12,1587,7,779,5,808,15386.33333,4.443442,1402.516338,1454.728114,Malicious
172.30.15.1899,51211,52.204.146.6,443,6,348,4,228,2,120,3983.851887,3.633661,501.9730789,264.1963573,Benign
10.0.2.15,49824,119.254.87.201,80,11,1579,6,705,5,874,4002.471511,1.794118,3143.605939,3897.179561,Malicious
10.0.2.15,33440,119.254.87.201,80,11,1579,6,705,5,874,4215.107381,0.852223,6617.986137,8204.425368,Malicious
172.30.15.2316,51646,52.55.184.84,443,108,91878,42,8513,66,83365,5039.10251,4.22711,16111.24385,157772.0949,Benign
172.30.6.255,58468,216.58.196.162,80,6,348,4,228,2,120,5672.930591,6.157946,296.2026624,155.8961381,Benign
172.30.15.413,49685,192.168.121.7,443,17,4316,8,1580,9,2736,1575.479928,5.019965,2517.945842,4360.189762,Benign
192.168.43.233,50926,52.84.109.5,443,893,589531,375,45834,518,543697,433.2752,235.949717,1554.026022,18434.33446,Benign
10.0.2.15,58745,119.254.87.201,80,11,1582,6,705,5,877,3315.99544,3.578449,1576.101825,1960.625958,Malicious
172.30.1.136,51822,157.240.16.39,443,37,10678,21,2660,16,8018,3055.951376,99.035285,214.8729112,647.6883466,Benign
172.30.6.255,56699,180.149.59.210,80,30,18920,20,14360,10,4560,1156.233931,85.218582,1348.062797,428.0756514,Benign
172.30.1.136,50645,157.240.16.20,443,22,5968,11,1780,11,4188,1746.378941,28.09942,506.7720259,1192.337778,Benign
192.168.43.233,50940,54.239.35.198,443,28,7800,13,1531,15,6269,452.465497,28.714611,426.5424317,1746.567279,Benign
172.30.15.2288,51613,52.175.39.99,443,24,5843,14,1353,10,4490,4798.363551,127.494194,84.89798367,281.7383198,Benign
10.0.2.15,42735,119.254.87.201,80,11,1587,6,705,5,882,14122.77323,1.6415,3435.881815,4298.507463,Malicious
192.168.43.224,58290,104.24.18.65,443,19,6509,10,1141,9,5368,3264.484788,28.80694192,316.868067,1490.751782,Benign
172.30.6.255,57817,103.243.221.46,80,25,16770,10,4258,15,12512,4064.848177,38.208531,891.5286484,2619.729086,Benign
192.168.137.97,36704,172.217.24.234,443,38,4544,20,2535,18,2009,1903.607433,240.2362168,84.41691379,66.90082044,Benign
192.168.137.97,59498,103.243.221.87,443,12,1532,7,1038,5,494,1817.726936,21.91484946,378.9211518,180.3343439,Benign
192.168.137.97,42724,157.240.16.39,443,6,412,4,272,2,140,150.2933231,24.67146072,88.19907443,45.39658243,Benign
172.30.15.1954,51266,34.205.118.138,443,6,348,4,228,2,120,4028.704543,8.756447,208.3036647,109.6335077,Benign
172.30.1.136,51845,172.217.160.234,443,42,11086,21,3003,21,8083,3678.080739,154.197969,155.7997174,419.357015,Benign
172.30.1.136,50193,119.81.21.130,443,18,1997,11,1222,7,775,356.917607,18.530271,527.5691867,334.5876593,Benign
172.30.15.763,50054,209.197.3.15,443,46,28983,19,2109,27,26874,2617.478735,8.882347,1899.497959,24204.41354,Benign
172.30.1.136,50557,184.29.24.13,443,12,708,5,294,7,414,1472.258335,27.747397,84.76470784,119.3625478,Benign
192.168.43.224,59912,172.217.166.194,443,21,5367,11,1517,10,3850,1210.574717,38.45589267,315.5823245,800.9175672,Benign
172.30.15.1791,51103,52.37.171.77,443,15,5005,8,1087,7,3918,3643.15734,3.830893,2269.96682,8181.904324,Benign
172.30.6.255,55815,185.84.60.59,443,6,344,4,228,2,116,90.876222,11.200876,162.8444061,82.85066275,Benign
192.168.137.97,55242,52.172.156.220,443,41,16179,23,3343,18,12836,8274.505603,124.6399916,214.5699759,823.8768205,Benign
172.30.15.2298,51626,172.217.166.196,443,19,3207,10,1478,9,1729,4923.378194,1.231639,9600.215648,11230.5635,Benign
192.168.137.97,53450,52.206.154.207,443,43,9137,25,3444,18,5693,6795.219849,19.69584713,1398.87357,2312.365632,Benign
192.168.42.240,50957,13.35.130.15,443,15,1722,9,1090,6,632,224.215988,47.535616,183.4414011,106.3623537,Benign
192.168.42.240,51004,172.217.163.78,443,43,11363,20,4217,23,7146,356.450915,38.763747,870.2977037,1474.780031,Benign
172.30.1.136,50522,172.217.161.4,443,31,4285,15,2550,16,1735,1029.62024,98.493155,207.1209923,140.9234987,Benign
172.30.15.1104,50412,87.248.118.22,443,57,16500,25,4983,32,11517,3458.242156,9.436787,4224.319146,9763.492596,Benign
192.168.137.97,39658,192.168.125.6,80,59,37943,30,2613,29,35330,8266.284318,11.78750348,1773.403506,23977.93566,Benign
172.30.15.1650,50961,184.29.25.7,443,15,1749,7,970,8,779,3579.114397,8.389991,924.9116,742.7898314,Benign
10.0.2.15,42914,119.254.87.201,80,12,1656,7,779,5,877,10283.49238,3.851043,1618.262897,1821.844108,Malicious
192.168.43.233,51127,40.100.141.2,443,1,54,0,0,1,54,8.011089,0,0,0,Benign
172.30.6.255,57503,54.194.27.245,443,28,9147,15,3538,13,5609,3059.194744,130.223845,217.3488273,344.5759108,Benign
172.30.15.2124,51436,13.56.57.63,443,19,6556,10,1207,9,5349,4178.284351,9.387436,1028.608877,4558.433208,Benign
172.30.15.276,49539,180.149.59.79,443,15,5008,8,1219,7,3789,231.107761,3.761184,2592.800565,8059.164348,Benign
172.30.15.1330,50638,52.84.110.238,443,21,8769,11,1776,10,6993,3489.650309,7.361401,1930.067388,7599.64034,Benign
10.0.2.15,54303,119.254.87.201,80,11,1579,6,705,5,874,7670.68442,2.084743,2705.369439,3353.890623,Malicious
172.30.6.255,58032,35.230.55.83,80,457,384583,191,12954,266,371629,4808.103556,64.636824,1603.296598,45995.94807,Benign
172.30.6.255,56163,157.240.16.39,443,18,1879,9,1071,9,808,423.09304,61.02206,140.4082392,105.9289051,Benign
10.0.2.15,38358,119.254.87.201,80,12,1667,7,779,5,888,8656.843485,5.061472,1231.262368,1403.544265,Malicious
192.168.137.97,32820,172.217.24.238,443,21,6678,11,2026,10,4652,1098.571854,23.40397416,692.5319559,1590.157285,Benign
192.168.137.97,52104,172.217.161.3,443,23,6236,13,1657,10,4579,8269.039226,19.27275494,687.8103335,1900.714253,Benign
10.0.2.15,43781,119.254.87.201,80,11,1587,6,705,5,882,7878.721409,1.449539,3890.892208,4867.754507,Malicious
10.0.2.15,39650,119.254.87.201,80,11,1534,6,705,5,829,12595.80195,2.016586,2796.806087,3288.72659,Malicious
192.168.43.233,51266,49.44.170.2,443,113,65474,50,12539,63,52935,1950.558365,333.640569,300.6588806,1269.270105,Benign
172.30.15.1021,50327,52.221.149.123,443,20,8343,10,1922,10,6421,3446.431874,10.787761,1425.318933,4761.69244,Benign
192.168.43.224,36432,18.215.97.76,443,37,8910,21,3059,16,5851,358.195909,64.15578438,381.4465092,729.5990603,Benign
10.0.2.15,35181,119.254.87.201,80,11,1587,6,705,5,882,23408.12069,2.12677,2651.908763,3317.707133,Malicious
192.168.43.224,54950,151.101.194.217,443,19,8473,11,1344,8,7129,3264.367637,28.92413036,371.7311417,1971.779248,Benign
10.0.2.15,43300,119.254.87.201,80,11,1579,6,705,5,874,7039.983502,1.289048,4375.321943,5424.157983,Malicious
172.30.6.255,55675,195.201.82.80,80,14,4694,8,873,6,3821,41.403263,17.356336,402.3890757,1761.201212,Benign
10.0.2.15,52422,119.254.87.201,80,11,1559,6,705,5,854,1001.557854,0.894741,6303.500119,7635.729222,Malicious
172.30.6.255,56598,52.229.174.172,443,29,10110,16,2260,13,7850,914.716995,65.498494,276.0368811,958.8006711,Benign
10.0.2.15,43870,119.254.87.201,80,12,1653,7,779,5,874,1902.366951,4.384472,1421.379815,1594.718817,Malicious
172.30.15.861,50167,172.217.167.2,80,12,1830,7,876,5,954,3434.381385,2.671155,2623.58418,2857.19099,Benign
172.30.1.136,51781,172.217.160.243,443,11,642,6,348,5,294,2974.391155,37.253709,74.73081405,63.13465325,Benign
192.168.43.233,51320,117.18.232.102,443,395,319720,145,9096,250,310624,2978.258846,182.40004,398.9472809,13623.85666,Benign
192.168.137.97,39762,172.217.167.10,443,22,6871,12,1845,10,5026,98.2218967,40.76365844,362.0872259,986.368779,Benign
192.168.43.233,50852,172.217.194.189,443,16,980,8,437,8,543,34.535475,198.487171,17.61322902,21.88554544,Benign
192.168.137.97,54412,122.15.34.26,80,14,1386,8,544,6,842,84.28623709,47.87350188,90.90623893,140.7041419,Benign
172.30.15.1654,50965,184.29.25.7,443,390,360948,137,35313,253,325635,3580.720245,16.659755,16957.27218,156369.6465,Benign
10.0.2.15,60008,119.254.87.201,80,11,1513,6,705,5,808,2114.641419,1.701847,3314.046445,3798.22628,Malicious
172.30.15.462,49736,162.247.242.20,443,22,6261,10,2471,12,3790,1658.501493,2.206195,8960.223371,13743.11881,Benign
172.30.15.2308,51637,87.250.251.119,443,22,7946,13,5468,9,2478,4998.666478,9.097555,4808.324874,2179.047008,Benign
192.168.43.233,51521,13.107.18.11,443,26,6285,13,1173,13,5112,3916.382673,123.193282,76.17298482,331.9661538,Benign
172.30.6.255,58288,13.229.196.49,443,25,10814,12,3895,13,6919,5320.855733,3.183681,9787.412746,17386.164,Benign
172.30.6.255,56131,210.176.156.21,80,41,21355,20,14921,21,6434,345.944281,65.774974,1814.793572,782.5468696,Benign
192.168.43.224,54936,54.85.227.48,443,6,412,4,272,2,140,361.4472171,44.48783288,48.91224991,25.17542275,Benign
172.30.15.2247,51564,104.121.244.70,443,26,12981,14,6195,12,6786,4468.153314,9.565026,5181.376402,5675.677202,Benign
172.30.6.255,57722,103.243.221.87,80,27,17337,11,4606,16,12731,3738.839861,23.275321,1583.136061,4375.793571,Benign
172.30.6.255,56884,63.251.88.51,80,10,2062,5,1547,5,515,1385.01792,0.771878,16033.62189,5337.631076,Benign
172.30.6.255,57825,103.243.221.46,80,50,33282,22,13690,28,19592,4102.836749,19.314168,5670.448761,8115.079045,Benign
192.168.43.233,51108,182.161.72.82,443,4,240,2,120,2,120,918.936565,10.731706,89.45455643,89.45455643,Benign
172.30.6.255,57279,103.243.221.75,80,8,448,5,282,3,166,2306.880388,18.153891,124.2708794,73.15236166,Benign
172.30.1.136,51760,13.107.4.52,80,20,3686,9,657,11,3029,2948.022778,4.54928,1155.347659,5326.557169,Benign
192.168.137.97,46650,52.84.110.17,443,54,28492,23,2601,31,25891,345.7854417,180.4181313,115.3320891,1148.04426,Benign
192.168.43.224,50108,49.44.178.251,80,2023,1582896,944,70475,1079,1512421,1685.14684,531.0684184,1061.633455,22783.06821,Benign
172.30.6.255,57074,173.241.248.220,80,165,84287,82,39175,83,45112,1679.946344,848.82333,369.216996,425.1721027,Benign
10.0.2.15,59464,119.254.87.201,80,11,1587,6,705,5,882,14212.86119,1.093662,5156.986345,6451.719087,Malicious
192.168.137.97,34760,104.198.143.177,80,10,911,5,425,5,486,3464.612357,0.874772373,3886.725398,4444.584809,Benign
192.168.137.97,58364,13.228.153.206,443,18,5261,10,1311,8,3950,1766.986848,50.73954992,206.7026613,622.7883387,Benign
172.30.6.255,57004,103.243.221.51,80,45,29057,26,24802,19,4255,1497.841112,25.223399,7866.346641,1349.54056,Benign
192.168.43.233,51265,49.44.170.2,443,104,60174,47,11230,57,48944,1950.534243,333.664693,269.2523419,1173.489459,Benign
192.168.42.240,50927,172.217.163.78,443,57,17798,30,11673,27,6125,8.300821,240.699023,387.9700002,203.5737386,Benign
192.168.137.97,39714,192.168.125.6,80,58,40845,29,2488,29,38357,8277.97449,10.33303903,1926.248409,29696.58772,Benign
192.168.43.233,50911,151.139.105.8,80,159,143846,56,3487,103,140359,371.804672,26.139283,1067.206013,42957.26092,Benign
192.168.137.97,56140,52.205.114.175,443,16,3031,10,2042,6,989,373.8579867,8.017658573,2037.502577,986.821767,Benign
172.30.6.255,57891,103.243.221.75,80,31,16240,15,8559,16,7681,4344.846297,17.223324,3975.539216,3567.720145,Benign
172.30.6.255,56360,35.186.236.204,80,7,402,5,282,2,120,607.828748,24.641917,91.55131884,38.95800802,Benign
172.30.6.255,55979,54.149.211.44,80,26,9825,15,5889,11,3936,176.110131,128.142074,367.6544208,245.7272543,Benign
172.30.1.136,50324,104.244.46.103,443,29,11235,16,2486,13,8749,568.129355,40.66939,489.0164323,1720.999504,Benign
10.0.2.15,45950,119.254.87.201,80,11,1579,6,705,5,874,22564.37629,1.708445,3301.247626,4092.610532,Malicious
192.168.215.49,56568,52.206.174.32,443,28,4623,15,2997,13,1626,545.6734602,93.74640305,255.7538126,138.7573238,Benign
10.0.2.15,60631,119.254.87.201,80,11,1585,6,705,5,880,22056.69336,2.2461,2511.0191,3134.321713,Malicious
172.30.15.1523,50831,104.20.90.77,8443,28,7921,14,2505,14,5416,3526.360966,41.421668,483.8047565,1046.022579,Benign
172.30.6.255,58293,104.16.0.35,443,28,7211,14,1952,14,5259,5321.620368,2.358146,6622.15147,17841.13452,Benign
192.168.137.97,33548,35.171.73.174,443,6,412,4,272,2,140,1828.55897,11.40010608,190.8754169,98.24469987,Benign
10.0.2.15,37678,119.254.87.201,80,11,1582,6,705,5,877,13767.20062,1.994063,2828.396094,3518.444503,Malicious
192.168.137.97,60468,172.217.161.4,443,48,9255,24,2785,24,6470,8268.823989,254.2503001,87.63018172,203.5789141,Benign
192.168.215.49,57012,108.179.217.142,443,6,412,4,272,2,140,1293.130331,12.82692917,169.6430979,87.31630038,Benign
172.30.15.679,49966,35.190.14.224,80,6,348,4,228,2,120,2398.176345,8.033361,227.0531599,119.5016631,Benign
172.30.1.136,50548,157.240.16.20,443,65,12238,29,2798,36,9440,1461.545501,82.576678,271.0692721,914.5439345,Benign
172.30.15.1856,51168,104.16.90.50,443,153,122712,63,5003,90,117709,3907.335927,9.857832,4060.121942,95525.26357,Benign
172.30.6.255,58251,157.240.16.39,443,5,330,1,66,4,264,5242.082606,15.053182,35.07564049,140.3025619,Benign
192.168.43.233,51002,104.244.42.195,443,108,13176,53,4878,55,8298,526.68427,1482.563801,26.32197007,44.77648783,Benign
172.30.6.255,57601,192.168.1.35,7680,3,198,3,198,0,0,3362.504667,9.003018,175.9410011,0,Benign
10.0.2.15,49552,119.254.87.201,80,11,1579,6,705,5,874,11094.44453,0.954423,5909.329511,7325.892188,Malicious
192.168.137.97,56174,172.217.161.14,443,19,6018,10,1443,9,4575,342.0768092,13.63418365,846.6953577,2684.429149,Benign
192.168.137.97,59386,34.205.118.138,443,9,598,5,338,4,260,4064.007752,96.27104867,28.08736414,21.60566472,Benign
172.30.6.255,56927,52.192.95.113,80,15,2817,8,1839,7,978,1386.864875,66.154076,222.389925,118.2693565,Benign
172.30.15.1893,51205,52.84.108.203,443,17,6849,8,1087,9,5762,3976.976389,0.31461,27640.57087,146517.9111,Benign
172.30.6.255,57630,103.243.221.46,80,42,33531,13,5437,29,28094,3450.904604,46.164269,942.2005578,4868.527215,Benign
172.30.6.255,57231,151.101.194.133,80,10,1099,6,547,4,552,2183.420332,60.633538,72.1712792,72.83098011,Benign
10.0.2.15,59321,119.254.87.201,80,11,1579,6,705,5,874,3311.808441,1.767307,3191.296136,3956.301876,Malicious
172.30.6.255,56716,103.243.220.231,80,7,394,4,228,3,166,1171.092014,19.92366,91.54944423,66.65441992,Benign
192.168.43.233,51527,172.217.161.5,443,11,643,6,349,5,294,4002.267153,59.402153,47.00166339,39.59452446,Benign
192.168.43.233,51176,172.217.161.1,443,21,5331,9,827,12,4504,563.478399,1.451056,4559.438092,24831.57094,Benign
172.30.15.1518,50826,52.84.102.103,443,29,6604,15,4812,14,1792,3525.737811,11.243951,3423.707556,1274.996663,Benign
10.0.2.15,59247,119.254.87.201,80,11,1569,6,705,5,864,11152.00276,1.443597,3906.907537,4788.039875,Malicious
192.168.215.49,41194,54.86.213.171,443,34,10880,16,2425,18,8455,550.9844318,60.95405024,318.2725336,1109.688359,Benign
172.30.6.255,57845,103.243.221.109,80,15,5833,9,4205,6,1628,4205.856711,3.527106,9537.564224,3692.545673,Benign
172.30.1.136,50338,172.217.161.3,443,28,3102,13,2072,15,1030,596.188353,19.369149,855.7939226,425.4187936,Benign
172.30.15.1614,50924,161.202.1.35,443,17,5746,9,1577,8,4169,3573.953174,3.224808,3912.170895,10342.32116,Benign
172.30.15.1202,50510,72.247.228.146,80,10,2332,6,1463,4,869,3465.528647,1.672207,6999.13348,4157.380037,Benign
172.30.6.255,56475,52.114.76.35,443,33,22147,21,15092,12,7055,777.577088,9.168784,13168.15839,6155.669061,Benign
192.168.137.97,39646,216.58.196.194,443,46,9922,22,3038,24,6884,2.477189148,240.4360005,101.0830323,229.0505577,Benign
10.0.2.15,47729,119.254.87.201,80,13,1730,8,853,5,877,7998.931425,13.058555,522.5693042,537.2723092,Malicious
10.0.2.15,42140,119.254.87.201,80,12,1587,7,779,5,808,22236.89276,4.478771,1391.453146,1443.253071,Malicious
10.0.2.15,51454,119.254.87.201,80,11,1579,6,705,5,874,2831.279513,1.576218,3578.185251,4435.934623,Malicious
172.30.6.255,57800,69.173.144.142,80,6,348,4,228,2,120,4042.521026,22.49223,81.09467136,42.68140598,Benign
172.30.15.815,50112,34.232.42.95,443,21,9748,12,2706,9,7042,3037.712474,9.328207,2320.703218,6039.317095,Benign
192.168.137.97,34126,52.84.110.227,443,8,552,5,338,3,214,1754.582239,10.8557571,249.0844235,157.7043392,Benign
172.30.15.1146,50454,23.23.178.66,80,6,348,4,228,2,120,3458.451416,9.189463,198.4882033,104.4674754,Benign
172.30.15.2313,51642,52.55.184.84,443,127,100819,54,6221,73,94598,5034.107774,3.721025,13374.80936,203380.5202,Benign
192.168.43.224,37402,151.101.153.170,443,19,7851,11,1344,8,6507,31.73265177,12.21797437,880.0149418,4260.608055,Benign
172.30.6.255,56074,52.4.123.24,80,6,348,4,228,2,120,286.646145,17.605115,103.6062531,54.52960688,Benign
192.168.137.97,48994,172.217.194.189,443,237,42135,118,17538,119,24597,9491.514937,1214.485868,115.5254282,162.0241166,Benign
192.168.137.97,39778,172.217.161.14,443,64,12323,34,4510,30,7813,3775.582082,436.8186253,82.59721062,143.0891367,Benign
192.168.43.224,37510,157.240.16.20,443,33,8134,16,2025,17,6109,45.60093163,65.69134722,246.6078211,743.964039,Benign
172.30.6.255,58353,35.190.43.164,80,10,1703,6,1249,4,454,5442.086218,6.962775,1435.060016,521.6311025,Benign
10.0.2.15,55055,119.254.87.201,80,11,1579,6,705,5,874,16104.90197,2.04954,2751.836998,3411.497214,Malicious
10.0.2.15,48552,119.254.87.201,80,11,1513,6,705,5,808,24814.22744,0.822407,6857.918281,7859.855278,Malicious
192.168.42.240,50935,216.58.221.67,443,167,93834,74,8662,93,85172,160.287529,260.408984,266.1044905,2616.561032,Benign
192.168.43.233,51184,131.253.61.100,443,238,91336,115,33189,123,58147,634.761117,286.055069,928.1849153,1626.176392,Benign
172.30.1.136,50245,23.58.57.98,443,53,11369,27,6246,26,5123,437.947932,191.966456,260.2954758,213.4956328,Benign
172.30.6.255,58420,103.243.220.231,80,7,406,5,294,2,112,5571.881101,7.345602,320.1915922,121.9777494,Benign
172.30.6.255,56801,172.217.166.197,443,4571,2972240,1578,270884,2993,2701356,1264.882142,1784.173522,1214.608318,12112.5259,Benign
10.0.2.15,46198,119.254.87.201,80,11,1579,6,705,5,874,22537.21101,1.016351,5549.263985,6879.513082,Malicious
172.30.6.255,56885,104.122.118.96,80,24,4708,14,3575,10,1133,1384.516883,311.333743,91.86283415,29.11345206,Benign
10.0.2.15,51785,119.254.87.201,80,11,1544,6,705,5,839,21843.41038,1.031112,5469.822871,6509.477147,Malicious
192.168.137.97,41520,35.171.73.174,443,16,2543,9,1585,7,958,1955.982663,1.568737669,8082.932061,4885.456728,Benign
192.168.137.97,47612,157.240.16.39,443,32,5870,15,3082,17,2788,274.8495569,65.42085327,376.8828862,340.931047,Benign
192.168.137.97,46262,172.217.161.14,443,19,1317,9,606,10,711,21.27732818,195.1932159,24.83692877,29.14035703,Benign
172.30.15.1638,50948,184.29.25.7,443,683,622879,248,59782,435,563097,3575.552473,21.827145,21911.06533,206384.1148,Benign
172.30.15.2001,51313,104.113.220.53,443,17,7130,10,1219,7,5911,4079.550936,2.699325,3612.755041,17518.45369,Benign
172.30.6.255,56499,72.247.228.186,443,14,1391,8,904,6,487,821.722585,102.432395,70.60266432,38.0348424,Benign
172.30.15.1659,50970,184.29.25.7,443,285,240657,112,32795,173,207862,3587.458344,19.578888,13400.14816,84933.11775,Benign
172.30.15.877,50183,54.231.114.138,443,114,89937,43,3477,71,86460,3436.876375,8.941469,3110.89822,77356.41649,Benign
172.30.15.642,49929,192.0.73.2,80,13,2476,7,763,6,1713,2394.302254,1.858795,3283.847869,7372.518217,Benign
172.30.1.136,50426,52.84.103.186,443,3,198,3,198,0,0,833.405289,9.000123,175.9975947,0,Benign
10.0.2.15,55912,119.254.87.201,80,11,1579,6,705,5,874,8839.781043,1.856065,3038.686684,3767.109449,Malicious
172.30.15.1799,51111,180.149.59.203,443,3445,3213424,1254,81720,2191,3131704,3657.928032,5.566838,117438.3016,4500513.936,Benign
10.0.2.15,41627,119.254.87.201,80,11,1582,6,705,5,877,22987.67843,2.248462,2508.381285,3120.355158,Malicious
10.0.2.15,33688,119.254.87.201,80,12,1661,7,779,5,882,7580.541554,4.246698,1467.493097,1661.526202,Malicious
10.0.2.15,49087,119.254.87.201,80,11,1582,6,705,5,877,23498.26928,2.145317,2628.982104,3270.379156,Malicious
192.168.215.49,32910,172.217.161.19,443,84,13379,40,5551,44,7828,479.7802732,379.4510766,117.0322151,165.0384038,Benign
172.30.6.255,56305,103.243.221.17,80,51,35809,30,31445,21,4364,588.850687,17.189485,14634.52803,2031.009073,Benign
172.30.1.136,50658,52.94.220.15,443,34,8578,17,2050,17,6528,1782.216953,13.56158,1209.298622,3850.878732,Benign
192.168.137.97,48884,35.164.102.20,443,29,9901,16,2716,13,7185,128.4653584,78.34048244,277.3534107,733.7202709,Benign
172.30.1.136,50743,52.230.83.250,443,43,13109,23,7853,20,5256,1890.628197,75.272772,834.6178616,558.6083637,Benign
10.0.2.15,36861,119.254.87.201,80,11,1579,6,705,5,874,1089.180389,1.895182,2975.96748,3689.355429,Malicious
172.30.6.255,55611,157.240.16.39,443,4,293,2,108,2,185,57.099119,0.027803,31075.78319,53231.66565,Benign
10.0.2.15,41507,119.254.87.201,80,11,1513,6,705,5,808,12080.61159,1.483101,3802.842827,4358.435467,Malicious
192.168.215.49,54224,157.240.16.20,443,1728,1404734,671,56729,1057,1348005,118.2561919,76.9705142,5896.179916,140106.1187,Benign
192.168.43.224,43580,18.206.249.150,443,24,9135,13,2640,11,6495,1280.534043,2.200072429,9599.683957,23617.40428,Benign
172.30.6.255,56444,34.246.69.20,80,13,1520,7,914,6,606,700.568986,61.472633,118.9472395,78.86436229,Benign
10.0.2.15,47972,119.254.87.201,80,11,1579,6,705,5,874,12773.71893,2.018745,2793.814969,3463.53799,Malicious
10.0.2.15,41324,119.254.87.201,80,11,1579,6,705,5,874,3041.682335,1.718287,3282.338748,4069.168887,Malicious
172.30.15.1413,50721,35.201.123.46,443,27,4504,14,2688,13,1816,3500.145971,6.868821,3130.668276,2115.064579,Benign
172.30.6.255,57178,122.15.34.32,80,10,1221,6,705,4,516,2008.749813,60.033091,93.94818601,68.76207657,Benign
172.30.6.255,55689,205.185.216.10,443,7,402,4,228,3,174,44.027561,13.113131,139.0972148,106.1531376,Benign
192.168.43.224,48720,104.25.219.21,443,7,410,4,236,3,174,215.0886509,60.90152871,31.00086385,22.85656911,Benign
192.168.137.97,46256,103.102.166.240,443,14,984,8,536,6,448,19.69640533,16.19012178,264.8528564,221.3695516,Benign
172.30.15.1507,50815,184.29.26.86,443,42,30652,16,2226,26,28426,3521.722558,5.314938,3350.556488,42786.57625,Benign
172.30.1.136,50801,172.217.161.14,443,1,66,1,66,0,0,1935.377792,0,0,0,Benign
192.168.137.97,46916,157.240.16.16,443,382,80695,211,37407,171,43288,139.454029,1673.080235,178.8653011,206.9858891,Benign
172.30.15.699,49986,35.187.209.245,443,20,8738,10,1714,10,7024,2403.086521,3.221498,4256.40494,17442.81698,Benign
10.0.2.15,43493,119.254.87.201,80,11,1579,6,705,5,874,17156.11365,2.085899,2703.87013,3352.031906,Malicious
10.0.2.15,38507,119.254.87.201,80,11,1579,6,705,5,874,23883.15713,2.07335,2720.235368,3372.320158,Malicious
172.30.15.237,49506,23.198.126.238,443,17,6651,8,1323,9,5328,52.60655,0.652636,16217.3095,65310.52532,Benign
172.30.6.255,56055,52.76.32.254,443,28,9889,16,3309,12,6580,255.649145,69.16762,382.7224357,761.0497513,Benign
172.30.15.707,49994,151.139.104.66,80,26,18004,11,961,15,17043,2403.560099,2.728829,2817.325673,49964.28871,Benign
10.0.2.15,42653,119.254.87.201,80,11,1579,6,705,5,874,16647.66037,1.536509,3670.658616,4550.575363,Malicious
10.0.2.15,57028,119.254.87.201,80,12,1656,7,779,5,877,21996.65597,4.118029,1513.345341,1703.727681,Malicious
172.30.15.2451,51785,14.139.45.128,80,10,1412,5,673,5,739,5420.575302,0.227151,23702.29495,26026.73992,Benign
172.30.15.2432,51766,14.139.45.128,443,3,198,3,198,0,0,5407.723202,9.021716,175.5763538,0,Benign
192.168.215.49,60762,172.217.167.46,443,21,6142,11,1509,10,4633,901.9669128,95.8673978,125.9239353,386.6173574,Benign
172.30.6.255,57015,103.243.221.51,80,16,5443,9,4215,7,1228,1522.836677,12.095188,2787.885562,812.2238365,Benign
192.168.43.224,45500,54.173.101.22,443,36,7925,18,2889,18,5036,52.54211228,71.93928496,321.2709163,560.0278071,Benign
192.168.43.224,54932,54.85.227.48,443,32,7061,16,2201,16,4860,361.273958,62.18793865,283.1417214,625.2016202,Benign
172.30.15.1858,51170,104.31.84.161,443,121,61774,59,5423,62,56351,3908.550902,8.7354,4966.458319,51607.02429,Benign
172.30.6.255,56695,103.243.221.46,80,6,340,4,228,2,112,1156.092128,13.551632,134.596335,66.11749788,Benign
192.168.137.97,35394,104.198.143.177,80,11,977,6,491,5,486,8723.81493,1.741104461,2256.039249,2233.065326,Benign
192.168.43.224,41944,23.251.156.28,443,454,363822,192,19333,262,344489,1027.43117,198.592693,778.800054,13877.20746,Benign
172.30.6.255,55980,54.149.211.44,80,6,348,4,228,2,120,176.330612,37.804984,48.24760672,25.39347722,Benign
172.30.15.473,49748,23.9.250.106,443,177,100103,73,11765,104,88338,1725.483192,10.140767,9281.349231,69689.40318,Benign
10.0.2.15,36714,119.254.87.201,80,11,1560,6,705,5,855,4935.738431,1.616723,3488.538234,4230.780412,Malicious
10.0.2.15,55273,119.254.87.201,80,11,1568,6,705,5,863,11452.3893,1.49386,3775.454192,4621.584352,Malicious
192.168.43.224,51740,14.139.116.24,443,11,750,6,404,5,346,1573.785365,61.50978391,52.54448633,45.00097097,Benign
172.30.15.2181,51493,77.88.21.119,443,11,1342,6,904,5,438,4261.921073,6.360266,1137.059362,550.9203546,Benign
192.168.215.49,56130,104.197.3.80,80,10,911,5,425,5,486,58.73617526,0.795333226,4274.93771,4888.517005,Benign
192.168.137.97,48364,172.217.194.189,443,18,5584,10,1443,8,4141,3522.710506,13.51142723,854.3879045,2451.850528,Benign
192.168.43.233,50915,83.231.173.69,443,7,394,4,228,3,166,372.154574,26.798026,68.06471492,49.55588893,Benign
172.30.15.1772,51084,35.201.87.190,443,48,16791,22,4618,26,12173,3641.638316,5.530962,6679.489029,17607.06365,Benign
10.0.2.15,49206,119.254.87.201,80,11,1579,6,705,5,874,25628.16027,2.020354,2791.589989,3460.779646,Malicious
172.30.15.801,50093,52.84.108.164,443,11,1345,6,907,5,438,2680.204769,6.009504,1207.420779,583.076407,Benign
172.30.6.255,56176,52.213.19.114,443,19,6444,10,1207,9,5237,435.97973,29.646211,325.707727,1413.199144,Benign
10.0.2.15,39241,119.254.87.201,80,11,1579,6,705,5,874,1509.650835,1.679409,3358.324268,4163.369376,Malicious
172.30.6.255,56624,172.30.6.35,445,3,198,3,198,0,0,990.367606,9.008859,175.8269277,0,Benign
172.30.6.255,56018,139.162.30.99,443,7,402,4,228,3,174,228.151785,1.373987,1327.523477,1013.110022,Benign
10.0.2.15,56151,119.254.87.201,80,11,1559,6,705,5,854,9412.480367,1.160781,4858.797654,5885.692478,Malicious
192.168.43.233,51005,104.244.42.2,443,136,19070,74,9744,62,9326,532.887466,1123.332528,69.39352156,66.41666483,Benign
192.168.43.233,51344,35.156.121.57,443,25,8559,14,1950,11,6609,3389.161278,26.179186,595.8932413,2019.619709,Benign
192.168.137.97,46620,103.229.206.27,443,6,412,4,272,2,140,376.6589455,14.29646423,152.205466,78.34104869,Benign
10.0.2.15,44197,119.254.87.201,80,11,1582,6,705,5,877,9863.076673,1.970084,2862.822093,3561.269469,Malicious
172.30.15.1270,50578,67.202.94.86,80,6,535,4,228,2,307,3469.543777,8.187169,222.7876327,299.9815931,Benign
192.168.215.49,59890,54.148.63.115,443,14,1660,8,1080,6,580,517.1946154,13.27222909,650.9833384,349.6021632,Benign
192.168.43.224,45044,157.240.16.52,443,32,9985,15,1982,17,8003,2274.434077,65.71503376,241.2842099,974.2671705,Benign
192.168.137.97,50654,192.168.121.7,443,13,1611,7,1039,6,572,2962.844601,32.69446731,254.2326174,139.9625189,Benign
192.168.43.233,51278,34.225.100.237,443,11,633,6,339,5,294,2001.931855,153.380371,17.6815324,15.33442633,Benign
172.30.6.255,56758,23.198.126.238,443,17,6691,8,1318,9,5373,1244.684138,0.797078,13228.31643,53926.96825,Benign
172.30.6.255,55736,13.228.141.18,80,10,1324,6,804,4,520,58.294527,0.368046,17476.07636,11302.93496,Benign
192.168.215.49,38486,158.85.224.176,443,7,478,4,272,3,206,18.0565328,53.82942512,40.42398735,30.61522571,Benign
10.0.2.15,41085,119.254.87.201,80,11,1582,6,705,5,877,24396.64411,1.047187,5385.85754,6699.85399,Malicious
172.30.6.255,55685,35.186.241.238,80,14,3371,8,875,6,2496,42.503518,16.107296,434.5856685,1239.686661,Benign
10.0.2.15,55504,119.254.87.201,80,11,1582,6,705,5,877,13466.78325,2.152459,2620.258969,3259.527824,Malicious
10.0.2.15,57722,119.254.87.201,80,11,1582,6,705,5,877,909.036412,1.885098,2991.886894,3721.82242,Malicious
172.30.15.2339,51673,52.229.168.53,443,31,10753,18,2416,13,8337,5223.570866,86.857663,222.5249832,767.8769805,Benign
172.30.1.136,51759,13.107.4.52,80,13,2451,6,459,7,1992,2945.378008,2.853165,1286.991814,5585.37624,Benign
10.0.2.15,52588,119.254.87.201,80,11,1582,6,705,5,877,5868.798588,1.630084,3459.944396,4304.072674,Malicious
172.30.6.255,57618,157.240.16.39,443,19,1933,10,1125,9,808,3412.09773,61.060913,147.3938,105.8615026,Benign
172.30.6.255,56404,151.101.2.49,80,6,348,4,228,2,120,651.572634,25.470796,71.6114251,37.69022374,Benign
10.0.2.15,60602,119.254.87.201,80,11,1579,6,705,5,874,12475.71132,1.623507,3473.960999,4306.726118,Malicious
10.0.2.15,44393,119.254.87.201,80,12,1642,7,779,5,863,19353.8158,4.012437,1553.170804,1720.650069,Malicious
172.30.15.1449,50757,103.231.98.244,443,13,1142,8,860,5,282,3502.038663,0.85117,8082.991647,2650.469354,Benign
172.30.6.255,58519,157.240.16.17,443,12,1688,7,971,5,717,5770.957385,8.069972,962.5807871,710.7831353,Benign
10.0.2.15,35360,119.254.87.201,80,11,1579,6,705,5,874,21753.31933,0.986218,5718.816732,7089.710389,Malicious
172.30.6.255,56993,192.168.56.1,7680,3,198,3,198,0,0,1476.617683,9.018226,175.6443008,0,Benign
192.168.43.224,36874,169.55.74.36,443,7,478,4,272,3,206,1460.152949,30.68777822,70.90770743,53.70216078,Benign
10.0.2.15,39538,119.254.87.201,80,11,1587,6,705,5,882,14125.05517,1.708622,3300.905642,4129.643654,Malicious
172.30.15.2109,51421,52.30.52.254,443,6,348,4,228,2,120,4146.440366,1.179748,1546.092894,813.7331023,Benign
192.168.137.97,57490,72.247.219.151,443,14,1667,8,1080,6,587,348.5608185,15.17825121,569.2355385,309.3900566,Benign
192.168.137.97,57770,169.60.79.147,443,10,692,6,412,4,280,8332.126139,39.36953245,83.71956168,56.89678949,Benign
172.30.1.136,51888,52.84.110.171,443,11,644,6,350,5,294,4531.32128,121.917115,22.96642272,19.29179509,Benign
172.30.6.255,56240,172.217.166.206,443,17,1783,10,1154,7,629,506.499266,103.711247,89.01638219,48.5193279,Benign
172.30.15.1098,50404,50.7.74.138,443,23,8916,12,1932,11,6984,3453.748415,5.37918,2873.300392,10386.71322,Benign
192.168.42.240,50909,146.185.181.89,80,10,542,5,272,5,270,10.580769,98.069976,22.18823832,22.02508951,Benign
192.168.137.97,46324,172.217.160.227,443,19,2408,14,1772,5,636,3761.393677,86.69542806,163.5149663,58.68821591,Benign
172.30.15.202,49443,204.79.197.200,443,1,54,1,54,0,0,1.079126,0,0,0,Benign
172.30.15.582,49867,14.139.45.149,80,79,58755,38,2713,41,56042,2298.600125,3.547333,6118.399372,126386.7813,Benign
192.168.137.97,39736,192.168.125.6,80,13,1969,7,1083,6,886,8296.5519,3.353242851,2583.76753,2113.774729,Benign
172.30.6.255,56293,34.226.179.16,443,21,6120,12,1771,9,4349,569.402157,63.399272,223.4725976,548.7760175,Benign
192.168.137.97,46544,151.101.193.170,443,19,7863,11,1356,8,6507,382.7901939,17.02398865,637.2184701,3057.802791,Benign
192.168.137.97,58658,192.229.237.96,443,350,309121,123,9316,227,299805,1153.308246,180.1108673,413.7895793,13316.46466,Benign
192.168.137.97,56178,172.217.161.14,443,19,6017,10,1443,9,4574,342.0769696,13.63396473,846.7089527,2683.885481,Benign
172.30.6.255,56180,103.243.221.75,80,86,65952,52,57659,34,8293,464.865536,26.172176,17624.5185,2534.905772,Benign
172.30.15.381,49649,62.210.213.13,80,16,5467,9,1314,7,4153,1455.37167,5.168915,2033.69566,6427.654546,Benign
192.168.137.97,41242,184.29.25.22,443,62,27540,30,4045,32,23495,128.3594808,551.7626505,58.6484061,340.653721,Benign
10.0.2.15,54194,119.254.87.201,80,11,1579,6,705,5,874,17849.04122,2.069314,2725.540928,3378.897548,Malicious
10.0.2.15,42696,119.254.87.201,80,11,1582,6,705,5,877,488.57602,4.669763,1207.770073,1502.431708,Malicious
10.0.2.15,49222,119.254.87.201,80,11,1582,6,705,5,877,8089.057361,1.049426,5374.366558,6685.559534,Malicious
172.30.1.136,51768,52.114.75.78,443,23,8027,12,3225,11,4802,2957.494849,2.344522,11004.37531,16385.42952,Benign
172.30.15.1474,50782,54.164.214.76,443,19,6466,10,1638,9,4828,3509.300044,8.163554,1605.183233,4731.272679,Benign
172.30.6.255,58486,180.149.59.210,80,13,4950,8,3669,5,1281,5682.992474,6.043222,4857.011707,1695.784136,Benign
192.168.215.49,57020,108.179.217.142,443,688,582106,289,22234,399,559872,1305.920507,104.6522024,1699.648893,42798.67883,Benign
192.168.43.233,51344,139.59.72.43,443,66,29332,31,7073,35,22259,3082.824786,189.198976,299.0713861,941.1890263,Benign
172.30.6.255,58140,157.240.16.20,443,113,52768,62,6105,51,46663,4919.277385,9.656638,5057.660855,38657.7606,Benign
172.30.1.136,50517,54.229.103.82,443,34,11136,18,4136,16,7000,1023.675131,3.652863,9058.100454,15330.44081,Benign
172.30.15.773,50064,184.85.113.82,443,25,9310,12,1254,13,8056,2648.509065,62.022235,161.7484439,1039.111216,Benign
192.168.43.233,51274,34.225.100.237,443,21,7744,10,1195,11,6549,1989.938024,13.557871,705.1254581,3864.323536,Benign
10.0.2.15,49687,119.254.87.201,80,11,1579,6,705,5,874,11001.807,1.352881,4168.881077,5168.229874,Malicious
172.30.15.1970,51282,157.240.16.39,443,15,4922,8,1025,7,3897,4076.492752,0.756083,10845.37015,41233.56827,Benign
172.30.15.1537,50845,85.159.213.174,443,71,33068,33,3809,38,29259,3530.805441,6.312874,4826.961539,37078.51606,Benign
172.30.6.255,57977,52.175.39.99,443,24,9380,12,2455,12,6925,4691.238705,1.510621,13001.27563,36673.65938,Benign
172.30.15.2085,51397,64.74.232.52,443,6,348,4,228,2,120,4123.58668,4.060917,449.1596356,236.3998082,Benign
172.30.6.255,56096,72.247.228.146,80,9,534,5,294,4,240,305.825065,18.048839,130.3130911,106.3780335,Benign
172.30.1.136,50758,23.9.209.92,443,26,9126,12,1695,14,7431,1906.796965,2.628436,5158.961451,22617.25224,Benign
172.30.1.136,50571,122.15.34.32,80,15,1332,8,683,7,649,1563.17006,98.515609,55.46329212,52.70230832,Benign
172.30.15.1336,50644,13.232.120.220,443,6,340,4,228,2,112,3490.042494,6.976603,261.4452908,128.4292656,Benign
172.30.1.136,50315,157.240.16.35,443,25,5813,7,971,18,4842,567.153539,132.213744,58.75334716,292.9801307,Benign
192.168.43.224,36686,169.55.74.36,443,7,478,4,272,3,206,370.9643904,19.36809884,112.3496951,85.08837204,Benign
192.168.43.224,42034,23.251.156.28,443,404,288681,200,20388,204,268293,1431.481312,327.102113,498.6332816,6561.694086,Benign
192.168.43.224,57402,34.196.177.243,443,30,5258,16,3356,14,1902,3133.702589,12.28130591,2186.086741,1238.956192,Benign
192.168.215.49,46394,223.31.160.67,443,20,4919,10,1819,10,3100,293.048756,17.23856371,844.1538543,1438.634936,Benign
10.0.2.15,42100,119.254.87.201,80,11,1579,6,705,5,874,14152.78297,2.542391,2218.38419,2750.167067,Malicious
10.0.2.15,36075,119.254.87.201,80,11,1582,6,705,5,877,18867.69225,8.098797,696.3997246,866.3015013,Malicious
192.168.42.240,50982,13.35.130.79,443,12,696,7,402,5,294,296.215555,31.720454,101.3856863,74.14774076,Benign
172.30.6.255,56251,31.172.81.158,80,25,4366,14,2136,11,2230,529.95165,217.33273,78.62598514,82.08611745,Benign
172.30.15.1301,50609,204.79.197.200,443,21,10081,10,1174,11,8907,3473.419525,3.531316,2659.631707,20178.31313,Benign
10.0.2.15,37926,119.254.87.201,80,11,1579,6,705,5,874,24096.35963,1.182755,4768.527717,5911.621595,Malicious
192.168.43.224,43822,74.125.68.188,443,14,4970,8,1005,6,3965,1221.868456,0.362324697,22190.04133,87545.78493,Benign
10.0.2.15,35186,119.254.87.201,80,11,1579,6,705,5,874,608.657376,1.748301,3225.989117,3999.311331,Malicious
10.0.2.15,37735,119.254.87.201,80,11,1582,6,705,5,877,4993.52211,0.894435,6305.656644,7844.057981,Malicious
172.30.6.255,56712,103.243.220.231,80,16,5452,9,4225,7,1227,1170.840165,20.175412,1675.306556,486.5328153,Benign
172.30.15.2068,51380,157.240.16.39,443,27,5046,13,3360,14,1686,4120.559106,6.799141,3953.440589,1983.78001,Benign
172.30.6.255,56532,23.198.119.247,443,21,9775,11,1312,10,8463,832.126241,41.459733,253.1613023,1633.006175,Benign
172.30.1.136,50463,52.94.220.15,443,41,9451,17,2130,24,7321,877.138729,116.75732,145.9437404,501.6216542,Benign
10.0.2.15,58160,119.254.87.201,80,11,1579,6,705,5,874,5748.713674,1.496169,3769.627629,4673.268862,Malicious
192.168.43.224,35770,172.217.167.54,443,11,746,7,478,4,268,40.57681064,18.89764978,202.3532051,113.4532614,Benign
192.168.43.233,51197,157.240.16.39,443,9,511,5,283,4,228,1160.898727,55.396857,40.86874459,32.92605571,Benign
192.168.215.49,41364,104.113.219.221,443,27,7956,14,2397,13,5559,620.1241362,70.12030043,273.4728728,634.224322,Benign
172.30.6.255,56998,103.243.221.51,80,40,26804,17,8922,23,17882,1483.851424,14.17698,5034.640664,10090.72454,Benign
192.168.43.233,51113,144.2.1.1,443,5,294,3,174,2,120,919.721617,19.442709,71.59496138,49.37583544,Benign
172.30.6.255,57100,115.114.126.194,443,16,6794,9,1108,7,5686,1770.650034,10.467244,846.8322703,4345.747553,Benign
172.30.1.136,51882,23.57.218.72,443,21,8944,10,1008,11,7936,4419.107749,60.436257,133.4298383,1050.495235,Benign
172.30.6.255,57928,103.243.221.17,80,26,14149,11,5339,15,8810,4499.885258,27.179289,1571.490704,2593.150983,Benign
172.30.15.1801,51113,52.37.171.77,443,36,5533,19,4120,17,1413,3672.787186,14.587789,2259.423961,774.8946739,Benign
10.0.2.15,42910,119.254.87.201,80,11,1513,6,705,5,808,793.213316,1.025397,5500.308661,6303.899855,Malicious
172.30.6.255,57926,103.243.220.231,80,27,16953,11,4334,16,12619,4488.858181,11.202659,3094.979504,9011.432018,Benign
192.168.43.233,51221,157.240.16.39,443,7,402,4,228,3,174,1282.594582,36.345724,50.18472049,38.29886564,Benign
192.168.43.224,33964,52.84.108.93,443,15,1720,8,1106,7,614,2882.727253,13.34952189,662.7952727,367.9532527,Benign
192.168.43.233,51369,117.18.237.66,443,33,10360,16,3857,17,6503,3470.720153,181.833865,169.6933627,286.1073211,Benign
192.168.42.240,51034,172.217.194.188,5228,24,4938,12,3124,12,1814,608.35585,7.155031,3492.926865,2028.223218,Benign
192.168.43.224,58486,52.24.249.177,443,33,7615,18,5588,15,2027,93.12130706,81.53083447,548.3078923,198.8940762,Benign
192.168.43.224,43846,52.84.108.114,443,20,7196,12,1451,8,5745,28.81487879,13.00280302,892.7305893,3534.622492,Benign
172.30.1.136,50408,52.84.103.186,443,540,341454,248,18169,292,323285,821.365107,188.187392,772.379055,13743.10985,Benign
172.30.6.255,56469,176.34.147.227,443,20,6499,10,1196,10,5303,764.015423,54.753153,174.7479273,774.8229586,Benign
192.168.137.97,45874,54.85.227.48,443,6,412,4,272,2,140,16.36632307,1.03045103,2111.696662,1086.902693,Benign
172.30.15.872,50178,180.149.59.139,80,15,7197,7,819,8,6378,3435.215685,1.827999,3584.247037,27912.48792,Benign
172.30.15.2089,51401,157.240.16.39,443,37,6811,18,4654,19,2157,4140.909819,6.965605,5345.120776,2477.315323,Benign
192.168.137.97,53284,52.222.190.164,443,23,8439,13,1662,10,6777,306.6182585,10.91752029,1217.858969,4965.962836,Benign
172.30.15.1073,50379,162.210.197.200,80,12,1398,7,927,5,471,3452.75136,1.465217,5061.366337,2571.632734,Benign
10.0.2.15,47534,119.254.87.201,80,11,1582,6,705,5,877,26439.16321,2.084104,2706.198923,3366.434688,Malicious
10.0.2.15,39110,119.254.87.201,80,11,1582,6,705,5,877,10488.88445,1.350599,4175.924904,5194.732115,Malicious
172.30.6.255,57316,103.243.221.51,80,16,5472,9,4245,7,1227,2467.839257,43.187797,786.333232,227.2864254,Benign
172.30.6.255,57201,103.243.221.75,80,34,21298,14,7757,20,13541,2087.850248,12.175825,5096.656695,8896.974127,Benign
192.168.43.224,38208,140.98.193.112,443,98,72154,42,6105,56,66049,2279.838051,11.27243153,4332.694315,46874.71365,Benign
10.0.2.15,38131,119.254.87.201,80,11,1579,6,705,5,874,24339.08189,1.059031,5325.62314,6602.261879,Malicious
172.30.6.255,57560,103.243.221.51,80,70,48828,41,40784,29,8044,3253.844985,28.222954,11560.51914,2280.129855,Benign
10.0.2.15,56777,119.254.87.201,80,11,1579,6,705,5,874,18242.61717,4.033409,1398.320874,1733.521198,Malicious
10.0.2.15,36955,119.254.87.201,80,11,1579,6,705,5,874,10701.57458,0.857367,6578.27978,8155.200748,Malicious
10.0.2.15,56964,119.254.87.201,80,11,1569,6,705,5,864,22531.69623,0.893088,6315.16715,7739.438891,Malicious
172.30.6.255,57288,103.243.220.231,80,17,5527,9,4245,8,1282,2346.841367,23.210397,1463.137403,441.8709426,Benign
172.30.6.255,56894,198.8.71.209,80,9,2852,5,1636,4,1216,1385.173881,10.337045,1266.125861,941.0813245,Benign
172.30.15.1818,51130,172.25.10.63,7680,3,198,3,198,0,0,3744.872885,9.000619,175.9878959,0,Benign
10.0.2.15,51501,119.254.87.201,80,11,1582,6,705,5,877,13797.25785,1.318369,4278.013212,5321.727073,Malicious
192.168.43.233,51221,23.32.125.203,80,17,6018,9,972,8,5046,1536.96035,308.468558,25.2084039,130.8658499,Benign
192.168.42.240,50945,216.58.221.46,443,13,750,7,402,6,348,178.842113,32.724532,98.27489664,85.07379112,Benign
172.30.15.268,49531,172.217.166.197,443,48,13454,23,4923,25,8531,114.537467,5.038591,7816.470914,13545.05654,Benign
172.30.6.255,58303,157.240.16.17,443,15,4921,8,1025,7,3896,5326.657613,7.294343,1124.158817,4272.900246,Benign
172.30.6.255,55910,52.212.169.136,80,6,348,4,228,2,120,121.805968,30.219857,60.35766483,31.76719202,Benign
172.30.6.255,57631,103.243.221.46,80,25,13978,10,5275,15,8703,3450.90493,46.163155,914.1489571,1508.215805,Benign
10.0.2.15,54409,119.254.87.201,80,11,1582,6,705,5,877,5744.127114,1.619701,3482.12417,4331.663684,Malicious
172.30.15.1254,50562,172.217.167.2,80,8,468,5,282,3,186,3469.524156,7.982617,282.6140851,186.4050348,Benign
10.0.2.15,37501,119.254.87.201,80,11,1579,6,705,5,874,24246.46914,1.279609,4407.596383,5464.169133,Malicious
10.0.2.15,44976,119.254.87.201,80,11,1579,6,705,5,874,1213.685379,4.696192,1200.973044,1488.865873,Malicious
172.30.6.255,57916,216.239.32.62,443,41,7446,20,2387,21,5059,4448.034636,240.370567,79.44400281,168.37336,Benign
172.30.6.255,57241,103.243.221.87,80,40,24215,23,20068,17,4147,2205.117716,20.912882,7676.7994,1586.390628,Benign
192.168.43.224,47728,184.50.97.22,443,9,618,5,338,4,280,106.5024578,68.30298146,39.5883158,32.79505451,Benign
172.30.6.255,57407,176.34.147.227,443,18,6378,9,1141,9,5237,2730.390781,40.434432,225.748194,1036.146619,Benign
10.0.2.15,37713,119.254.87.201,80,11,1582,6,705,5,877,16224.98568,2.72164,2072.279949,2577.857468,Malicious
10.0.2.15,42820,119.254.87.201,80,11,1579,6,705,5,874,943.449749,1.225445,4602.409737,5705.682426,Malicious
172.30.6.255,56495,184.29.26.80,80,12,2526,7,617,5,1909,820.135819,61.078317,80.81427653,250.0396335,Benign
172.30.15.2519,51853,23.61.93.124,443,13,5033,7,1033,6,4000,5488.072866,0.25869,31945.57192,123700.1817,Benign
172.30.15.289,49552,192.0.78.13,443,6,348,4,228,2,120,392.769547,2.122322,859.4360328,452.3347541,Benign
172.30.15.2393,51727,14.139.45.128,80,55,44065,22,1621,33,42444,5340.085555,0.369304,35114.70225,919437.6449,Benign
172.30.15.1140,50448,13.232.120.220,80,10,1468,6,955,4,513,3458.309873,8.874193,860.9233538,462.4645869,Benign
10.0.2.15,35198,119.254.87.201,80,11,1579,6,705,5,874,22597.30989,2.654531,2124.669104,2633.986945,Malicious
10.0.2.15,57966,119.254.87.201,80,11,1579,6,705,5,874,7695.973296,2.801408,2013.273325,2495.887782,Malicious
192.168.43.233,51061,49.44.148.176,443,6,348,3,174,3,174,892.199776,15.708451,88.61472083,88.61472083,Benign
10.0.2.15,45018,119.254.87.201,80,11,1579,6,705,5,874,25174.63529,4.601976,1225.560498,1519.347341,Malicious
172.30.1.136,51805,157.240.16.39,443,26,6331,9,1660,17,4671,2977.739466,143.48465,92.55345432,260.4320392,Benign
172.30.15.1348,50656,13.232.120.220,443,6,340,4,228,2,112,3492.272376,4.746403,384.2910094,188.7745309,Benign
192.168.43.224,38898,54.77.4.53,443,43,9938,22,2589,21,7349,1301.206796,124.4077543,166.4847992,472.5750442,Benign
10.0.2.15,33750,119.254.87.201,80,11,1513,6,705,5,808,23462.68381,4.131058,1365.267687,1564.732328,Malicious
10.0.2.15,44872,119.254.87.201,80,11,1513,6,705,5,808,10819.20714,1.216524,4636.160076,5313.499775,Malicious
172.30.15.204,49484,172.217.194.189,443,31,9052,16,3585,15,5467,6.216586,3.229738,8879.977261,13541.6557,Benign
172.30.1.136,51875,52.84.110.171,443,43,9376,21,5972,22,3404,4204.775957,138.354069,345.3169129,196.8283275,Benign
172.30.6.255,56201,103.243.221.17,443,28,13546,14,5695,14,7851,467.047777,23.794585,1914.721354,2639.592159,Benign
192.168.43.224,35048,34.232.42.95,443,70,45373,34,4983,36,40390,3040.47173,3.700948469,10771.29291,87307.3491,Benign
192.168.215.49,60640,52.204.146.6,443,24,5583,13,1509,11,4074,556.0789182,78.20243148,154.3686017,416.7645351,Benign
192.168.215.49,55976,111.119.15.0,443,3102,2613892,1278,94847,1824,2519045,560.1722343,23.84158247,31825.7398,845261.0068,Benign
192.168.43.224,37408,151.101.153.170,443,19,7851,11,1344,8,6507,32.16269623,11.78610985,912.2602906,4416.724487,Benign
10.0.2.15,35981,119.254.87.201,80,11,1579,6,705,5,874,24907.31042,2.020546,2791.324721,3460.450789,Malicious
172.30.6.255,56381,103.243.221.75,80,15,5023,9,3849,6,1174,648.896986,28.167792,1093.163426,333.4304655,Benign
172.30.6.255,57358,103.243.221.17,80,32,16180,15,8623,17,7557,2527.858087,34.189046,2017.722285,1768.285667,Benign
172.30.6.255,58461,161.69.17.34,443,3,198,3,198,0,0,5657.332834,9.001072,175.9790389,0,Benign
192.168.43.233,51116,172.217.31.10,443,9,575,4,218,5,357,11.062277,57.608149,30.27349481,49.57631949,Benign
172.30.6.255,57857,119.42.60.92,80,11,1676,6,807,5,869,4225.829015,51.142421,126.2357134,135.9341201,Benign
172.30.6.255,55859,54.169.196.206,443,22,8680,12,2305,10,6375,105.026329,61.359402,300.5244412,831.1684654,Benign
10.0.2.15,52431,119.254.87.201,80,11,1579,6,705,5,874,6046.78337,1.955351,2884.392623,3575.828585,Malicious
172.30.6.255,57478,103.243.220.231,80,26,11298,14,8484,12,2814,3005.840894,36.187937,1875.542118,622.0857519,Benign
172.30.15.422,49696,59.63.81.183,443,100,73095,41,3621,59,69474,1616.770962,4.095628,7072.907989,135703.7309,Benign
172.30.6.255,57982,23.61.87.106,443,2410,1887050,1140,71141,1270,1815909,4693.013308,9.376046,60700.21414,1549402.808,Benign
192.168.43.233,50724,157.240.16.16,443,23,3655,11,2246,12,1409,1846.235324,2.628569,6835.658489,4288.264832,Benign
172.30.6.255,55647,122.15.34.40,80,198,212154,47,6209,151,205945,36.774998,21.801824,2278.341482,75569.82388,Benign
10.0.2.15,35037,119.254.87.201,80,11,1579,6,705,5,874,16675.51749,1.268918,4444.731653,5510.206333,Malicious
192.168.43.224,54434,52.206.154.207,443,11,754,6,404,5,350,38.00430513,12.05098921,268.193751,232.3460714,Benign
192.168.137.97,42070,54.76.174.157,443,150,72127,79,59520,71,12607,3707.163953,283.1176539,1681.844963,356.2335256,Benign
10.0.2.15,56257,119.254.87.201,80,5,340,4,276,1,64,1904.463529,13.748091,160.6041159,37.24153412,Malicious
10.0.2.15,58197,119.254.87.201,80,11,1582,6,705,5,877,11902.75674,2.528856,2230.257476,2774.377031,Malicious
10.0.2.15,37224,119.254.87.201,80,11,1579,6,705,5,874,16260.11733,2.680629,2103.983804,2608.343042,Malicious
192.168.43.233,51308,172.217.166.206,443,79,33823,33,3787,46,30036,2535.532689,243.110342,124.6183101,988.3906954,Benign
172.30.6.255,57161,103.243.220.231,80,35,19320,16,9316,19,10004,1941.908105,20.120214,3704.135552,3977.691291,Benign
172.30.6.255,57540,210.176.156.62,80,38,19764,19,15036,19,4728,3147.862368,71.231967,1688.680028,530.9975506,Benign
10.0.2.15,42145,119.254.87.201,80,11,1579,6,705,5,874,18660.02324,1.552891,3631.935532,4502.569723,Malicious
192.168.137.97,40198,210.176.156.55,443,17,4668,10,1503,7,3165,349.8984205,13.85332436,867.9505143,1827.720145,Benign
10.0.2.15,38689,119.254.87.201,80,11,1513,6,705,5,808,12233.13261,1.421515,3967.59795,4547.261197,Malicious
10.0.2.15,57290,119.254.87.201,80,11,1568,6,705,5,863,102.523465,1.937382,2911.14504,3563.571872,Malicious
172.30.1.136,50412,52.84.103.186,443,95,38674,47,4202,48,34472,827.097614,192.608486,174.5302125,1431.795689,Benign
172.30.15.1089,50395,54.37.85.231,80,6,360,3,198,3,162,3453.038365,1.6263,973.9900387,796.9009408,Benign
192.168.43.233,51289,23.9.140.60,80,36,13485,18,11589,18,1896,2789.252355,67.306375,1377.462387,225.3575534,Benign
192.168.137.97,39754,192.168.125.6,80,20,5666,11,1296,9,4370,8302.291308,13.26764358,781.4499942,2634.981848,Benign
192.168.137.97,33042,185.199.110.153,80,9,626,6,412,3,214,71.66125678,17.27434397,190.8031938,99.10651328,Benign
192.168.137.97,55366,172.217.161.10,443,7,466,4,272,3,194,421.311679,45.41288434,47.91591707,34.1753232,Benign
172.30.15.1754,51066,184.29.25.7,443,35,20130,16,6272,19,13858,3638.200943,8.96757,5595.272744,12362.7694,Benign
192.168.43.233,51345,35.156.121.57,443,9,534,5,294,4,240,3389.174356,24.763903,94.97695093,77.53220484,Benign
172.30.15.887,50193,157.240.16.63,80,14,2056,8,1278,6,778,3438.057757,8.942914,1143.251517,695.970016,Benign
10.0.2.15,33933,119.254.87.201,80,11,1513,6,705,5,808,25417.90266,0.890157,6335.96096,7261.640362,Malicious
10.0.2.15,60657,119.254.87.201,80,11,1579,6,705,5,874,22417.11795,1.214653,4643.30142,5756.376512,Malicious
172.30.6.255,57054,103.243.221.75,80,40,24202,24,20109,16,4093,1663.837028,16.19559,9933.074374,2021.784943,Benign
10.0.2.15,35648,119.254.87.201,80,12,1656,7,779,5,877,14905.78401,3.895798,1599.672262,1800.914729,Malicious
172.30.15.1081,50387,50.7.74.138,80,10,1871,6,1120,4,751,3452.813076,4.671322,1918.086572,1286.145549,Benign
10.0.2.15,58537,119.254.87.201,80,11,1579,6,705,5,874,20011.45434,1.549891,3638.965579,4511.284987,Malicious
192.168.43.224,38988,23.9.182.234,443,26,7265,14,2056,12,5209,106.2671875,168.0963546,97.84864185,247.9054355,Benign
172.30.15.1876,51188,54.86.233.56,443,6,348,4,228,2,120,3965.294194,2.166527,841.900424,443.1054863,Benign
172.30.1.136,50619,52.30.87.88,443,10,660,3,198,7,462,1629.582397,23.822157,66.49271936,155.1496785,Benign
172.30.6.255,55858,103.243.221.75,443,21,7600,11,3121,10,4479,104.857239,16.381951,1524.116389,2187.285263,Benign
172.30.1.136,50145,23.58.57.98,443,45,17053,26,10171,19,6882,119.666073,245.895928,330.904219,223.8996003,Benign
172.30.6.255,55813,4.78.226.233,80,14,2902,8,1467,6,1435,91.141818,134.303085,87.38444095,85.47830454,Benign
172.30.15.1359,50667,13.228.208.99,443,32,10581,17,2841,15,7740,3493.177843,3.914684,5805.832604,15817.36866,Benign
172.30.6.255,57488,172.217.163.133,443,464,158973,208,41800,256,117173,3052.445091,1721.453,194.2545048,544.5306959,Benign
10.0.2.15,55359,119.254.87.201,80,11,1579,6,705,5,874,20071.53814,1.68057,3356.004213,4160.493166,Malicious
192.168.137.97,49952,74.125.68.188,5228,31,7041,19,2125,12,4916,4050.521904,165.7636112,102.5556808,237.2535186,Benign
10.0.2.15,60518,119.254.87.201,80,13,1727,8,853,5,874,17521.68903,10.032073,680.2183357,696.9646254,Malicious
192.168.137.97,57474,172.217.160.237,443,20,5719,11,1521,9,4198,23.90494911,10.81873639,1124.715453,3104.244228,Benign
172.30.15.689,49976,172.217.166.198,443,39,17423,19,3660,20,13763,2400.092529,6.074371,4820.252171,18125.99198,Benign
172.30.15.1608,50918,54.201.247.66,443,17,5125,10,1207,7,3918,3573.765628,3.206909,3010.999065,9773.897544,Benign
192.168.137.97,45436,52.220.16.13,443,42,15882,23,7357,19,8525,8.231772267,87.60901333,671.8030231,778.4587157,Benign
172.30.6.255,58183,157.240.16.39,443,160,120732,60,12246,100,108486,5041.332997,72.753658,1346.571467,11929.13214,Benign
172.30.6.255,56247,103.243.221.17,80,56,40403,34,35985,22,4418,529.130817,37.587106,7659.009449,940.3224606,Benign
10.0.2.15,59817,119.254.87.201,80,11,1579,6,705,5,874,6557.30504,1.952491,2888.617668,3581.066443,Malicious
192.168.137.97,39684,192.168.125.6,80,201,162587,94,6783,107,155804,8274.172254,17.21167297,3152.744076,72417.82957,Benign
172.30.6.255,56275,157.240.16.39,443,19,1933,10,1125,9,808,545.09327,61.034327,147.4580034,105.9076149,Benign
10.0.2.15,59393,119.254.87.201,80,12,1587,7,779,5,808,5658.597551,3.895355,1599.854185,1659.4123,Malicious
172.30.1.136,50775,151.101.129.181,443,53,22539,28,2864,25,19675,1921.277233,11.970724,1914.002862,13148.74522,Benign
192.168.215.49,49116,104.237.191.1,443,77,9350,38,5085,39,4265,1505.129189,348.973203,116.5705551,97.77255018,Benign
172.30.1.136,51816,74.125.68.188,5228,11,643,6,349,5,294,3015.523112,59.724567,46.74793205,39.38077944,Benign
192.168.43.224,48804,34.227.208.227,443,16,4997,9,1251,7,3746,361.4710907,44.1278109,226.7957507,679.1182112,Benign
172.30.6.255,57260,151.101.1.69,443,8,480,5,294,3,186,2252.357597,18.533798,126.9032931,80.28575686,Benign
192.168.43.224,50180,52.207.90.113,443,6,412,4,272,2,140,371.0629793,34.93446785,62.28805343,32.0600275,Benign
192.168.215.49,44192,172.217.161.5,443,54,10362,26,4460,28,5902,1589.048191,240.2457125,148.5146171,196.5321234,Benign
192.168.43.224,48428,104.237.191.1,443,28,5010,16,2949,12,2061,2909.096771,47.06038833,501.3133303,350.3583498,Benign
172.30.15.2273,51592,13.107.21.200,443,55,17885,26,8636,29,9249,4536.810096,10.745686,6429.370819,6885.740008,Benign
10.0.2.15,51006,119.254.87.201,80,11,1513,6,705,5,808,23765.92407,2.216628,2544.405286,2916.141094,Malicious
172.30.1.136,50418,172.217.161.14,443,32,4483,16,2631,16,1852,827.491908,3.966385,5306.5953,3735.391295,Benign
192.168.137.97,46598,172.217.161.14,443,23,1594,11,758,12,836,888.3870399,202.4948721,29.94643735,33.02799687,Benign
192.168.43.224,39118,52.84.108.11,443,31,8926,15,2254,16,6672,1150.946625,212.7734846,84.74740184,250.8583252,Benign
192.168.137.97,46338,172.217.160.227,443,28,6667,16,1871,12,4796,3792.428566,36.60618673,408.8926309,1048.128839,Benign
10.0.2.15,57129,119.254.87.201,80,11,1582,6,705,5,877,17066.00573,2.054707,2744.916915,3414.598772,Malicious
192.168.43.233,51367,204.79.197.229,443,39,11476,21,1981,18,9495,3201.962764,6.522936,2429.58079,11645.0629,Benign
10.0.2.15,37676,119.254.87.201,80,11,1582,6,705,5,877,14034.97668,1.225946,4600.528898,5722.927437,Malicious
172.30.6.255,57940,184.29.25.201,443,34,10865,18,3884,16,6981,4554.760253,219.120145,141.8034841,254.873873,Benign
172.30.6.255,56449,13.251.188.142,80,6,348,4,228,2,120,700.569805,10.290216,177.2557544,93.29250231,Benign
172.30.6.255,56138,172.217.166.206,443,35,5941,19,3730,16,2211,366.407989,64.046942,465.9082708,276.1724361,Benign
10.0.2.15,46397,119.254.87.201,80,11,1582,6,705,5,877,4332.855021,1.018194,5539.219441,6890.631844,Malicious
192.168.42.240,50951,172.217.163.101,443,12,696,6,348,6,348,179.625598,32.044558,86.87902639,86.87902639,Benign
172.30.1.136,50805,172.217.161.14,443,3,198,3,198,0,0,1938.859959,8.999977,176.0004498,0,Benign
172.30.6.255,56773,23.198.126.238,443,18,6437,8,1318,10,5119,1245.554664,0.881236,11965.01278,46471.09287,Benign
10.0.2.15,47220,119.254.87.201,80,11,1582,6,705,5,877,1964.544904,1.821888,3095.689746,3850.950223,Malicious
172.30.6.255,57589,172.217.163.133,443,17,1791,10,1162,7,629,3325.439602,103.048627,90.20983851,48.83131534,Benign
192.168.137.97,37672,172.217.194.189,443,19,5650,11,1509,8,4141,102.5587529,36.42657389,331.4064078,909.4459474,Benign
192.168.137.97,33038,185.199.110.153,80,20,4110,12,1181,8,2929,71.41258399,234.0525038,40.36701102,100.114289,Benign
172.30.15.1047,50353,210.176.156.55,443,33,18623,18,13906,15,4717,3447.843194,9.376525,11864.52337,4024.518678,Benign
10.0.2.15,52947,119.254.87.201,80,11,1579,6,705,5,874,16437.37041,1.047587,5383.801059,6674.385994,Malicious
10.0.2.15,59562,119.254.87.201,80,11,1569,6,705,5,864,24576.87434,2.282028,2471.485889,3028.884834,Malicious
10.0.2.15,58877,119.254.87.201,80,10,981,6,725,4,256,12265.50957,180.504435,32.13217448,11.34598161,Malicious
172.30.15.2411,51745,172.217.166.234,443,73,39412,38,3970,35,35442,5345.571731,2.60499,12191.98538,108843.4121,Benign
172.30.6.255,57277,103.243.220.231,80,23,10455,11,4324,12,6131,2298.86306,23.542782,1469.325078,2083.356164,Benign
172.30.6.255,58241,103.243.221.109,80,31,18282,13,5455,18,12827,5221.883369,37.674729,1158.336136,2723.735584,Benign
172.30.15.2029,51341,184.29.26.86,443,22,8140,12,2095,10,6045,4090.542653,6.81602,2458.912973,7095.049604,Benign
172.30.6.255,56010,139.162.30.99,443,20,8035,9,1742,11,6293,228.151552,0.459707,30314.96149,109513.2334,Benign
172.30.15.2493,51827,14.139.45.128,80,38,29953,14,1237,24,28716,5475.068982,0.619232,15981.08625,370988.5794,Benign
172.30.6.255,56977,103.243.220.231,80,37,25252,14,8039,23,17213,1436.861658,16.195184,3971.057075,8502.774652,Benign
172.30.15.1387,50695,184.29.24.49,443,42,31432,15,1968,27,29464,3495.664319,1.353817,11629.34134,174109.2038,Benign
192.168.137.97,37058,151.101.193.176,443,33,2243,17,1098,16,1145,9.087996588,554.1351342,15.85172904,16.53026389,Benign
192.168.137.97,51836,103.102.166.224,443,154,78415,77,9227,77,69188,5424.445469,223.3699456,330.465228,2477.969892,Benign
172.30.15.2539,51873,192.168.121.146,80,385,344870,149,9877,236,334993,5501.856057,2.195857,35984.12829,1220454.702,Benign
10.0.2.15,44890,119.254.87.201,80,11,1582,6,705,5,877,23973.2658,2.070679,2723.74424,3388.260566,Malicious
10.0.2.15,34087,119.254.87.201,80,11,1582,6,705,5,877,23222.45124,0.948976,5943.248301,7393.232284,Malicious
192.168.43.224,58606,172.217.166.206,443,51,9838,26,3569,25,6269,2190.038882,241.1796918,118.3847603,207.9445397,Benign
192.168.43.224,38492,140.98.193.112,443,24,9903,13,4100,11,5803,3265.824337,9.56922234,3427.655752,4851.38691,Benign
10.0.2.15,50085,119.254.87.201,80,11,1582,6,705,5,877,2174.723569,2.883095,1956.231064,2433.495948,Malicious
192.168.43.224,54254,23.60.211.179,443,6,412,4,272,2,140,962.8598117,14.99754213,145.0904409,74.67890342,Benign
172.30.1.136,50528,52.84.103.186,443,73,37747,32,3512,41,34235,1047.917454,188.356814,149.1637037,1454.048803,Benign
172.30.6.255,55635,117.18.232.131,80,138,124998,43,8535,95,116463,35.502246,23.078663,2958.576933,40370.79618,Benign
192.168.137.97,47124,157.240.16.20,443,19,5904,11,1327,8,4577,133.1758302,10.18483094,1042.334434,3595.150494,Benign
192.168.43.224,53966,104.244.42.136,443,16,5699,9,1245,7,4454,947.7094781,26.06276424,382.1543989,1367.161199,Benign
172.30.6.255,56910,63.251.88.56,80,11,2570,6,1896,5,674,1385.797037,0.788218,19243.40728,6840.747103,Benign
172.30.6.255,56478,157.240.16.39,443,28,5562,15,3415,13,2147,789.09674,61.064575,447.3952369,281.2760099,Benign
172.30.6.255,56678,161.69.226.28,443,52,13002,31,8466,21,4536,1153.253718,229.910305,294.5844467,157.8354654,Benign
172.30.6.255,55712,157.240.16.39,443,18,1879,9,1071,9,808,57.100765,61.015399,140.4235675,105.9404692,Benign
192.168.137.97,42284,54.82.135.50,443,6,412,4,272,2,140,3030.579794,25.23850441,86.21747013,44.37663904,Benign
172.30.6.255,55998,52.109.124.5,443,58,41027,30,22986,28,18041,222.719927,1.191254,154365.064,121156.3613,Benign
172.30.6.255,55683,104.20.58.225,80,157,174617,33,2221,124,172396,41.953374,16.65556,1066.790909,82805.26143,Benign
10.0.2.15,44868,119.254.87.201,80,11,1579,6,705,5,874,9617.856841,1.818163,3102.032106,3845.639802,Malicious
10.0.2.15,54499,119.254.87.201,80,11,1582,6,705,5,877,26111.10899,1.331742,4235.054538,5268.287701,Malicious
172.30.15.2020,51332,34.196.221.221,443,6,348,4,228,2,120,4089.8702,7.722863,236.1818409,124.306232,Benign
10.0.2.15,44549,119.254.87.201,80,11,1582,6,705,5,877,23375.51279,2.155198,2616.928932,3255.385352,Malicious
192.168.137.97,58232,173.194.166.151,443,12,832,7,478,5,354,1198.160665,33.90195219,112.7958643,83.5350125,Benign
172.30.15.2450,51784,14.139.45.128,80,10,1402,5,668,5,734,5420.574061,0.225039,23746.99497,26093.25495,Benign
192.168.137.97,34194,192.229.237.96,443,78,36419,39,3651,39,32768,145.6895552,179.4607811,162.754223,1460.731411,Benign
172.30.6.255,57714,176.34.147.227,443,18,6378,9,1141,9,5237,3714.501568,25.47167,358.358914,1644.807741,Benign
192.168.137.97,39902,172.217.161.14,443,40,5271,21,2681,19,2590,5007.169709,240.9017509,89.0321466,86.01016773,Benign
172.30.6.255,55783,172.217.166.197,443,31,8220,17,5527,14,2693,64.405155,105.770219,418.038276,203.6868242,Benign
192.168.43.233,51282,207.46.155.185,80,116,71820,63,35950,53,35870,2768.384114,113.169904,2541.31169,2535.656476,Benign
172.30.6.255,56218,54.36.212.191,80,10,1543,6,851,4,692,470.031621,20.961574,324.7847705,264.1023045,Benign
192.168.137.97,58366,13.228.153.206,443,18,5261,10,1311,8,3950,1766.988171,50.73817066,206.7082803,622.8052685,Benign
172.30.1.136,50653,193.32.65.35,443,18,5489,11,1513,7,3976,1749.978091,16.159173,749.0482341,1968.417567,Benign
10.0.2.15,35164,119.254.87.201,80,11,1582,6,705,5,877,25988.60572,1.231198,4580.904128,5698.51478,Malicious
172.30.6.255,57869,157.240.16.39,443,19,1933,10,1125,9,808,4266.090081,61.041738,147.4401007,105.8947568,Benign
192.168.43.224,35034,34.232.42.95,443,613,477348,288,39861,325,437487,3015.327627,25.78755491,12365.96494,135720.3508,Benign
192.168.43.224,52250,192.0.73.2,443,87,28219,46,5501,41,22718,1903.253731,181.7626605,242.117935,999.8973362,Benign
172.30.1.136,50344,104.113.230.86,443,14,864,8,492,6,372,608.899053,22.023428,178.7187717,135.1288274,Benign
172.30.6.255,57919,157.240.16.39,443,19,1933,10,1125,9,808,4449.08932,61.056693,147.4039873,105.8688193,Benign
192.168.43.224,59522,49.44.150.71,443,53,13018,29,7119,24,5899,53.6334687,463.9829021,122.7459024,101.7106445,Benign
172.30.6.255,56273,147.75.111.32,443,5,294,3,174,2,120,531.522878,34.923986,39.8579933,27.48827124,Benign
10.0.2.15,49526,119.254.87.201,80,11,1513,6,705,5,808,2144.691,1.899868,2968.627294,3402.341636,Malicious
172.30.6.255,57433,192.168.240.1,7680,3,198,3,198,0,0,2800.763202,9.006765,175.867806,0,Benign
192.168.215.49,33740,18.208.55.232,443,11,736,6,404,5,332,1583.034569,151.0551038,21.3961655,17.58298749,Benign
172.30.15.1829,51141,104.16.121.145,443,587,522338,212,13831,375,508507,3864.064781,3.110281,35574.92072,1307938.415,Benign
172.30.15.1460,50768,103.229.206.238,443,18,6074,10,1942,8,4132,3504.764706,2.330244,6667.112972,14185.63893,Benign
172.30.15.2158,51470,104.16.123.127,443,98,35444,48,4993,50,30451,4189.210247,8.251979,4840.535828,29521.16092,Benign
172.30.1.136,51555,172.217.161.14,443,2,132,2,132,0,0,736.110499,3.000202,351.9763003,0,Benign
172.30.15.808,50100,172.25.10.224,7680,3,198,3,198,0,0,2701.317139,9.000507,175.9900859,0,Benign
172.30.6.255,57774,103.231.98.53,80,39,17419,20,15673,19,1746,3975.927867,66.024886,1899.041522,211.556594,Benign
10.0.2.15,51218,119.254.87.201,80,11,1582,6,705,5,877,17636.50503,1.508525,3738.751429,4650.900714,Malicious
10.0.2.15,50666,119.254.87.201,80,11,1582,6,705,5,877,7338.175402,2.664051,2117.076587,2633.583216,Malicious
10.0.2.15,41668,119.254.87.201,80,11,1582,6,705,5,877,9890.923523,1.917778,2940.903483,3658.400503,Malicious
192.168.137.97,39730,192.168.125.6,80,159,121274,78,5767,81,115507,8292.89523,9.960198317,4632.036284,92774.85956,Benign
192.168.43.224,40152,104.16.44.54,80,7,410,4,236,3,174,1174.373182,60.74068855,31.08295354,22.91709286,Benign
172.30.6.255,56370,52.114.76.35,443,22,12315,13,5840,9,6475,611.619061,130.653898,357.5859635,396.467314,Benign
192.168.43.224,53392,151.101.152.143,443,39,10006,21,2545,18,7461,113.1336289,301.3685122,67.55848464,198.0565241,Benign
172.30.6.255,58201,157.240.16.39,443,28,5505,16,3373,12,2132,5120.092457,61.055971,441.9551365,279.3502375,Benign
192.168.43.233,51066,52.70.107.220,443,44,18640,25,10310,19,8330,898.100426,108.49279,760.2348506,614.2343653,Benign
172.30.1.136,51797,130.211.21.54,443,12,696,7,402,5,294,2977.382383,45.187048,71.17083639,52.05031318,Benign
10.0.2.15,60304,119.254.87.201,80,11,1582,6,705,5,877,8416.776528,1.722298,3274.694623,4073.627212,Malicious
10.0.2.15,55586,119.254.87.201,80,11,1513,6,705,5,808,13672.22141,1.356929,4156.444442,4763.698027,Malicious
192.168.43.233,51120,13.228.37.108,443,31,9908,16,2872,15,7036,920.276529,88.111118,260.7616442,638.8297105,Benign
192.168.43.224,35250,205.185.216.10,443,22,4669,12,1695,10,2974,106.2723009,12.90953608,1050.386313,1842.978698,Benign
10.0.2.15,35123,119.254.87.201,80,12,1633,7,779,5,854,23886.06651,5.154038,1209.149021,1325.562598,Malicious
172.30.6.255,57569,103.243.221.51,80,16,6244,9,5068,7,1176,3256.278467,25.789472,1572.114388,364.8000238,Benign
172.30.1.136,50278,52.94.220.15,443,33,7952,15,1501,18,6451,482.701208,29.036817,413.5439501,1777.329795,Benign
10.0.2.15,60782,119.254.87.201,80,11,1513,6,705,5,808,25840.82013,2.018327,2794.393574,3202.652494,Malicious
172.30.15.1244,50552,180.149.59.138,80,8,468,5,282,3,186,3469.510366,7.9963,282.1304853,186.0860648,Benign
192.168.43.224,44734,157.240.16.52,443,340,266161,140,10953,200,255208,366.8634758,75.63300666,1158.541804,26994.35194,Benign
192.168.215.49,46048,52.46.128.194,443,25,8186,12,1845,13,6341,1250.192272,1.123067297,13142.5784,45169.15428,Benign
192.168.215.49,34816,192.155.228.10,80,6,412,4,272,2,140,1299.195333,27.26387669,79.81256756,41.07999801,Benign
192.168.43.224,36208,43.245.63.29,443,22,7647,12,1410,10,6237,2469.927027,60.66707122,185.932826,822.4560539,Benign
172.30.6.255,56372,172.217.166.206,443,49,9461,26,5861,23,3600,630.498355,199.705205,234.7860688,144.2125657,Benign
172.30.1.136,50295,172.217.161.4,443,62,15697,29,4052,33,11645,496.908867,133.614018,242.6092747,697.232232,Benign
192.168.43.233,50908,213.239.228.180,443,169,133665,66,4664,103,129001,335.159519,182.090645,204.9089342,5667.550906,Benign
172.30.6.255,55977,54.254.228.105,443,60,16225,29,8546,31,7679,176.010674,124.922245,547.2844328,491.7618956,Benign
10.0.2.15,41352,119.254.87.201,80,11,1582,6,705,5,877,4335.184195,1.163169,4848.822484,6031.797615,Malicious
10.0.2.15,60545,119.254.87.201,80,11,1579,6,705,5,874,25658.1595,1.958943,2879.10368,3569.271796,Malicious
192.168.43.224,36204,43.245.63.29,443,22,7647,12,1410,10,6237,2469.914363,60.67963689,185.8943227,822.285738,Benign
192.168.137.97,33674,35.171.73.174,443,24,3312,13,2013,11,1299,2670.382452,60.74609534,265.1034591,171.072724,Benign
10.0.2.15,38348,119.254.87.201,80,11,1513,6,705,5,808,16290.28329,2.144274,2630.260872,3014.540119,Malicious
192.168.137.97,33366,23.9.247.202,443,13,3856,8,651,5,3205,4109.488059,0.124025278,41991.43984,206732.0502,Benign
172.30.1.136,51899,172.217.194.188,5228,2,132,2,132,0,0,4739.893046,3.000048,351.9943681,0,Benign
172.30.6.255,56538,23.198.119.247,443,20,9368,10,1236,10,8132,832.148823,41.437365,238.6252118,1569.983999,Benign
192.168.43.224,54892,52.206.154.207,443,9,598,5,338,4,260,1916.430914,103.1385529,26.21716055,20.16704658,Benign
172.30.6.255,56356,72.251.245.181,80,11,1701,6,817,5,884,607.743045,24.298759,268.9849305,291.0436702,Benign
172.30.6.255,56257,202.241.208.52,80,6,348,4,228,2,120,529.925736,36.434164,50.0629025,26.34889605,Benign
192.168.43.233,51680,130.211.21.54,443,9,534,5,294,4,240,894.777007,10.58164,222.271784,181.4463543,Benign
192.168.215.49,38484,158.85.224.176,443,29,7906,15,3020,14,4886,17.80598241,1.288070549,18756.73659,30346.1639,Benign
192.168.43.233,51231,172.217.160.229,443,6,384,1,66,5,318,1631.600488,12.2717,43.02582364,207.3062412,Benign
172.30.15.1780,51092,161.202.1.35,443,17,4996,10,3959,7,1037,3641.870951,5.305653,5969.481985,1563.615261,Benign
172.30.6.255,57019,172.217.166.197,443,18,5430,10,1315,8,4115,1542.053172,17.192387,611.8987433,1914.80101,Benign
172.30.6.255,55958,103.231.98.53,80,190,111736,80,68623,110,43113,162.865093,248.822526,2206.327573,1386.144597,Benign
10.0.2.15,50830,119.254.87.201,80,11,1582,6,705,5,877,3341.868931,1.354562,4163.707531,5179.534049,Malicious
172.30.15.985,50291,77.238.185.37,80,5,294,3,174,2,120,3442.724571,4.534355,306.989638,211.7169917,Benign
192.168.43.233,51203,104.121.28.119,443,21,8944,10,1008,11,7936,1240.259964,61.455371,131.2171722,1033.07488,Benign
10.0.2.15,33486,119.254.87.201,80,11,1582,6,705,5,877,24574.01234,2.148978,2624.503369,3264.807737,Malicious
172.30.15.1765,51077,184.29.25.7,443,13,1477,6,904,7,573,3638.841845,8.334587,867.7094618,549.9972584,Benign
192.168.43.233,51311,117.18.232.102,443,28,6679,13,1496,15,5183,2591.665265,67.925945,176.1918807,610.4294905,Benign
192.168.43.224,59126,172.82.254.215,443,5,342,3,214,2,128,50.13110978,11.67740292,146.6079411,87.69073113,Benign
192.168.137.97,50638,192.168.121.7,443,19,3834,10,2367,9,1467,2934.996522,7.340198455,2579.766762,1598.866852,Benign
10.0.2.15,50225,119.254.87.201,80,11,1579,6,705,5,874,15208.93683,2.415921,2334.513422,2894.134369,Malicious
192.168.43.233,51360,139.59.72.43,443,39,10920,19,5731,20,5189,3137.076627,134.939428,339.7672621,307.6343261,Benign
192.168.215.49,54322,52.20.114.147,443,35,7979,18,2818,17,5161,556.602315,60.95024121,369.8754845,677.4050304,Benign
192.168.43.233,51048,162.212.45.11,80,13,1293,7,697,6,596,887.868983,3.366926,1656.110054,1416.12854,Benign
10.0.2.15,43342,119.254.87.201,80,11,1582,6,705,5,877,19233.6919,1.502419,3753.946136,4669.802499,Malicious
10.0.2.15,42882,119.254.87.201,80,11,1582,6,705,5,877,2082.683421,1.033073,5459.439943,6791.388411,Malicious
192.168.43.224,51644,54.197.248.134,443,378,275262,182,57371,196,217891,1274.824837,483.7587691,948.753861,3603.300056,Benign
172.30.6.255,57140,172.217.166.234,443,43,6727,22,4200,21,2527,1870.510916,169.664767,198.0375808,119.1526111,Benign
172.30.15.1686,50997,162.247.242.19,443,23,6378,11,2552,12,3826,3608.265213,9.069083,2251.164754,3374.982895,Benign
192.168.43.233,51016,172.82.241.224,443,10,588,6,348,4,240,698.070294,40.624619,68.52987347,47.26198171,Benign
172.30.15.1673,50984,161.202.1.35,443,27,10438,15,8149,12,2289,3596.580073,20.54929,3172.469706,891.1256788,Benign
192.168.43.224,38426,18.205.91.83,443,9,598,5,338,4,260,358.4470091,12.46588513,216.911994,166.85538,Benign
192.168.137.97,49774,157.240.16.16,443,280,23908,141,11534,139,12374,14.83150121,1955.213485,47.19280053,50.62976537,Benign
172.30.15.585,49870,172.30.6.35,7680,11,854,6,454,5,400,2302.558169,0.432583,8396.076591,7397.424309,Benign
10.0.2.15,53571,119.254.87.201,80,11,1582,6,705,5,877,1930.148036,0.827928,6812.186567,8474.166836,Malicious
172.30.15.2536,51870,192.168.121.146,80,138,123631,50,4101,88,119530,5500.380787,3.348301,9798.402234,285589.6169,Benign
172.30.1.136,50250,172.217.161.14,443,3,198,3,198,0,0,451.916024,8.999933,176.0013102,0,Benign
192.168.43.233,51481,104.131.222.33,80,9,523,5,283,4,240,3816.684935,74.772301,30.27859207,25.67795794,Benign
172.30.6.255,55777,195.201.82.80,80,169,178945,41,7479,128,171466,63.638968,35.253505,1697.192946,38910.40054,Benign
172.30.6.255,57829,103.243.221.17,80,16,5440,9,4204,7,1236,4127.865601,35.188258,955.7733719,281.0028277,Benign
172.30.15.572,49856,144.2.194.65,443,6,360,3,198,3,162,2255.304013,1.041172,1521.362465,1244.751107,Benign
192.168.137.97,48484,185.199.110.153,80,30,2832,16,1484,14,1348,2.73E-05,403.9949002,29.38650957,26.69340627,Benign
172.30.6.255,55932,52.68.71.55,80,14,2587,8,1624,6,963,152.439465,6.607198,1966.340346,1166.001079,Benign
172.30.1.136,50487,172.217.161.3,443,18,2089,11,1434,7,655,948.981846,16.382876,700.2433517,319.8461613,Benign
172.30.15.558,49842,192.28.147.68,443,24,8373,11,2110,13,6263,2253.354011,2.970606,5682.342256,16866.5922,Benign
172.30.15.684,49971,23.23.150.12,80,12,4165,7,1651,5,2514,2398.860222,7.532524,1753.462717,2670.021363,Benign
172.30.15.2522,51856,23.61.93.124,443,13,5033,7,1033,6,4000,5488.095251,0.236598,34928.44403,135250.5093,Benign
172.30.15.970,50276,52.0.128.155,80,10,2020,6,810,4,1210,3442.427714,4.834728,1340.302908,2002.180888,Benign
192.168.43.233,50906,173.222.151.224,443,67,31470,30,3247,37,28223,334.999935,350.255374,74.16303054,644.6267974,Benign
10.0.2.15,40079,119.254.87.201,80,11,1582,6,705,5,877,21813.40346,1.083221,5206.69374,6476.979305,Malicious
192.168.137.97,57280,104.197.3.80,80,13,1125,7,565,6,560,3923.813255,4.190977353,1078.507379,1068.963066,Benign
172.30.15.2303,51632,172.25.10.63,7680,3,198,3,198,0,0,4976.331873,9.001899,175.9628718,0,Benign
192.168.43.224,38938,23.213.72.244,443,25,3205,13,1927,12,1278,3265.301968,70.58389197,218.406772,144.8489126,Benign
192.168.43.224,58948,104.197.3.80,80,10,911,5,425,5,486,2123.813645,0.971207648,3500.796155,4003.263368,Benign
192.168.215.49,46410,223.31.160.67,443,103,61463,52,5208,51,56255,334.9773778,125.5521199,331.8462486,3584.487465,Benign
172.30.1.136,50174,161.202.24.162,443,67,16442,34,9502,33,6940,265.309889,116.839626,650.6011924,475.181254,Benign
10.0.2.15,56951,119.254.87.201,80,11,1579,6,705,5,874,6735.072312,1.295302,4354.196936,5397.968968,Malicious
192.168.43.224,39002,23.9.182.234,443,9,618,5,338,4,280,106.5178794,68.28732798,39.59739062,32.80257211,Benign
172.30.6.255,56506,52.109.120.4,443,22,9460,12,2549,10,6911,824.610186,48.973864,416.3853602,1128.928687,Benign
172.30.1.136,50461,157.240.16.16,443,1,66,1,66,0,0,881.834757,0,0,0,Benign
172.30.6.255,56358,18.207.56.96,80,7,402,4,228,3,174,607.745194,24.367672,74.85327281,57.12486609,Benign
172.30.15.1337,50645,52.220.69.147,443,6,340,4,228,2,112,3490.048085,7.044368,258.9302546,127.1938093,Benign
192.168.43.233,50998,104.237.191.1,443,24,3938,12,2001,12,1937,516.259038,48.58472,329.4863076,318.9480149,Benign
10.0.2.15,37642,119.254.87.201,80,11,1579,6,705,5,874,7640.649515,2.096904,2689.679642,3334.439726,Malicious
192.168.137.97,33846,172.217.161.5,443,7,466,4,272,3,194,9564.334645,56.31559352,38.63938678,27.5589744,Benign
172.30.6.255,56612,172.217.166.210,443,7,402,4,228,3,174,965.971941,30.864648,59.09673747,45.10014175,Benign
192.168.137.97,33692,104.17.162.9,443,19,6963,11,1207,8,5756,3519.144419,4.003231688,2412.051251,11502.70671,Benign
172.30.6.255,57134,172.217.166.206,443,32,4755,18,2662,14,2093,1862.408745,67.76372,314.2684611,247.0938727,Benign
192.168.137.97,56710,104.113.232.176,443,662,525634,282,22013,380,503621,2.180919372,72.78113146,2419.638119,55357.31472,Benign
10.0.2.15,53114,119.254.87.201,80,11,1579,6,705,5,874,6076.815432,0.824041,6844.319639,8485.014702,Malicious
10.0.2.15,52942,119.254.87.201,80,11,1582,6,705,5,877,13286.55011,2.352377,2397.574879,2982.515133,Malicious
172.30.6.255,55885,54.149.211.44,80,6,348,4,228,2,120,110.463538,10.671656,170.9200521,89.95792218,Benign
172.30.6.255,58419,103.243.220.231,80,7,406,5,294,2,112,5571.880273,7.346913,320.1344565,121.9559834,Benign
10.0.2.15,33801,119.254.87.201,80,11,1513,6,705,5,808,611.177129,1.755541,3212.684865,3682.055845,Malicious
10.0.2.15,39431,119.254.87.201,80,11,1582,6,705,5,877,21931.02187,1.556657,3623.148838,4507.09437,Malicious
192.168.43.233,51485,216.58.196.194,443,25,5976,14,2109,11,3867,3818.641334,72.447932,232.8844942,427.0101181,Benign
192.168.43.224,50732,104.197.3.80,80,10,911,5,425,5,486,214.5627982,1.473670252,2307.16471,2638.310704,Benign
172.30.6.255,56421,38.106.10.133,80,12,1927,7,1278,5,649,678.978892,19.157767,533.673888,271.012796,Benign
172.30.6.255,56672,103.243.221.17,80,16,6188,9,4506,7,1682,1133.106823,3.562376,10119.08906,3777.254282,Benign
172.30.6.255,57295,157.240.16.39,443,27,5452,15,3399,12,2053,2375.087973,61.022114,445.6089476,269.1483288,Benign
10.0.2.15,54480,119.254.87.201,80,11,1582,6,705,5,877,5446.261654,1.292281,4364.375859,5429.159757,Malicious
172.30.1.136,50591,52.30.87.88,443,15,846,8,444,7,402,1597.415033,55.607048,63.8767949,57.83439538,Benign
192.168.42.240,51021,54.239.25.128,443,64,23887,32,11288,32,12599,490.158389,5.618699,16072.048,17938.67228,Benign
192.168.43.224,37774,117.18.237.66,443,19,6435,11,1515,8,4920,94.32352,11.92789718,1016.105339,3299.827239,Benign
10.0.2.15,46235,119.254.87.201,80,11,1582,6,705,5,877,8867.10876,1.817983,3102.339241,3859.222006,Malicious
192.168.137.97,41432,35.171.73.174,443,27,6695,14,2232,13,4463,568.3513186,60.71338079,294.103207,588.0746474,Benign
192.168.215.49,41192,54.86.213.171,443,24,5583,13,1509,11,4074,550.9842708,83.29711769,144.9269835,391.2740429,Benign
172.30.6.255,56301,52.84.107.243,80,8,480,5,294,3,186,569.28858,19.596569,120.0210098,75.93165926,Benign
10.0.2.15,41242,119.254.87.201,80,11,1569,6,705,5,864,3796.434065,0.965927,5838.950563,7155.820264,Malicious
172.30.15.617,49904,192.0.73.2,443,62,25544,31,2982,31,22562,2391.209066,4.954949,4814.580332,36427.41832,Benign
10.0.2.15,42046,119.254.87.201,80,11,1582,6,705,5,877,9860.814575,1.822024,3095.458677,3850.662779,Malicious
172.30.6.255,55929,52.203.61.66,80,11,1793,6,976,5,817,152.349429,6.780777,1151.490456,963.9013346,Benign
172.30.15.2397,51731,14.139.45.128,80,48,32307,23,1749,25,30558,5340.553381,2.891787,4838.530639,84537.34663,Benign
172.30.15.2126,51438,157.240.16.20,443,12,1688,7,971,5,717,4178.304644,9.046024,858.7198088,634.0907342,Benign
192.168.43.233,51036,172.82.241.224,443,10,564,7,390,3,174,819.987561,55.739914,55.97425213,24.97312787,Benign
172.30.1.136,50265,172.217.161.3,443,89,10288,41,5672,48,4616,474.9255,124.784211,363.6357488,295.9348759,Benign
172.30.15.403,49675,172.25.10.224,7680,3,198,3,198,0,0,1493.858232,9.013782,175.7308974,0,Benign
10.0.2.15,53448,119.254.87.201,80,11,1513,6,705,5,808,10643.88615,6.083408,927.1119083,1062.562301,Malicious
10.0.2.15,42441,119.254.87.201,80,11,1582,6,705,5,877,698.744653,1.706988,3304.065406,4110.163633,Malicious
192.168.137.97,46872,52.84.110.71,443,14,980,9,618,5,362,42.72728866,19.87232162,248.7882441,145.7303307,Benign
172.30.6.255,57156,103.231.98.53,80,283,147679,142,133917,141,13762,1921.883336,589.118621,1818.540378,186.8825667,Benign
172.30.6.255,58218,13.107.5.88,443,33,8935,17,1966,16,6969,5163.754646,1.65734,9489.905511,33639.44634,Benign
172.30.15.619,49906,192.0.73.2,443,21,8410,10,1145,11,7265,2391.297212,0.73976,12382.39429,78566.02141,Benign
192.168.43.224,35050,34.232.42.95,443,28,13055,15,5090,13,7965,3040.472082,3.725048642,10931.40088,17105.8169,Benign
172.30.15.489,49767,52.114.74.45,443,32,19599,19,14330,13,5269,1807.296609,1.249096,91778.37412,33746.00511,Benign
192.168.43.224,51808,54.173.101.22,443,20,5474,11,1515,9,3959,34.04894304,11.0688473,1094.964965,2861.363892,Benign
10.0.2.15,53865,119.254.87.201,80,11,1582,6,705,5,877,19167.99033,1.725479,3268.657573,4066.117293,Malicious
10.0.2.15,37202,119.254.87.201,80,11,1582,6,705,5,877,16107.1215,2.118927,2661.724543,3311.109821,Malicious
10.0.2.15,55103,119.254.87.201,80,11,1582,6,705,5,877,4337.115785,1.015525,5553.777603,6908.741784,Malicious
192.168.43.224,41512,157.240.16.20,443,31,11803,14,1154,17,10649,9.852992713,66.19547114,139.4657345,1286.976262,Benign
192.168.43.233,51174,151.101.153.170,443,9,534,5,294,4,240,1037.249056,15.516383,151.5817185,123.7401784,Benign
172.30.15.1040,50346,52.221.118.237,443,20,8289,10,1943,10,6346,3447.557783,9.509691,1634.54312,5338.554113,Benign
172.30.6.255,57577,103.243.221.17,80,17,5853,10,4270,7,1583,3288.858884,27.539798,1240.386731,459.8436052,Benign
172.30.1.136,50770,172.217.161.4,443,8,480,4,240,4,240,1917.84027,5.364275,357.9234845,357.9234845,Benign
172.30.6.255,56873,103.15.158.152,80,7,1553,4,1248,3,305,1383.819509,10.333591,966.1694565,236.1231444,Benign
172.30.6.255,57497,103.243.221.109,80,40,29114,15,5545,25,23569,3057.851871,15.177468,2922.75365,12423.15253,Benign
10.0.2.15,37621,119.254.87.201,80,11,1579,6,705,5,874,18753.17079,1.513534,3726.378132,4619.651755,Malicious
10.0.2.15,47315,119.254.87.201,80,11,1582,6,705,5,877,18212.56402,2.173899,2594.41676,3227.380849,Malicious
172.30.15.834,50136,52.229.168.53,443,30,10163,17,2314,13,7849,3211.263062,119.133318,155.38894,527.0733751,Benign
192.168.43.233,51071,157.240.16.20,443,78,40753,35,3438,43,37315,907.909136,68.812429,399.6952353,4338.16978,Benign
172.30.15.248,49516,13.107.4.50,80,712,718733,215,12492,497,706241,57.970221,3.158274,31642.59972,1788929.016,Benign
172.30.6.255,57772,103.243.221.51,80,14,5408,9,4288,5,1120,3975.899233,3.469637,9886.913242,2582.402712,Benign
192.168.215.49,46414,223.31.160.67,443,51,31702,21,2549,30,29153,335.7262242,124.803165,163.3932922,1868.734659,Benign
172.30.6.255,56239,103.243.221.17,80,23,12036,11,4253,12,7783,500.864819,21.581543,1576.532317,2885.057848,Benign
10.0.2.15,39162,119.254.87.201,80,11,1513,6,705,5,808,10278.61658,1.154541,4885.058218,5598.761759,Malicious
10.0.2.15,50962,119.254.87.201,80,11,1579,6,705,5,874,12896.05843,2.154967,2617.209451,3244.597249,Malicious
10.0.2.15,52544,119.254.87.201,80,11,1579,6,705,5,874,25204.66454,2.089489,2699.224547,3346.272701,Malicious
10.0.2.15,34651,119.254.87.201,80,11,1582,6,705,5,877,11965.16465,4.50539,1251.833914,1557.245877,Malicious
172.30.6.255,56014,54.179.181.44,443,23,7942,12,1893,11,6049,227.894798,76.711981,197.4137521,630.8271455,Benign
172.30.6.255,55823,52.9.25.50,80,6,348,4,228,2,120,91.142,11.016916,165.5635751,87.13872376,Benign
10.0.2.15,49254,119.254.87.201,80,11,1560,6,705,5,855,25149.97502,2.113555,2668.489819,3236.253611,Malicious
192.168.137.97,42276,35.194.103.20,443,6,412,4,272,2,140,349.0075821,14.82250485,146.8037975,75.5607781,Benign
192.168.43.224,46598,172.217.24.234,443,50,8476,24,2784,26,5692,93.37665032,240.7960592,92.49320805,189.1060849,Benign
172.30.1.136,50630,52.214.173.82,443,35,14527,18,2480,17,12047,1714.762726,21.801913,910.0118875,4420.52952,Benign
10.0.2.15,32978,119.254.87.201,80,11,1582,6,705,5,877,18507.33637,1.225215,4603.273711,5726.341907,Malicious
172.30.6.255,56390,54.175.180.42,80,13,1401,7,897,6,504,650.888681,96.210383,74.58654437,41.90815871,Benign
192.168.43.224,46120,104.17.40.113,443,20,6798,11,1207,9,5591,36.92491523,12.95488278,745.3560302,3452.597817,Benign
10.0.2.15,45404,119.254.87.201,80,11,1593,6,705,5,888,4873.401465,1.0924,5162.943977,6503.112413,Malicious
172.30.15.2200,51512,77.88.21.119,443,102,57525,57,46673,45,10852,4299.155813,19.801295,18856.54448,4384.35971,Benign
172.30.6.255,55763,172.217.194.188,5228,53,8093,27,2350,26,5743,61.587486,796.379809,23.60682653,57.69106585,Benign
172.30.6.255,58057,151.139.104.15,80,17,8745,7,1816,10,6929,4819.999673,5.994319,2423.628105,9247.422434,Benign
172.30.6.255,57901,103.243.221.75,80,16,5838,9,4255,7,1583,4405.842865,3.596484,9464.79951,3521.216833,Benign
192.168.43.224,38136,157.240.16.35,443,31,7953,17,2416,14,5537,34.7910364,67.58387129,285.9853931,655.4226497,Benign
172.30.15.1819,51131,157.240.16.52,443,25,6537,13,1690,12,4847,3748.201435,8.841797,1529.100928,4385.533846,Benign
10.0.2.15,56864,119.254.87.201,80,12,1587,7,779,5,808,3284.050276,4.625889,1347.200506,1397.353028,Malicious
172.30.6.255,57090,103.231.98.53,80,39,17418,20,15672,19,1746,1734.84359,60.900363,2058.706941,229.3582388,Benign
172.30.15.1289,50597,103.243.220.231,80,10,3140,6,2125,4,1015,3471.101613,0.932253,18235.39318,8710.08192,Benign
172.30.6.255,58001,52.229.173.178,443,29,10122,16,2272,13,7850,4737.763407,97.2925,186.8181001,645.47627,Benign
172.30.15.274,49537,172.217.166.194,443,16,4830,8,1219,8,3611,213.410859,1.244731,7834.624509,23208.22732,Benign
172.30.15.1933,51245,34.201.201.2,443,19,5522,11,1790,8,3732,3991.668851,5.531848,2588.646687,5397.111417,Benign
192.168.43.224,37794,4.31.198.61,443,21,7685,12,1443,9,6242,744.4170593,59.84646541,192.8935973,834.4018257,Benign
192.168.43.224,33164,35.171.73.174,443,6,412,4,272,2,140,1907.93564,10.67329248,203.87336,104.9348177,Benign
172.30.6.255,58184,157.240.16.20,443,50,13762,25,2824,25,10938,5041.336432,65.242732,346.2761185,1341.206864,Benign
192.168.215.49,54312,52.20.114.147,443,9,610,5,338,4,272,555.9737193,78.5355597,34.43026332,27.70719415,Benign
172.30.6.255,55745,103.231.98.48,80,15,4970,8,3722,7,1248,58.267143,0.392941,75777.27954,25408.39464,Benign
10.0.2.15,36873,219.234.85.243,80,8,1325,4,1069,4,256,22.895649,0.619351,13808.00225,3306.687161,Malicious
172.30.6.255,55734,173.241.248.143,80,9,1500,6,1008,3,492,58.135345,0.599495,13451.32153,6565.525984,Benign
192.168.137.97,50632,104.237.191.1,443,42,5407,21,2740,21,2667,5308.202636,242.4281302,90.41854997,88.0095886,Benign
172.30.15.1821,51133,158.85.224.180,443,7,402,4,228,3,174,3758.05677,9.245257,197.2903511,150.563689,Benign
192.168.43.224,50448,23.251.156.28,443,9,610,5,338,4,272,179.1914755,73.95261041,36.56395609,29.42424869,Benign
172.30.6.255,58158,176.34.147.227,443,42,14341,23,7880,19,6461,4958.529637,155.58522,405.1798751,332.2166463,Benign
10.0.2.15,45040,119.254.87.201,80,11,1582,6,705,5,877,9232.256247,1.424859,3958.286399,4923.995988,Malicious
172.30.6.255,56970,176.34.147.227,443,18,6378,9,1141,9,5237,1419.461525,16.748067,545.0181206,2501.542417,Benign
192.168.137.97,54062,140.98.193.112,443,73,49854,36,5681,37,44173,15.55210108,13.25433219,3428.916625,26661.7733,Benign
172.30.15.1408,50716,119.42.60.92,443,6,348,4,228,2,120,3500.005051,7.084016,257.4810672,135.5163512,Benign
172.30.6.255,57189,172.217.166.206,443,17,1779,10,1150,7,629,2051.406808,98.785516,93.13106185,50.93864165,Benign
10.0.2.15,54735,119.254.87.201,80,11,1582,6,705,5,877,17396.32836,1.422644,3964.449293,4931.662454,Malicious
172.30.20.1,62078,172.30.6.255,56830,5,306,2,108,3,198,1314.318774,1.102071,783.9785277,1437.293967,Benign
10.0.2.15,37956,119.254.87.201,80,11,1582,6,705,5,877,4242.902983,0.855228,6594.732633,8203.66031,Malicious
192.168.215.49,49474,172.217.161.14,443,19,6009,10,1443,9,4566,193.9404104,49.34136604,233.9619051,740.3118911,Benign
192.168.43.233,51654,172.217.166.211,443,11,642,6,348,5,294,857.443781,37.517078,74.2062055,62.69144948,Benign
10.0.2.15,47335,119.254.87.201,80,11,1579,6,705,5,874,25504.92811,5.145868,1096.025005,1358.760077,Malicious
192.168.215.49,48672,169.44.82.118,443,29,8076,15,3190,14,4886,337.8233319,1.363651207,18714.46296,28664.22132,Benign
172.30.6.255,57622,103.243.221.87,80,35,21829,16,8341,19,13488,3430.844847,20.223917,3299.459744,5335.464935,Benign
172.30.6.255,56253,104.16.91.60,80,8,456,5,282,3,174,529.951828,36.558767,61.70886452,38.07568237,Benign
192.168.43.224,51254,54.236.156.42,443,11,742,6,404,5,338,46.73670111,20.91119703,154.5583448,129.3087142,Benign
172.30.15.2035,51347,144.2.1.5,443,29,8209,14,2133,15,6076,4090.703869,6.65528,2563.979277,7303.674676,Benign
172.30.6.255,56852,103.231.98.53,80,22,14959,15,14285,7,674,1352.83983,4.129168,27676.27764,1305.832071,Benign
192.168.43.233,51212,52.84.108.135,443,4337,3490924,1929,117376,2408,3373548,1437.710558,346.18808,2712.421525,77958.73272,Benign
10.0.2.15,42640,119.254.87.201,80,12,1587,7,779,5,808,2711.084056,4.480524,1390.908742,1442.6884,Malicious
172.30.1.136,50573,172.217.194.188,5228,41,7736,25,6334,16,1402,1574.090819,223.116366,227.1101888,50.26973234,Benign
172.30.6.255,56680,157.240.16.39,443,4,264,1,66,3,198,1155.094456,7.171886,73.62080212,220.8624063,Benign
192.168.43.224,39032,144.2.1.1,443,41,11107,21,3485,20,7622,114.7249789,116.4878889,239.3381857,523.4535586,Benign
172.30.6.255,56700,52.213.19.114,443,20,6522,11,1285,9,5237,1157.350894,12.231001,840.4872177,3425.394209,Benign
172.30.6.255,57974,131.253.61.102,443,56,26881,16,6929,40,19952,4686.901854,99.640324,556.320953,1601.921728,Benign
192.168.215.49,60508,159.153.113.136,80,23,1896,13,1156,10,740,1496.210805,345.6036984,26.7589729,17.12944632,Benign
172.30.6.255,57686,35.190.43.164,80,97,25061,50,18145,47,6916,3641.91273,642.993017,225.7567286,86.04759078,Benign
192.168.42.240,50925,13.107.6.254,443,1,54,0,0,1,54,112.01438,0,0,0,Benign
172.30.6.255,57022,103.243.221.51,80,35,19625,16,9598,19,10027,1548.856884,45.234808,1697.453872,1773.324649,Benign
192.168.43.224,36682,169.55.74.36,443,31,9200,17,4314,14,4886,370.714353,1.385137649,24915.93527,28219.57805,Benign
192.168.215.49,44814,13.228.149.38,443,37,12386,20,4728,17,7658,1252.739184,200.6462664,188.5108588,305.3333665,Benign
172.30.6.255,58312,103.243.221.51,80,17,7234,10,5292,7,1942,5353.882627,5.282158,8014.906029,2941.222129,Benign
192.168.137.97,46322,74.125.68.188,443,272,21688,142,10506,130,11182,4205.141697,5329.172465,15.77130419,16.78609589,Benign
172.30.15.2107,51419,52.86.72.168,443,6,340,4,228,2,112,4146.357088,1.341338,1359.836223,667.9897237,Benign
172.30.15.1375,50683,104.244.42.72,443,23,5675,12,4352,11,1323,3494.363742,2.782256,12513.5861,3804.107171,Benign
10.0.2.15,35295,119.254.87.201,80,11,1582,6,705,5,877,16945.89027,1.351466,4173.245942,5191.399562,Malicious
10.0.2.15,36353,119.254.87.201,80,11,1582,6,705,5,877,4156.874533,1.896671,2973.631167,3699.112814,Malicious
172.30.15.1409,50717,209.15.36.33,443,7,402,4,228,3,174,3500.034382,6.43294,283.5406517,216.3862868,Benign
172.30.6.255,56868,184.29.25.41,80,19,9322,9,2091,10,7231,1379.012728,57.04779,293.2278358,1014.027011,Benign
172.30.6.255,58342,35.190.43.164,80,10,1629,6,1175,4,454,5419.881702,9.170289,1025.049483,396.0616726,Benign
192.168.43.233,51232,172.217.166.197,443,46,7034,22,3542,24,3492,1468.463045,240.324033,117.9074754,116.2430559,Benign
172.30.6.255,56164,103.243.221.109,80,32,18696,19,14765,13,3931,434.845137,30.185387,3913.151751,1041.828617,Benign
172.30.1.136,50146,23.58.57.98,443,8,456,4,228,4,228,119.916453,36.014609,50.64611419,50.64611419,Benign
172.30.6.255,55804,18.207.56.96,80,14,5407,8,2782,6,2625,90.847156,8.10415,2746.247293,2591.264969,Benign
10.0.2.15,38302,119.254.87.201,80,12,1656,7,779,5,877,23287.96509,4.442632,1402.77205,1579.244016,Malicious
172.30.15.891,50197,210.176.156.62,80,14,5168,8,3648,6,1520,3438.483429,8.686627,3359.646961,1399.8529,Benign
172.30.6.255,57070,210.176.156.21,80,26,6225,14,4280,12,1945,1679.891796,303.074179,112.9756422,51.34056636,Benign
192.168.43.224,33962,52.84.108.93,443,15,1720,8,1106,7,614,2882.727064,13.34733477,662.9038795,368.0135462,Benign
172.30.15.493,49771,172.25.10.224,7680,3,198,3,198,0,0,1841.662096,9.006431,175.874328,0,Benign
192.168.42.240,50900,172.82.246.68,443,2,108,2,108,0,0,13.394593,0.000126,0,0,Benign
192.168.137.97,39788,192.168.125.6,80,149,109285,76,5300,73,103985,8378.626252,27.99382583,1514.619697,29716.55268,Benign
172.30.6.255,56992,157.240.16.39,443,19,1933,10,1125,9,808,1460.08844,61.042341,147.4386443,105.8937107,Benign
192.168.215.49,54774,195.8.215.225,443,17,3275,10,2473,7,802,530.3516093,2.815442317,7026.959807,2278.860398,Benign
172.30.6.255,57904,103.243.221.75,80,17,5863,9,4226,8,1637,4417.839704,16.24381,2081.285117,806.2147981,Benign
172.30.15.1135,50443,104.16.87.26,80,7,402,4,228,3,174,3458.305057,8.916766,204.5584688,156.1104104,Benign
172.30.15.366,49634,62.210.213.13,80,20,10973,9,852,11,10121,1402.328963,2.111837,3227.521821,38340.08022,Benign
192.168.215.24,49309,192.168.215.49,2987,6,356,3,194,3,162,1621.386127,1.025451675,1513.479414,1263.833325,Benign
172.30.6.255,58576,35.190.43.164,80,3,186,2,120,1,66,5880.098737,0.345115,2781.681468,1529.924808,Benign
192.168.43.224,49118,157.240.16.39,443,37,10938,19,3862,18,7076,303.9125732,65.81053737,469.4688911,860.1662023,Benign
172.30.6.255,57331,52.213.19.114,443,19,6444,10,1207,9,5237,2468.837279,42.763404,225.8005467,979.7162078,Benign
192.168.43.233,51261,52.84.108.242,443,11,644,6,350,5,294,2300.80144,123.300607,22.70872843,19.07533188,Benign
172.30.6.255,57727,157.240.16.39,443,28,5547,15,3399,13,2148,3778.096664,61.041052,445.4706973,281.5154627,Benign
192.168.43.224,59316,91.189.92.40,443,6,434,3,229,3,205,5.523402408,0.550262883,3329.31778,2980.393646,Benign
192.168.43.233,51112,144.2.1.1,443,38,8842,18,2466,20,6376,919.637703,117.686626,167.631622,433.422231,Benign
172.30.6.255,58430,157.240.16.20,443,6,348,4,228,2,120,5592.975964,6.054657,301.2557111,158.5556374,Benign
192.168.43.224,60162,151.101.153.2,443,528,338892,254,24417,274,314475,879.9078101,877.1784513,222.6867289,2868.059511,Benign
10.0.2.15,49305,119.254.87.201,80,11,1579,6,705,5,874,3466.057925,1.888459,2986.562059,3702.489702,Malicious
192.168.137.97,48486,185.199.110.153,80,40,7112,21,2644,19,4468,0,403.9949609,52.35708869,88.47635108,Benign
172.30.1.136,50129,172.217.161.5,443,11,666,6,360,5,306,106.202418,12.936166,222.6316514,189.2369037,Benign
10.0.2.15,50418,119.254.87.201,80,12,1653,7,779,5,874,23282.5134,4.347402,1433.499824,1608.316875,Malicious
172.30.1.136,50651,157.240.16.20,443,23,6509,10,1778,13,4731,1746.409445,3.573571,3980.332278,10591.08662,Benign
172.30.1.136,50484,172.217.161.3,443,87,23388,47,18875,40,4513,945.413177,95.924539,1574.154034,376.379187,Benign
172.30.6.255,58180,35.190.43.164,80,21,5179,12,3979,9,1200,5023.883433,90.111524,353.2511558,106.5346537,Benign
172.30.6.255,56667,172.30.10.168,139,3,198,3,198,0,0,1131.388743,9.009226,175.8197652,0,Benign
172.30.15.2034,51346,184.29.26.86,443,6,348,4,228,2,120,4090.692621,6.666184,273.6198101,144.0104264,Benign
10.0.2.15,34724,119.254.87.201,80,11,1579,6,705,5,874,13371.84112,4.580377,1231.339691,1526.511901,Malicious
192.168.43.224,58378,162.213.83.13,443,11,766,6,412,5,354,655.3337395,42.55732141,77.44848338,66.54554154,Benign
192.168.215.49,36792,77.238.185.35,443,34,8957,16,2258,18,6699,516.5952093,116.0982281,155.5923833,461.6091124,Benign
192.168.137.97,33462,52.94.216.31,443,16,2050,11,1748,5,302,3740.17981,61.20319972,228.4847861,39.47506031,Benign
172.30.15.1230,50538,103.15.158.128,80,19,5640,10,2314,9,3326,3468.228246,10.530338,1757.968263,2526.794487,Benign
10.0.2.15,58427,119.254.87.201,80,11,1579,6,705,5,874,11304.61511,1.222622,4613.036572,5718.856687,Malicious
172.30.1.136,50821,172.217.161.3,443,20,2389,10,1357,10,1032,1957.450047,23.725745,457.5620281,347.9764281,Benign
172.30.1.136,50133,119.81.119.5,80,9,534,5,294,4,240,112.760681,19.463724,120.8401845,98.6450486,Benign
172.30.15.769,50060,104.244.42.8,443,6,348,4,228,2,120,2623.232803,3.143614,580.2239079,305.3810042,Benign
172.30.15.1432,50740,103.231.98.244,443,17,6428,8,1087,9,5341,3501.136693,1.033357,8415.291134,41348.7304,Benign
192.168.137.97,57382,172.217.160.237,443,1,66,1,66,0,0,1.169913263,0,0,0,Benign
10.0.2.15,40002,219.234.85.243,80,6,832,4,704,2,128,36785.40104,3.339432,1686.514353,306.6389733,Malicious
192.168.137.97,41230,184.29.25.22,443,1145,915313,513,38148,632,877165,122.359663,557.7625885,547.1575295,12581.1952,Benign
172.30.6.255,56111,157.240.16.17,443,2099,1999847,693,48608,1406,1951239,313.016272,72.878105,5335.813822,214192.0677,Benign
192.168.137.97,39926,172.217.161.14,443,12,820,7,478,5,342,5229.203256,15.6465262,244.3992968,174.8630952,Benign
192.168.43.224,51004,23.213.88.167,443,362,257338,170,16627,192,240711,93.71312271,141.8927001,937.4407557,13571.43813,Benign
192.168.43.233,51324,52.222.134.188,443,34,9532,17,2996,17,6536,3365.611864,213.027151,112.5114798,245.4522804,Benign
192.168.43.233,51289,74.207.230.33,443,12,1381,6,904,6,477,2491.954644,26.235739,275.6545184,145.4504483,Benign
192.168.43.224,47434,104.16.121.145,443,290,152410,130,12707,160,139703,152.6922117,459.8795691,221.0491764,2430.253647,Benign
192.168.137.97,54588,52.91.99.99,443,35,7289,17,2453,18,4836,349.3886546,6.45663202,3039.355494,5991.978462,Benign
192.168.137.97,34196,192.229.237.96,443,29,1990,14,980,15,1010,145.9398934,69.49087032,112.8205758,116.2742669,Benign
10.0.2.15,45465,119.254.87.201,80,11,1582,6,705,5,877,15654.39857,4.496486,1254.312812,1560.329555,Malicious
172.30.15.399,49671,195.154.150.142,80,11,1700,6,905,5,795,1483.418256,7.137328,1014.385215,891.0897748,Benign
10.0.2.15,36969,119.254.87.201,80,11,1582,6,705,5,877,11244.55005,0.989406,5700.389931,7091.123361,Malicious
192.168.43.224,49028,172.217.166.206,443,46,8759,21,2477,25,6282,24.07391376,240.7712562,82.30218304,208.7292345,Benign
10.0.2.15,52491,119.254.87.201,80,11,1579,6,705,5,874,6739.699334,1.054326,5349.389088,6631.724912,Malicious
192.168.43.224,33180,35.171.73.174,443,36,5001,19,2790,17,2211,2058.127429,95.80342341,232.9770608,184.6280579,Benign
172.30.15.870,50176,54.85.78.249,80,6,348,4,228,2,120,3434.821903,2.376645,767.4684271,403.9307511,Benign
192.168.137.97,44032,172.217.161.10,443,17,1210,8,560,9,650,3838.790913,44.87288617,99.83757191,115.882896,Benign
192.168.43.233,51230,172.217.166.195,443,144,88741,66,6098,78,82643,1435.634442,241.124151,202.319012,2741.923599,Benign
10.0.2.15,46098,119.254.87.201,80,11,1579,6,705,5,874,4517.347754,0.840804,6707.865329,8315.850067,Malicious
172.30.15.1085,50391,23.237.44.42,80,7,402,4,228,3,174,3452.958504,9.845552,185.2613241,141.3836421,Benign
172.30.6.255,57812,103.243.221.87,80,31,18126,18,15013,13,3113,4043.421715,21.645569,5548.664486,1150.535705,Benign
192.168.43.224,32802,54.243.243.77,443,119,76230,63,12535,56,63695,31.20792274,79.46223598,1261.983114,6412.605859,Benign
10.0.2.15,37104,119.254.87.201,80,11,1582,6,705,5,877,4094.950622,1.799659,3133.927038,3898.51633,Malicious
172.30.15.1577,50886,52.84.102.103,443,19,2900,10,1774,9,1126,3561.974001,5.010499,2832.452416,1797.824927,Benign
10.0.2.15,47478,119.254.87.201,80,11,1513,6,705,5,808,5808.766528,1.627687,3465.039654,3971.27949,Malicious
10.0.2.15,39365,219.234.85.243,80,11,1631,6,796,5,835,119.108637,31.998601,199.0087004,208.7591267,Malicious
10.0.2.15,53925,119.254.87.201,80,11,1582,6,705,5,877,733.097401,1.849069,3050.183633,3794.341909,Malicious
192.168.43.233,51506,13.107.21.200,443,787,529846,453,391978,334,137868,3897.621321,118.632829,26433.02049,9297.122974,Benign
192.168.43.224,42036,23.251.156.28,443,15,1742,9,1178,6,564,1431.491845,24.62035956,382.7726389,183.2629612,Benign
192.168.137.97,40424,192.0.73.2,443,6,356,4,236,2,120,8.761139375,13.36777445,141.2351777,71.81449712,Benign
10.0.2.15,54955,119.254.87.201,80,11,1534,6,705,5,829,8331.359955,1.223423,4610.016323,5420.856073,Malicious
192.168.43.233,50901,172.217.166.195,443,19,6357,9,1121,10,5236,225.666327,63.67944,140.8303842,657.7947294,Benign
192.168.215.49,36238,210.176.156.35,443,31,7824,17,3108,14,4716,620.32576,359.5992607,69.14363492,104.9167897,Benign
172.30.6.255,57515,172.217.166.206,443,42,6737,23,3958,19,2779,3075.421418,64.754148,488.9879796,343.3293571,Benign
172.30.15.620,49907,198.58.102.214,80,12,3633,7,797,5,2836,2391.452702,4.991667,1277.328796,4545.174989,Benign
192.168.137.97,57470,72.247.219.151,443,69,30385,37,11915,32,18470,347.5371736,29.56757009,3223.802284,4997.367032,Benign
10.0.2.15,42278,119.254.87.201,80,11,1582,6,705,5,877,23582.866,2.02361,2787.098305,3467.071224,Malicious
192.168.137.97,36276,52.84.103.186,443,4343,3616055,1852,146736,2491,3469319,3707.041764,88.83366891,13214.44914,312432.801,Benign
192.168.137.97,35164,172.217.161.10,443,20,6514,11,1497,9,5017,16.93308741,0.277562452,43147.04642,144601.6913,Benign
10.0.2.15,49606,119.254.87.201,80,11,1513,6,705,5,808,16347.31297,1.221952,4615.565914,5289.896821,Malicious
10.0.2.15,40512,119.254.87.201,80,11,1582,6,705,5,877,25084.52516,0.820947,6870.114636,8546.22771,Malicious
172.30.15.1326,50634,34.233.218.142,443,21,7885,10,1979,11,5906,3488.600514,8.759162,1807.478843,5394.123319,Benign
10.0.2.15,47106,119.254.87.201,80,11,1579,6,705,5,874,15506.44268,1.221827,4616.038113,5722.577746,Malicious
192.168.43.233,51351,139.59.46.160,443,1551,1411872,569,46991,982,1364881,3083.953336,188.127558,1998.261201,58040.66196,Benign
192.168.43.233,51283,54.173.195.251,443,7,402,4,228,3,174,2439.5765,33.702399,54.12077639,41.30269777,Benign
192.168.43.224,43186,185.199.109.153,80,295,215991,138,10347,157,205644,2601.756172,319.6367281,258.968988,5146.942937,Benign
192.168.137.97,59094,54.82.135.50,443,12,869,5,342,7,527,13.95200885,14.61849575,187.1601598,288.4017666,Benign
172.30.15.2018,51330,34.205.118.138,443,6,348,4,228,2,120,4089.47948,8.113774,224.8029092,118.3173206,Benign
172.30.6.255,56068,52.0.91.50,80,13,1699,7,998,6,701,286.544844,64.879217,123.0594383,86.43754132,Benign
10.0.2.15,47342,119.254.87.201,80,11,1513,6,705,5,808,21365.94282,1.055598,5342.943052,6123.543243,Malicious
192.168.43.224,56366,104.17.79.191,443,21,6447,12,1261,9,5186,1279.902216,20.90683198,482.5216948,1984.423084,Benign
192.168.43.233,51269,13.107.21.200,443,35,11778,19,3605,16,8173,2532.193729,60.450315,477.0860168,1081.615538,Benign
192.168.215.49,49220,104.237.191.1,443,59,7300,29,3842,30,3458,510.2623732,306.1219351,100.4044352,90.36921838,Benign
192.168.137.97,46118,104.17.109.77,443,1691,1494135,649,39513,1042,1454622,1641.182226,11.54495004,27380.28307,1007971.101,Benign
172.30.15.2267,51584,52.220.171.90,443,54,29357,28,20251,26,9106,4488.295892,19.333249,8379.760691,3768.016436,Benign
10.0.2.15,51152,124.95.142.227,80,15,6361,8,676,7,5685,177.596903,6.100382,886.5018617,7455.270834,Malicious
172.30.6.255,55943,139.162.37.98,80,7,402,4,228,3,174,152.521682,1.534602,1188.581795,907.0755805,Benign
172.30.6.255,55926,103.231.98.48,80,62,35956,33,28701,29,7255,122.186308,105.29263,2180.665446,551.2256651,Benign
192.168.43.224,56936,52.84.108.179,443,28,8728,16,2308,12,6420,23.3395872,126.0158081,146.5212998,407.5679138,Benign
172.30.6.255,56312,50.57.31.206,80,21,1891,11,1094,10,797,590.941688,265.355869,32.98212334,24.02810996,Benign
10.0.2.15,48014,119.254.87.201,80,11,1593,6,705,5,888,3011.509381,1.678442,3360.259097,4232.496565,Malicious
172.30.6.255,55709,54.194.27.245,443,24,8639,13,3162,11,5477,54.054152,4.697441,5385.059653,9327.631789,Benign
172.30.15.560,49844,151.101.0.84,443,6,348,4,228,2,120,2253.724683,2.48113,735.1489039,386.9204758,Benign
10.0.2.15,55707,119.254.87.201,80,11,1579,6,705,5,874,11394.72719,1.650729,3416.67227,4235.704346,Malicious
10.0.2.15,43295,119.254.87.201,80,11,1513,6,705,5,808,19768.69922,2.191531,2573.543336,2949.536192,Malicious
172.30.15.788,50080,34.200.202.18,443,126,100842,55,10467,71,90375,2674.743773,31.756224,2636.837428,22767.19046,Benign
10.0.2.15,58958,119.254.87.201,80,11,1582,6,705,5,877,26406.15146,0.896084,6294.05279,7829.623116,Malicious
172.30.6.255,55742,52.215.35.189,80,6,348,4,228,2,120,58.211494,0.523451,3484.566846,1833.98255,Benign
192.168.137.97,55848,52.84.108.195,443,28,8764,15,2278,13,6486,19.44440944,129.8529938,140.343318,399.590325,Benign
172.30.15.1383,50691,184.29.26.86,443,12,1423,6,904,6,519,3495.6607,1.357786,5326.317991,3057.919289,Benign
10.0.2.15,48335,119.254.87.201,80,12,1661,7,779,5,882,19230.64322,4.684069,1330.467164,1506.382592,Malicious
10.0.2.15,33307,119.254.87.201,80,11,1582,6,705,5,877,20014.46379,1.485619,3796.397327,4722.610575,Malicious
10.0.2.15,40357,119.254.87.201,80,11,1582,6,705,5,877,13917.40022,1.35378,4166.112662,5182.525964,Malicious
172.30.6.255,57447,54.194.27.245,443,18,6378,9,1141,9,5237,2861.780665,30.065689,303.6018898,1393.482118,Benign
183.61.112.109,10086,192.168.215.71,10031,8,480,8,480,0,0,1181.058804,85.3431206,44.99483934,0,Benign
10.0.2.15,57356,119.254.87.201,80,11,1582,6,705,5,877,11905.15305,1.49653,3768.718302,4688.178653,Malicious
192.168.43.224,44872,157.240.16.52,443,51,9300,28,2992,23,6308,1223.987562,80.14420202,298.6616548,629.6650129,Benign
172.30.15.1649,50960,184.29.25.7,443,180,148787,74,12007,106,136780,3578.790924,8.70815,11030.58629,125656.9995,Benign
172.30.1.136,50328,157.240.16.20,443,23,6965,13,2870,10,4095,569.032744,45.247109,507.4357347,724.0241581,Benign
192.168.137.97,46434,74.50.21.249,80,10,1384,5,727,5,657,568.8701864,0.840731662,6917.783953,6251.697465,Benign
192.168.215.37,51786,74.125.68.188,5228,9,676,0,0,9,676,1305.293936,59.99797718,0,90.13637216,Benign
172.30.15.2103,51415,52.86.72.168,443,16,2836,8,2004,8,832,4146.228337,1.469965,10906.38212,4527.998966,Benign
10.0.2.15,50413,119.254.87.201,80,11,1579,6,705,5,874,16380.24911,1.221509,4617.239824,5724.067526,Malicious
10.0.2.15,51734,119.254.87.201,80,11,1579,6,705,5,874,5023.572497,0.955696,5901.458204,7316.134001,Malicious
10.0.2.15,43547,119.254.87.201,80,12,1608,7,779,5,829,15809.49,4.456679,1398.350655,1488.103586,Malicious
172.30.15.2229,51546,184.29.25.145,443,6,348,4,228,2,120,4457.550769,10.120899,180.2211444,94.85323389,Benign
172.30.6.255,58485,103.243.221.87,80,24,13603,12,5401,12,8202,5682.84393,6.404875,6746.11136,10244.69642,Benign
172.30.15.587,49872,104.24.1.12,443,28,8268,15,1926,13,6342,2310.514502,5.660436,2722.0518,8963.267141,Benign
192.168.43.233,50694,151.101.152.188,443,14,8982,5,799,9,8183,1837.370973,0.629742,10150.18849,103953.6826,Benign
10.0.2.15,40831,119.254.87.201,80,11,1513,6,705,5,808,23012.24837,2.181979,2584.809478,2962.44831,Malicious
172.30.15.1793,51105,104.244.42.195,443,23,3852,12,2184,11,1668,3643.253979,3.924923,4451.552298,3399.81192,Benign
192.168.43.224,41896,23.251.156.28,443,1098,886685,462,44035,636,842650,715.0901625,172.8017905,2038.636283,39011.16985,Benign
10.0.2.15,55387,119.254.87.201,80,11,1579,6,705,5,874,26048.686,0.828317,6808.98738,8441.212724,Malicious
10.0.2.15,52491,119.254.87.201,80,11,1579,6,705,5,874,21810.90595,1.631731,3456.452075,4285.020019,Malicious
172.30.15.973,50279,199.166.0.201,80,12,1497,6,857,6,640,3442.48497,0.738316,9285.996782,6934.700047,Benign
172.30.15.990,50296,52.220.73.112,80,6,348,4,228,2,120,3442.847773,4.215206,432.7190652,227.7468764,Benign
172.30.1.136,51807,157.240.16.39,443,8,456,5,282,3,174,2977.807738,45.188599,49.92409701,30.80423007,Benign
10.0.2.15,37718,119.254.87.201,80,11,1582,6,705,5,877,14127.67385,1.685926,3345.34256,4161.511241,Malicious
172.30.1.136,50572,13.107.4.52,80,10,1519,5,436,5,1083,1568.148659,0.32523,10724.71789,26639.60889,Benign
10.0.2.15,46222,119.254.87.201,80,11,1582,6,705,5,877,1840.201637,2.869314,1965.626627,2445.183762,Malicious
192.168.137.97,44390,139.59.27.59,443,173,113387,89,5975,84,107412,3468.892817,61.54762783,776.6343186,13961.48041,Benign
10.0.2.15,45331,119.254.87.201,80,11,1582,6,705,5,877,10879.26094,2.011119,2804.408889,3488.6051,Malicious
10.0.2.15,42740,119.254.87.201,80,11,1513,6,705,5,808,20159.04942,1.697218,3323.08519,3808.585579,Malicious
172.30.6.255,58228,157.240.16.39,443,5,330,1,66,4,264,5181.087877,15.062358,35.05427238,140.2170895,Benign
172.30.15.1625,50935,184.29.25.7,443,876,807674,321,79500,555,728174,3574.562618,32.475092,19584.24013,179380.3078,Benign
172.30.6.255,58014,103.243.221.46,80,85,65107,55,56214,30,8893,4761.871806,12.176676,36932.24653,5842.645398,Benign
172.30.6.255,56525,23.198.119.247,443,24,10153,13,1624,11,8529,831.968408,41.616801,312.1816115,1639.53015,Benign
172.30.15.656,49943,172.217.160.226,80,95,70692,41,6275,54,64417,2396.538404,9.658062,5197.730145,53358.11677,Benign
172.30.15.1665,50976,184.29.25.7,443,12,1423,6,904,6,519,3590.844804,6.53532,1106.602278,635.3170158,Benign
10.0.2.15,40309,119.254.87.201,80,11,1579,6,705,5,874,13854.75731,0.827235,6817.893343,8452.253592,Malicious
10.0.2.15,58903,119.254.87.201,80,11,1582,6,705,5,877,15596.53847,1.220168,4622.314304,5750.027865,Malicious
10.0.2.15,36556,119.254.87.201,80,12,1653,7,779,5,874,18267.12627,4.432851,1405.86724,1577.314464,Malicious
10.0.2.15,37148,119.254.87.201,80,11,1513,6,705,5,808,15534.25313,1.428156,3949.148412,4526.116195,Malicious
192.168.137.97,48654,54.255.158.169,443,16,5129,9,1245,7,3884,347.745869,15.4277888,645.5883037,2014.02809,Benign
192.168.43.233,51226,117.18.237.29,80,11,1756,6,686,5,1070,1301.177559,60.831488,90.21643528,140.7165973,Benign
172.30.15.1405,50713,217.12.15.83,443,20,8075,10,1794,10,6281,3499.958978,7.170391,2001.564489,7007.707111,Benign
172.30.6.255,55924,103.231.98.48,80,15,5133,8,3934,7,1199,122.150194,43.772912,718.9834663,219.1309548,Benign
10.0.2.15,41891,119.254.87.201,80,11,1582,6,705,5,877,20429.31502,2.230929,2528.094798,3144.87821,Malicious
10.0.2.15,58863,119.254.87.201,80,11,1582,6,705,5,877,20969.893,1.680298,3356.54747,4175.449831,Malicious
10.0.2.15,50211,119.254.87.201,80,11,1513,6,705,5,808,4487.309732,1.543106,3654.966023,4188.953967,Malicious
10.0.2.15,35641,119.254.87.201,80,11,1582,6,705,5,877,7428.256026,1.015463,5554.116694,6909.163603,Malicious
192.168.43.233,51638,74.125.130.188,443,74,5678,39,3001,35,2677,839.502729,1399.074903,17.15991042,15.30725764,Benign
10.0.2.15,47790,119.254.87.201,80,11,1579,6,705,5,874,8901.865737,2.118724,2661.979569,3300.099494,Malicious
172.30.15.577,49861,54.209.36.227,443,19,7376,11,1285,8,6091,2260.849442,5.183369,1983.266096,9400.835634,Benign
172.30.6.255,56496,184.85.113.82,443,21,8944,10,1008,11,7936,820.135902,61.26027,131.6350711,1036.365005,Benign
192.168.43.224,47474,52.20.111.213,443,16,4978,9,1245,7,3733,35.64632505,12.58662089,791.3164371,2372.67812,Benign
192.168.43.224,39086,103.37.200.184,443,200,136744,101,8371,99,128373,2542.337744,23.04388947,2906.106631,44566.4349,Benign
10.0.2.15,38435,119.254.87.201,80,12,1587,7,779,5,808,342.786149,4.707383,1323.877832,1373.162116,Malicious
172.30.1.136,50330,157.240.16.20,443,27,7228,15,3002,12,4226,569.035767,45.242956,530.8229639,747.2544455,Benign
172.30.15.316,49579,14.139.45.149,80,12,2546,6,714,6,1832,731.153974,0.096633,59110.24184,151666.6149,Benign
172.30.6.255,57159,103.243.220.231,80,51,39616,18,9424,33,30192,1941.902325,20.125704,3746.055293,12001.369,Benign
172.30.15.2487,51821,14.139.45.128,80,224,218036,72,4307,152,213729,5432.335212,2.420612,14234.41675,706363.5147,Benign
10.0.2.15,47064,119.254.87.201,80,11,1582,6,705,5,877,6134.523634,1.38518,4071.672996,5065.045698,Malicious
172.30.15.1750,51062,103.254.155.35,443,17,6752,9,1598,8,5154,3637.689101,9.487566,1347.447807,4345.898621,Benign
172.30.15.1900,51212,52.204.146.6,443,26,6455,14,1940,12,4515,3983.852438,3.616292,4291.688835,9988.131489,Benign
192.168.43.233,51402,172.217.161.14,443,18,5759,9,1285,9,4474,3626.702485,19.716832,521.381934,1815.301769,Benign
192.168.43.233,51163,74.125.170.249,443,18,2316,9,1492,9,824,481.886763,20.682019,577.119671,318.7309711,Benign
192.168.137.97,48486,104.244.46.7,443,517,375180,232,17360,285,357820,1747.904969,1197.091787,116.0144957,2391.261915,Benign
192.168.43.224,33458,172.217.166.206,443,14,987,7,462,7,525,42.08740588,141.1304903,26.18852944,29.75969255,Benign
192.168.215.49,58812,104.25.50.33,443,64,22552,30,2619,34,19933,789.0086706,400.3656257,52.33216504,398.2959319,Benign
10.0.2.15,39572,119.254.87.201,80,13,1730,8,853,5,877,20401.82984,10.631583,641.8611415,659.9205405,Malicious
172.30.15.1770,51082,184.29.24.149,443,37,22375,18,4368,19,18007,3641.244676,5.92261,5900.101476,24323.06027,Benign
192.168.137.97,39746,192.168.125.6,80,450,352686,224,17096,226,335590,8298.913128,30.82734469,4436.580619,87088.91495,Benign
192.168.43.224,47562,52.20.111.213,443,6,412,4,272,2,140,57.07314669,14.23404382,152.8729311,78.68459688,Benign
10.0.2.15,47988,119.254.87.201,80,11,1582,6,705,5,877,10518.90481,0.95394,5912.32153,7354.760257,Malicious
172.30.6.255,58406,103.243.221.51,80,3,198,3,198,0,0,5550.877543,9.001328,175.9740341,0,Benign
10.0.2.15,40232,119.254.87.201,80,13,1730,8,853,5,877,18056.84121,19.469442,350.4979752,360.359583,Malicious
172.30.15.827,50126,172.217.166.196,443,18,3097,10,1502,8,1595,3104.308793,1.6651,7216.3834,7663.203411,Benign
192.168.137.97,52756,184.29.25.201,443,28,9266,15,2548,13,6718,349.3887643,1.920241222,10615.33299,27988.15033,Benign
172.30.15.516,49799,172.25.10.63,7680,3,198,3,198,0,0,2106.774271,9.01622,175.6833795,0,Benign
172.30.6.255,58265,157.240.16.20,443,95,64127,43,3701,52,60426,5272.375815,51.838763,571.1556042,9325.222517,Benign
172.30.6.255,56203,103.243.221.17,80,6,340,4,228,2,112,467.051395,23.985388,76.04629952,37.35607696,Benign
172.30.6.255,58109,103.243.221.87,80,25,17702,10,5293,15,12409,4891.848268,7.249081,5841.292158,13694.42554,Benign
192.168.43.233,51161,182.161.72.94,443,18,3501,8,2070,10,1431,951.400765,16.433514,1007.696832,696.6252014,Benign
10.0.2.15,39683,119.254.87.201,80,11,1593,6,705,5,888,21242.69706,1.289518,4373.727238,5509.035159,Malicious
192.168.43.224,60860,151.101.153.140,443,60,11164,31,3488,29,7676,114.7252122,601.2002164,46.41382228,102.1423451,Benign
172.30.1.136,50471,74.125.24.188,443,2,132,2,132,0,0,881.33673,2.999655,352.0404847,0,Benign
192.168.215.49,43610,34.227.208.227,443,22,5464,12,1443,10,4021,552.7496418,81.53153279,141.5893901,394.5467343,Benign
192.168.137.97,54650,52.91.99.99,443,7,478,4,272,3,206,375.3757292,7.079084503,307.3843799,232.7984642,Benign
172.30.15.1039,50345,209.15.36.33,443,19,6384,11,1882,8,4502,3447.549423,9.394965,1602.56052,3833.542754,Benign
172.30.6.255,56511,23.198.119.247,443,13,3675,8,1231,5,2444,831.967944,41.616296,236.6380708,469.8159586,Benign
172.30.6.255,56966,103.243.220.231,80,23,13635,10,5275,13,8360,1417.845514,18.38383,2295.495552,3637.979681,Benign
172.30.6.255,56264,52.8.9.72,80,13,2134,7,837,6,1297,530.107737,61.274044,109.2795507,169.3376073,Benign
172.30.15.1702,51013,157.240.16.20,443,144,123840,52,3795,92,120045,3611.506757,5.621463,5400.729312,170838.0897,Benign
172.30.6.255,58360,172.217.166.206,443,32,4853,18,2661,14,2192,5464.400156,95.795053,222.224419,183.0574696,Benign
192.168.43.224,39066,103.37.200.184,443,21,3121,12,2132,9,989,2513.962261,27.99141238,609.329739,282.65812,Benign
192.168.43.233,51365,204.79.197.229,443,73,33032,38,13080,35,19952,3201.962022,5.630217,18585.4293,28349.88421,Benign
192.168.43.233,51143,104.198.94.254,443,8,468,5,294,3,174,925.525632,14.271037,164.8093268,97.54021379,Benign
172.30.6.255,58088,122.15.34.40,80,113,93777,44,4567,69,89210,4857.692261,14.824977,2464.48949,48140.37823,Benign
172.30.6.255,58390,157.240.16.17,443,6,348,4,228,2,120,5523.925981,11.954207,152.5822666,80.30645613,Benign
10.0.2.15,60055,119.254.87.201,80,11,1559,6,705,5,854,17912.18161,1.356267,4158.473221,5037.356214,Malicious
10.0.2.15,42464,119.254.87.201,80,11,1582,6,705,5,877,7005.365681,2.148193,2625.462424,3266.000774,Malicious
172.30.15.2302,51631,34.192.34.151,443,45,27526,27,23081,18,4445,4962.887623,1.91817,96262.58361,18538.50284,Benign
192.168.43.233,51322,172.217.166.197,443,2153,1311640,916,139574,1237,1172066,3003.907382,268.70397,4155.472656,34895.3832,Benign
172.30.6.255,57766,157.240.16.39,443,29,5480,15,3275,14,2205,3961.09041,61.0743,428.9856781,288.8285253,Benign
10.0.2.15,57626,119.254.87.201,80,11,1582,6,705,5,877,7638.521779,2.194656,2569.878833,3196.856364,Malicious
172.30.10.168,62078,172.30.6.255,57113,3,198,0,0,3,198,1820.379486,9.006485,0,175.8732735,Benign
172.30.1.136,50618,52.30.87.88,443,10,660,3,198,7,462,1629.281073,24.124625,65.6590517,153.204454,Benign
172.30.15.2042,51354,52.86.72.168,443,21,8067,10,2161,11,5906,4090.894467,6.698737,2580.785005,7053.269893,Benign
172.30.6.255,56936,103.15.158.189,80,5,294,3,174,2,120,1387.651574,16.706751,83.31961134,57.46180092,Benign
172.30.1.136,50607,157.240.16.20,443,31,11473,13,3347,18,8126,1613.286194,103.502449,258.6991927,628.0817568,Benign
172.30.15.1626,50936,184.29.25.7,443,224,190027,89,19234,135,170793,3574.563296,2.502534,61486.47731,545984.1904,Benign
172.30.6.255,57626,172.30.13.95,7680,3,198,3,198,0,0,3448.674842,8.98112,176.369985,0,Benign
192.168.43.233,50888,54.239.25.120,443,56,20837,29,12582,27,8255,120.746764,10.586203,9508.224998,6238.308485,Benign
10.0.2.15,60504,119.254.87.201,80,11,1513,6,705,5,808,20314.81119,1.430035,3943.959414,4520.169087,Malicious
10.0.2.15,38593,119.254.87.201,80,11,1513,6,705,5,808,10368.72703,1.294298,4357.574531,4994.213079,Malicious
172.30.15.1705,51016,157.240.16.20,443,16,4988,8,1037,8,3951,3613.719844,0.271605,30544.35669,116374.8826,Benign
192.168.137.97,36960,18.211.245.141,443,11,742,6,404,5,338,22.72263342,18.57023643,174.0419414,145.609347,Benign
10.0.2.15,55719,119.254.87.201,80,12,1653,7,779,5,874,7578.442631,4.386472,1420.731741,1593.991709,Malicious
192.168.215.49,42980,158.85.224.178,443,29,8015,15,3129,14,4886,1304.785176,1.26108059,19849.64339,30995.64002,Benign
172.30.6.255,55684,104.20.58.225,80,17,5570,9,935,8,4635,41.953374,16.649459,449.263847,2227.099391,Benign
192.168.43.233,51258,172.82.241.224,443,23,5503,11,3366,12,2137,1946.042043,43.686073,616.3978163,391.3375322,Benign
172.30.1.136,51903,23.57.209.77,80,19,5908,9,723,10,5185,4759.616955,60.693505,95.29850023,683.4339193,Benign
192.168.137.97,56730,103.231.98.48,443,20,7095,11,1377,9,5718,376.9892159,13.09473535,841.2541153,3493.312296,Benign
10.0.2.15,54531,119.254.87.201,80,12,1653,7,779,5,874,1239.502084,5.312213,1173.14573,1316.212283,Malicious
10.0.2.15,54542,115.182.31.2,80,8,756,4,500,4,256,83.059936,62.161823,64.34817718,32.94626671,Malicious
172.30.6.255,56425,38.106.10.133,80,6,348,4,228,2,120,678.979124,19.170656,95.14541391,50.07653364,Benign
172.30.6.255,57354,103.243.221.51,80,20,9700,10,4270,10,5430,2510.854819,17.176343,1988.781896,2529.059882,Benign
172.30.6.255,57082,172.30.10.168,80,3,198,3,198,0,0,1685.320854,9.001565,175.9694009,0,Benign
192.168.43.233,51276,13.107.21.200,443,33,14649,19,1617,14,13032,2702.036894,9.932091,1302.444772,10496.88328,Benign
172.30.15.380,49648,62.210.213.13,80,6,348,4,228,2,120,1455.350979,5.192068,351.3051062,184.8974243,Benign
172.30.15.433,49707,59.63.81.183,443,56,15908,29,4305,27,11603,1623.384199,7.485313,4601.010005,12400.81744,Benign
192.168.137.97,39756,172.217.167.10,443,19,4910,10,1286,9,3624,94.32649953,44.65865329,230.3696875,649.1910943,Benign
172.30.6.255,57094,172.30.10.168,139,3,198,3,198,0,0,1737.339167,9.005798,175.8866899,0,Benign
10.0.2.15,57600,119.254.87.201,80,11,1579,6,705,5,874,20975.37298,1.323436,4261.63411,5283.217322,Malicious
10.0.2.15,51540,119.254.87.201,80,11,1579,6,705,5,874,13341.80307,4.434728,1271.780366,1576.646865,Malicious
172.30.1.136,50391,157.240.16.20,443,3,198,3,198,0,0,743.403371,9.001961,175.9616599,0,Benign
172.30.6.255,55665,122.15.34.33,80,10,1997,6,740,4,1257,38.297415,20.280719,291.902866,495.8404088,Benign
172.30.6.255,56928,115.114.126.213,443,105,54861,39,10756,66,44105,1386.864773,170.272765,505.3538656,2072.20456,Benign
172.30.6.255,57620,103.243.221.87,80,71,48209,42,40186,29,8023,3430.836292,20.232961,15889.3204,3172.249479,Benign
192.168.43.224,40598,172.217.166.195,443,13,921,6,396,7,525,18.11940597,145.6635932,21.74874264,28.83356032,Benign
192.168.137.97,47194,157.240.16.20,443,11,758,7,478,4,280,224.4326554,60.94623314,62.7438285,36.75370707,Benign
172.30.6.255,56673,173.241.248.220,80,9,2032,6,1554,3,478,1134.696485,15.551252,799.4211656,245.8966005,Benign
172.30.6.255,56376,103.243.221.46,80,31,22207,12,4984,19,17223,631.878453,17.596746,2265.873475,7830.084039,Benign
172.30.6.255,57870,157.240.16.39,443,27,5466,15,3411,12,2055,4266.090081,61.0415,447.0401284,269.3249674,Benign
10.0.2.15,49577,119.254.87.201,80,11,1579,6,705,5,874,7127.912631,2.027097,2782.303955,3449.267598,Malicious
172.30.6.255,58470,216.58.196.162,80,10,1609,6,939,4,670,5673.159546,5.923615,1268.144537,904.8528643,Benign
172.30.15.814,50109,172.30.30.101,7680,3,198,3,198,0,0,2935.642989,8.883378,178.3105481,0,Benign
172.30.6.255,56290,54.246.129.36,80,10,1555,6,872,4,683,569.160113,19.885061,350.8161227,274.779142,Benign
172.30.6.255,58553,103.243.221.46,80,30,18130,18,15075,12,3055,5814.098238,5.130744,23505.36296,4763.441715,Benign
10.0.2.15,56798,119.254.87.201,80,11,1579,6,705,5,874,22261.35183,4.413392,1277.928632,1584.26897,Malicious
192.168.43.224,57166,172.217.166.202,443,15,1053,7,462,8,591,12.4834793,191.1016788,19.34048944,24.74075597,Benign
192.168.43.224,49166,157.240.16.39,443,33,6329,16,3193,17,3136,343.7394216,65.88608047,387.6994931,380.7784561,Benign
192.168.215.49,50120,217.12.15.83,443,20,8071,11,2144,9,5927,480.1846298,28.63029819,599.0856221,1656.147613,Benign
10.0.2.15,50671,119.254.87.201,80,11,1513,6,705,5,808,6619.583841,1.359142,4149.676781,4755.941616,Malicious
10.0.2.15,56105,119.254.87.201,80,11,1560,6,705,5,855,19714.16131,4.384229,1286.429153,1560.137484,Malicious
172.30.15.1470,50778,104.36.113.23,443,23,6068,11,4944,12,1124,3507.403025,10.06232,3930.703854,893.6308923,Benign
192.168.43.224,53306,151.101.152.143,443,19,7754,11,1344,8,6410,94.083839,12.16764177,883.6552066,4214.456752,Benign
192.168.43.233,51400,172.217.161.14,443,26,9277,13,2300,13,6977,3626.455816,19.962948,921.7075554,2795.979832,Benign
172.30.6.255,58035,35.230.55.83,80,28,12932,14,3978,14,8954,4814.594286,58.147626,547.2966343,1231.89896,Benign
172.30.6.255,56892,103.231.98.244,80,21,12222,13,10933,8,1289,1385.018043,4.303921,20321.93435,2395.954758,Benign
172.30.6.255,57699,103.243.221.87,80,33,23543,13,4714,20,18829,3678.864924,34.182645,1103.249909,4406.680642,Benign
10.0.2.15,58963,119.254.87.201,80,11,1534,6,705,5,829,17128.19247,3.1904,1767.80341,2078.736209,Malicious
172.30.15.1584,50893,184.29.25.7,443,22,7985,11,1678,11,6307,3571.02616,6.038739,2222.980659,8355.386779,Benign
172.30.6.255,56820,103.243.221.51,80,23,9917,13,7806,10,2111,1286.855914,25.209433,2477.167971,669.9079666,Benign
10.0.2.15,53475,119.254.87.201,80,11,1560,6,705,5,855,190.714569,1.74131,3238.940797,3928.077137,Malicious
10.0.2.15,43938,119.254.87.201,80,11,1551,6,705,5,846,11392.32183,1.701948,3313.849777,3976.619732,Malicious
172.30.6.255,57640,103.243.221.46,80,25,19666,9,4498,16,15168,3496.850974,1.418391,25369.59132,85550.45823,Benign
172.30.15.1644,50954,184.29.25.7,443,702,627794,263,65143,439,562651,3577.135433,29.902099,17428.34174,150531.5062,Benign
172.30.15.1497,50805,52.85.51.65,443,19,2596,11,1635,8,961,3520.986129,6.142604,2129.390076,1251.586461,Benign
10.0.2.15,38318,119.254.87.201,80,11,1586,6,709,5,877,24.141309,1.943787,2918.015194,3609.448978,Malicious
172.30.15.2263,51580,104.121.244.70,443,147,111958,67,12164,80,99794,4487.736156,29.843182,3260.778291,26751.57093,Benign
172.30.6.255,57519,157.240.16.39,443,27,5454,15,3399,12,2055,3107.082257,61.046177,445.4332988,269.3043333,Benign
192.168.137.97,34520,172.217.161.19,443,44,8058,20,2582,24,5476,346.6973814,240.7107881,85.81252284,181.9943358,Benign
172.30.6.255,58206,103.243.221.87,80,25,14382,11,5347,14,9035,5155.860398,8.254855,5181.920215,8756.059313,Benign
172.30.6.255,55738,172.217.167.2,80,10,2136,6,954,4,1182,58.139786,0.436869,17469.76783,21644.93246,Benign
172.30.15.482,49757,172.217.166.196,443,7,402,4,228,3,174,1730.353166,10.575339,172.4767405,131.6269861,Benign
172.30.6.255,58380,210.176.156.21,80,13,4249,7,3917,6,332,5485.112921,1.173241,26708.91999,2263.81451,Benign
172.30.15.1535,50843,151.101.66.110,443,46,24316,23,2337,23,21979,3528.458089,8.545012,2187.943095,20577.15074,Benign
172.30.15.1356,50664,103.243.220.231,443,20,6422,11,4812,9,1610,3493.095403,4.241043,9077.012424,3036.988778,Benign
172.30.1.136,50637,172.217.160.228,443,18,1080,10,600,8,480,1739.071267,36.042553,133.1759157,106.5407326,Benign
10.0.2.15,56210,119.254.87.201,80,11,1579,6,705,5,874,8301.319375,2.016273,2797.240255,3467.784372,Malicious
172.30.15.1838,51150,35.161.208.104,443,20,8092,9,2124,11,5968,3867.154309,10.265552,1655.244647,4650.894565,Benign
10.0.2.15,41036,119.254.87.201,80,11,1579,6,705,5,874,20279.15953,2.02391,2786.685179,3454.699073,Malicious
192.168.43.224,33940,52.84.108.93,443,77,42629,41,4273,36,38356,2848.410658,158.0042077,216.3486688,1942.024231,Benign
192.168.43.224,45658,209.197.3.15,80,39,19626,20,1515,19,18111,804.2730387,30.09161474,402.770011,4814.896151,Benign
172.30.1.136,50796,151.101.129.181,443,67,32337,31,3392,36,28945,1931.886671,26.093521,1039.951642,8874.233569,Benign
10.0.2.15,36805,119.254.87.201,80,11,1582,6,705,5,877,9260.243195,1.890513,2983.317227,3711.161997,Malicious
172.30.15.518,49801,23.9.250.106,443,67,40026,27,5073,40,34953,2124.085391,1.960478,20701.07392,142630.5217,Benign
172.30.15.1596,50905,172.217.166.198,443,15,5181,7,1165,8,4016,3572.939099,0.403042,23124.14091,79713.77673,Benign
172.30.6.255,55696,103.243.221.87,80,13,4556,8,2995,5,1561,53.188723,5.573136,4299.195283,2240.749194,Benign
192.168.43.233,51001,104.244.42.195,443,8,456,4,228,4,228,526.584966,22.813936,79.95113162,79.95113162,Benign
192.168.43.224,34318,172.217.166.206,443,7,466,4,272,3,194,1375.915714,78.63250032,27.67303585,19.73738586,Benign
10.0.2.15,39909,119.254.87.201,80,11,1579,6,705,5,874,24819.77585,1.023149,5512.393601,6833.804265,Malicious
172.30.15.1107,50415,122.15.34.17,80,10,1567,6,1091,4,476,3458.264859,8.767208,995.5278807,434.3458031,Benign
172.30.6.255,57472,103.243.221.109,80,39,24310,23,20217,16,4093,2991.844023,14.18355,11403.06905,2308.589881,Benign
172.30.6.255,56265,103.243.223.145,443,30,12689,17,4760,13,7929,530.275373,76.155751,500.0278968,832.9246205,Benign
172.30.6.255,56208,119.42.60.92,80,11,1676,6,807,5,869,469.716408,31.283851,206.3684551,222.2232806,Benign
10.0.2.15,40570,219.234.85.243,80,11,1631,6,796,5,835,186.789882,4.29405,1482.982266,1555.640945,Malicious
172.30.6.255,55728,52.215.35.189,80,10,1738,6,1274,4,464,58.0837,0.664596,15335.63247,5585.348091,Benign
192.168.215.49,55852,156.154.202.36,443,21,8124,10,2646,11,5478,511.8956946,1.452339944,14575.10006,30174.75363,Benign
10.0.2.15,52576,119.254.87.201,80,11,1558,6,705,5,853,12981.31738,3.167619,1780.517164,2154.299491,Malicious
192.168.43.233,51126,40.100.141.2,443,1,54,0,0,1,54,8.710218,0,0,0,Benign
192.168.43.233,51254,163.53.78.128,80,8,668,5,282,3,386,1939.520134,10.899146,206.9886943,283.3249504,Benign
172.30.6.255,56803,172.217.166.206,443,51,10844,29,7396,22,3448,1265.462077,87.032877,679.8350467,316.9377016,Benign
192.168.137.97,51744,172.217.161.3,443,16,2049,11,1563,5,486,3759.495269,107.1185787,116.730451,36.29622469,Benign
192.168.137.97,42636,122.15.34.26,80,40,5426,21,2184,19,3242,38.7404048,591.2176965,29.55256601,43.86878159,Benign
172.30.15.1194,50502,103.71.26.125,80,7,398,4,228,3,170,3465.364885,1.858146,981.6236184,731.912347,Benign
192.168.137.97,45574,104.17.41.113,443,7,410,4,236,3,174,1766.994231,51.08982555,36.95452039,27.24612944,Benign
192.168.43.233,51294,23.9.140.60,80,23,6292,12,4774,11,1518,2812.332671,8.107745,4710.557621,1497.827078,Benign
172.30.6.255,57542,157.240.16.39,443,27,5452,15,3397,12,2055,3168.091663,61.03125,445.2800819,269.3701997,Benign
192.168.215.49,33134,52.206.154.207,443,27,6774,13,2006,14,4768,554.2554035,10.93483072,1467.603881,3488.302744,Benign
10.0.2.15,41961,119.254.87.201,80,11,1582,6,705,5,877,24156.5161,2.133631,2643.381166,3288.291181,Malicious
10.0.2.15,59512,119.254.87.201,80,11,1513,6,705,5,808,15203.94187,1.090733,5170.834659,5926.289935,Malicious
10.0.2.15,41146,119.254.87.201,80,11,1513,6,705,5,808,10131.051,2.93976,1918.523961,2198.818951,Malicious
192.168.43.233,51317,104.25.14.32,443,410,269575,184,14047,226,255528,3362.719579,415.5169,270.4486869,4919.713254,Benign
172.30.15.926,50232,50.23.131.235,443,23,6923,12,1760,11,5163,3440.647838,6.616358,2128.058971,6242.709358,Benign
10.0.2.15,55221,119.254.87.201,80,11,1579,6,705,5,874,14963.62952,1.423562,3961.892773,4911.623098,Malicious
192.168.215.28,62439,157.240.16.11,443,2,202,0,0,2,202,253.2815984,120.3586182,0,13.42654165,Benign
172.30.6.255,55889,184.84.52.113,80,135,112322,45,6699,90,105623,112.010973,299.713103,178.8110011,2819.309505,Benign
172.30.15.2366,51700,205.185.208.52,80,56,42642,21,1469,35,41173,5332.943266,11.558044,1016.78104,28498.24763,Benign
172.30.6.255,56851,103.243.220.231,80,52,38236,31,33871,21,4365,1352.831115,23.228089,11665.53133,1503.352256,Benign
10.0.2.15,33533,119.254.87.201,80,11,1582,6,705,5,877,18182.5282,1.198908,4704.280896,5851.991979,Malicious
172.30.1.136,51543,172.217.161.14,443,59,18755,28,6755,31,12000,712.929564,28.166738,1918.575023,3408.275392,Benign
192.168.43.224,47480,52.20.111.213,443,11,742,6,404,5,338,35.89671242,15.5222957,208.2166236,174.2010366,Benign
172.30.6.255,57030,172.30.16.59,7680,3,198,3,198,0,0,1556.845309,9.003403,175.9334776,0,Benign
172.30.1.136,50312,104.244.42.1,443,107,60646,48,5750,59,54896,561.877338,68.069338,675.7815097,6451.774219,Benign
192.168.43.224,57230,172.217.194.188,5228,7,466,4,272,3,194,14.60973069,55.57466356,39.15453303,27.92639488,Benign
172.30.15.2189,51501,31.24.224.56,443,18,7708,8,1066,10,6642,4282.253143,1.162679,7334.784579,45701.35007,Benign
192.168.43.233,51270,172.82.241.224,443,36,10839,18,8840,18,1999,1975.041489,40.887718,1729.614746,391.1198957,Benign
192.168.137.97,39764,172.217.161.4,443,16,1789,8,1121,8,668,1048.810095,50.26172337,178.4260347,106.3234533,Benign
172.30.6.255,57967,103.243.221.75,80,38,24303,23,20263,15,4040,4646.836994,50.220962,3227.815509,643.5559717,Benign
192.168.43.224,44578,192.168.121.2,443,7,518,7,518,0,0,2461.522477,64.80175361,63.94888671,0,Benign
192.168.43.224,39598,52.84.110.101,443,10,696,6,404,4,292,35.89688757,14.13198733,228.701026,165.2987613,Benign
10.0.2.15,58598,119.254.87.201,80,11,1582,6,705,5,877,22357.03766,0.960636,5871.110389,7303.494768,Malicious
192.168.43.224,38486,140.98.193.112,443,95,69374,44,8830,51,60544,3261.34537,5.009255551,14101.89584,96691.41354,Benign
172.30.6.255,56107,103.243.221.87,443,23,8950,12,3378,11,5572,306.405193,18.410856,1467.829633,2421.180199,Benign
172.30.1.136,50660,193.32.65.35,443,14,3660,7,1033,7,2627,1783.842621,1.311676,6300.336364,16022.2494,Benign
172.30.1.136,50261,104.17.38.113,443,1,66,1,66,0,0,461.652643,0,0,0,Benign
172.30.6.255,58004,52.229.175.79,443,31,10230,17,2326,14,7904,4737.777964,101.934523,182.5485562,620.3197713,Benign
172.30.6.255,56088,151.101.194.49,80,6,348,4,228,2,120,305.824794,18.178693,100.3372465,52.80907709,Benign
10.0.2.15,55063,119.254.87.201,80,13,1727,8,853,5,874,15416.43284,10.16178,671.5358923,688.068429,Malicious
172.30.6.255,56182,103.243.221.17,80,35,24218,14,5966,21,18252,464.870238,26.166302,1824.02542,5580.307068,Benign
172.30.6.255,57840,103.243.221.109,80,59,44793,22,9901,37,34892,4162.896778,43.143159,1835.934174,6469.994467,Benign
172.30.6.255,56442,213.155.156.183,443,18,5810,10,1651,8,4159,700.568928,1.507113,8763.77551,22076.64588,Benign
10.0.2.15,54046,119.254.87.201,80,11,1582,6,705,5,877,5804.175372,1.625821,3469.016577,4315.35821,Malicious
172.30.6.255,58318,52.213.19.114,443,18,4641,10,3757,8,884,5354.574651,4.561314,6589.329303,1550.430424,Benign
10.0.2.15,48116,119.254.87.201,80,12,1653,7,779,5,874,19498.38511,6.179455,1008.503177,1131.491369,Malicious
192.168.137.97,33448,52.94.216.31,443,42,9065,22,2284,20,6781,3721.449264,145.2947538,125.7581538,373.3651668,Benign
192.168.43.224,50956,23.251.156.28,443,138,98552,65,5573,73,92979,2651.716008,159.5152022,279.4968717,4663.079065,Benign
192.168.215.49,49546,172.217.161.14,443,18,6025,9,1389,9,4636,460.4997279,12.19402842,911.2657128,3041.488729,Benign
172.30.15.1591,50900,103.254.155.35,443,35,15023,19,5163,16,9860,3572.417096,4.754161,8687.968287,16591.78139,Benign
172.30.6.255,56603,103.231.98.53,80,39,17411,20,15665,19,1746,951.842701,60.112245,2084.76659,232.3653026,Benign
172.30.6.255,57490,161.69.226.18,443,36,8680,21,4945,15,3735,3052.048865,332.692191,118.9087122,89.81274827,Benign
10.0.2.15,33965,119.254.87.201,80,11,1582,6,705,5,877,12771.05703,2.018579,2794.044722,3475.71237,Malicious
172.30.15.2337,51671,34.232.42.95,443,27,10535,14,3481,13,7054,5220.713832,7.339191,3794.423663,7689.130859,Benign
10.0.2.15,39067,119.254.87.201,80,11,1534,6,705,5,829,16287.36461,2.010901,2804.712912,3298.02412,Malicious
172.30.15.1044,50350,52.45.111.226,443,7,402,4,228,3,174,3447.781083,8.204668,222.312469,169.6595158,Benign
172.30.6.255,56311,52.221.7.77,80,14,3328,8,2216,6,1112,590.941644,61.101056,290.1422849,145.594865,Benign
172.30.1.136,50139,172.217.161.14,443,68,13518,33,3889,35,9629,114.857615,250.420691,124.2389352,307.6103644,Benign
192.168.42.240,51006,172.217.163.67,443,219,29082,89,14658,130,14424,378.915683,228.326677,513.5799353,505.3811561,Benign
172.30.1.136,50780,74.125.68.188,5228,2,132,2,132,0,0,1925.108251,2.99969,352.0363771,0,Benign
172.30.15.2006,51318,52.84.108.203,443,35,11353,17,2361,18,8992,4079.55865,3.009199,6276.753382,23905.36485,Benign
192.168.43.224,45940,104.31.92.239,80,176,115502,88,8383,88,107119,804.2853758,76.43296386,877.4224708,11211.81172,Benign
192.168.43.224,43750,172.217.166.196,443,22,6675,12,1939,10,4736,24.70176995,14.16287848,1095.257579,2675.162401,Benign
172.30.1.136,50431,52.84.103.186,443,25,3146,14,1640,11,1506,856.954681,37.679525,348.1997185,319.7492537,Benign
172.30.15.2129,51441,52.218.208.184,443,27,6062,13,1393,14,4669,4178.4321,9.239566,1206.117257,4042.614123,Benign
192.168.137.97,33454,52.94.216.31,443,11,1756,9,1640,2,116,3738.513036,62.91765794,208.5265159,14.74943649,Benign
172.30.6.255,55845,54.194.27.245,443,116,43222,69,37172,47,6050,102.830951,308.946034,962.5499837,156.6616647,Benign
192.168.215.49,47364,54.245.117.223,443,7,478,4,272,3,206,480.4375543,28.26017984,76.99880229,58.31526938,Benign
172.25.28.80,56827,172.30.1.136,7680,10,639,6,411,4,228,1889.14771,3.856694,852.5436553,472.9439255,Benign
10.0.2.15,45704,119.254.87.201,80,11,1582,6,705,5,877,23192.42553,0.96105,5868.581239,7300.348577,Malicious
192.168.43.233,51054,49.44.170.52,443,33,10054,16,1543,17,8511,889.510825,18.397402,670.9643025,3700.957342,Benign
192.168.43.233,50986,13.228.177.65,443,24,8073,13,3364,11,4709,509.608935,63.63355,422.9215563,592.0147469,Benign
172.30.1.136,51779,172.217.160.243,443,9,534,5,294,4,240,2974.278807,40.13992,58.59503457,47.83268128,Benign
10.0.2.15,47777,219.234.85.243,80,9,1379,5,1123,4,256,190.333112,82.971185,108.2785548,24.68326805,Malicious
10.0.2.15,55126,119.254.87.201,80,11,1579,6,705,5,874,5538.504208,1.889804,2984.436481,3699.854588,Malicious
172.30.15.681,49968,54.248.216.124,443,36,13394,20,4825,16,8569,2398.606551,8.769448,4401.645349,7817.139688,Benign
172.30.6.255,57343,13.228.208.99,443,6,340,4,228,2,112,2476.031449,34.894388,52.27201578,25.67748143,Benign
172.30.1.136,51803,157.240.16.39,443,50,10113,25,6990,25,3123,2977.67574,36.754742,1521.436336,679.7490239,Benign
10.0.2.15,41808,119.254.87.201,80,11,1513,6,705,5,808,17792.00606,1.419138,3974.24352,4554.877679,Malicious
10.0.2.15,56220,119.254.87.201,80,11,1582,6,705,5,877,16317.29758,2.183629,2582.856337,3213.000011,Malicious
172.30.1.136,51510,13.107.49.254,443,1,54,0,0,1,54,116.116092,0,0,0,Benign
172.30.6.255,56702,52.213.19.114,443,28,9267,15,3538,13,5729,1157.538253,84.402188,335.3467567,543.019098,Benign
172.30.6.255,56492,103.231.98.53,80,35,17195,20,15665,15,1530,817.868164,38.290373,3272.885328,319.6625951,Benign
192.168.137.97,60476,172.217.161.4,443,11,766,7,486,4,280,8269.0749,22.8795051,169.9337457,97.9042156,Benign
172.30.6.255,56085,103.243.221.46,80,7,394,4,228,3,166,305.333653,18.691451,97.58471935,71.04852373,Benign
192.168.137.97,34356,172.217.161.3,443,9,638,8,572,1,66,213.7894479,65.3546421,70.01797964,8.07899765,Benign
172.30.6.255,56214,54.221.241.51,80,13,1480,7,865,6,615,469.888335,61.536873,112.4529028,79.95206386,Benign
172.30.6.255,56051,13.250.67.150,80,6,348,4,228,2,120,254.482763,27.439015,66.47468942,34.98667864,Benign
192.168.215.49,47300,157.240.16.39,443,305,194710,143,20952,162,173758,1250.224113,172.5319587,971.5069675,8056.849354,Benign
172.30.1.136,51774,172.217.160.243,443,40,7810,18,2766,22,5044,2973.931588,39.607649,558.6799661,1018.793112,Benign
192.168.137.97,59500,103.243.221.87,443,6,412,4,272,2,140,1817.97746,10.41752432,208.8788021,107.5111481,Benign
172.30.6.255,57240,103.243.220.231,80,19,7320,10,5275,9,2045,2204.91252,21.118081,1998.287629,774.691602,Benign
172.30.6.255,56639,103.243.221.17,80,29,15803,14,8305,15,7498,1024.849979,47.224635,1406.892822,1270.184513,Benign
192.168.137.97,39778,192.168.125.6,80,784,667628,356,25412,428,642216,8327.920217,78.70001551,2583.176111,65282.42678,Benign
10.0.2.15,51648,119.254.87.201,80,11,1587,6,705,5,882,21663.19682,2.196463,2567.764629,3212.437451,Malicious
192.168.137.97,46556,151.101.193.170,443,21,9399,12,1458,9,7941,382.7904871,17.02430817,685.1379736,3731.605383,Benign
10.0.2.15,53981,119.254.87.201,80,11,1579,6,705,5,874,8899.86753,2.064984,2731.256029,3385.982652,Malicious
172.30.6.255,55820,13.228.37.108,80,7,402,4,228,3,174,90.878406,11.094084,164.4119515,125.4722787,Benign
172.30.6.255,56288,52.212.77.226,80,13,1892,7,842,6,1050,569.159886,62.891607,107.1049115,133.5631319,Benign
172.30.1.136,51914,172.217.160.228,443,21,1242,12,708,9,534,5745.723523,26.302028,215.3446114,162.4209358,Benign
192.168.43.224,51692,54.152.129.23,443,43,8924,22,3170,21,5754,28.19638995,15.2838247,1659.270536,3011.811565,Benign
10.0.2.15,50331,119.254.87.201,80,11,1582,6,705,5,877,23522.79673,2.118474,2662.293708,3311.817846,Malicious
192.168.43.233,50982,49.44.170.2,443,14,1555,7,970,7,585,502.159365,13.190838,588.2871126,354.7917122,Benign
192.168.43.233,51383,173.241.248.143,443,24,5179,13,1753,11,3426,3478.091065,62.18555,225.5186293,440.7454787,Benign
10.0.2.15,58132,119.254.87.201,80,11,1579,6,705,5,874,4305.164672,1.228108,4592.429982,5693.31036,Malicious
192.168.215.49,59866,103.243.221.51,443,28,10940,16,4998,12,5942,612.5962276,18.01338066,2219.683287,2638.927189,Benign
192.168.43.233,51264,52.84.110.78,443,11,644,6,350,5,294,2307.274469,122.402174,22.87541069,19.21534498,Benign
192.168.137.97,40202,210.176.156.55,443,6,412,4,272,2,140,350.086724,13.67049422,159.1749329,81.92827428,Benign
172.30.15.624,49911,104.31.90.207,80,6,348,4,228,2,120,2391.896457,4.392568,415.2468442,218.5509706,Benign
192.168.43.224,41954,23.251.156.28,443,371,282775,168,15368,203,267407,1054.006676,128.9414853,953.4867672,16590.90552,Benign
192.168.43.224,54598,216.58.221.42,443,10,700,6,412,4,288,358.1808471,12.60183316,261.549249,182.830543,Benign
10.0.2.15,41478,119.254.87.201,80,11,1579,6,705,5,874,6317.03645,1.895604,2975.304969,3688.534103,Malicious
192.168.137.97,50484,205.185.208.52,80,7,466,4,272,3,194,5243.725219,55.64812334,39.10284605,27.8895299,Benign
172.30.6.255,56763,23.198.126.238,443,17,6651,8,1327,9,5324,1244.684585,0.806625,13161.01038,52802.72741,Benign
172.30.6.255,57076,54.194.27.245,443,12,1416,6,904,6,512,1680.738716,15.223364,475.0592576,269.0601105,Benign
192.168.42.240,50974,216.58.221.46,443,147,37192,63,20277,84,16915,290.712868,101.072927,1604.940164,1338.835275,Benign
172.30.6.255,55652,35.186.241.238,443,46,8870,21,2603,25,6267,37.014026,21.604745,963.8623367,2320.601331,Benign
192.168.43.224,60640,52.84.110.250,443,29,8936,17,2045,12,6891,3037.273326,24.93279202,656.1639781,2211.064045,Benign
192.168.43.233,51677,107.22.42.44,443,18,4133,9,3026,9,1107,894.608976,4.570586,5296.476207,1937.607125,Benign
10.0.2.15,47322,119.254.87.201,80,11,1582,6,705,5,877,40.503337,1.679481,3358.180295,4177.481019,Malicious
172.30.6.255,58369,103.243.221.51,80,23,13609,11,5347,12,8262,5484.891539,4.328374,9882.69498,15270.39946,Benign
172.30.6.255,57106,103.243.221.46,80,102,71709,61,59812,41,11897,1800.847716,41.184431,11618.37103,2310.970376,Benign
172.30.15.1252,50560,52.84.112.65,80,10,600,6,348,4,252,3469.522375,7.985626,348.6263945,252.453596,Benign
172.30.15.487,49762,180.149.59.233,80,8,877,5,468,3,409,1789.470891,14.333645,261.2036227,228.2741061,Benign
172.30.15.2538,51872,192.168.121.146,80,140,132215,48,3035,92,129180,5501.840265,2.690382,9024.740725,384123.8902,Benign
172.30.15.1005,50311,104.18.255.119,80,14,4909,8,988,6,3921,3443.355929,3.645321,2168.258982,8605.00351,Benign
172.30.6.255,58511,35.190.43.164,80,10,1629,6,1175,4,454,5747.968567,1.106292,8496.852549,3283.039198,Benign
172.30.6.255,58331,172.217.167.2,80,14,2828,8,1608,6,1220,5419.159067,9.892129,1300.427845,986.6430169,Benign
192.168.43.224,32942,172.217.166.195,443,17,5876,9,1377,8,4499,22.5276341,10.65721106,1033.666308,3377.243804,Benign
10.0.2.15,49659,119.254.87.201,80,11,1513,6,705,5,808,24969.96259,0.986959,5714.523096,6549.410867,Malicious
192.168.43.233,51238,52.44.247.95,443,9,523,5,283,4,240,1538.428609,55.163065,41.04195443,34.80589775,Benign
172.30.15.2037,51349,34.192.10.179,443,23,9171,11,2821,12,6350,4090.759516,6.833956,3302.333231,7433.468989,Benign
192.168.43.224,42016,23.251.156.28,443,106,65078,54,5427,52,59651,1288.085614,69.12999405,628.0341926,6903.052815,Benign
172.30.6.255,56287,52.84.110.150,80,15,2034,8,919,7,1115,569.159747,128.713376,57.11916064,69.30126672,Benign
172.30.15.450,49724,52.84.110.254,443,17,4056,9,1706,8,2350,1632.630303,7.942367,1718.37942,2367.052542,Benign
172.30.1.136,50240,104.17.161.9,443,16,2816,8,1604,8,1212,433.873753,22.329429,574.6676281,434.2251654,Benign
172.30.6.255,57130,103.243.220.231,80,16,5473,9,4245,7,1228,1861.841259,14.190376,2393.171259,692.3001899,Benign
10.0.2.15,34709,119.254.87.201,80,11,1579,6,705,5,874,4815.695395,0.816163,6910.384323,8566.916167,Malicious
172.30.15.2376,51710,14.139.45.128,80,10,1400,5,665,5,735,5334.622321,0.246267,21602.56957,23876.52426,Benign
192.168.137.97,56016,172.217.161.14,443,42,9208,21,3254,21,5954,88.4561558,93.11956247,279.5545781,511.5144309,Benign
172.30.6.255,56193,176.34.37.52,443,22,7536,11,1734,11,5802,466.792056,61.996243,223.7554943,748.6905295,Benign
172.30.15.2440,51774,14.139.45.128,80,10,1620,5,664,5,956,5418.727384,0.325843,16302.32965,23471.42642,Benign
172.30.6.255,57853,103.243.221.109,80,33,21367,15,8800,18,12567,4224.10959,0.868963,81016.10771,115696.5256,Benign
192.168.43.224,48528,209.197.3.15,443,7,410,4,236,3,174,2475.681398,55.23597076,34.18062494,25.20096924,Benign
10.0.2.15,41609,119.254.87.201,80,11,1579,6,705,5,874,3824.637303,1.190283,4738.368943,5874.233271,Malicious
192.168.43.224,42256,192.229.237.25,443,97,45096,56,19352,41,25744,1301.192709,561.6902246,275.6252348,366.6647397,Benign
10.0.2.15,46628,119.254.87.201,80,11,1579,6,705,5,874,728.778937,1.758342,3207.567129,3976.473291,Malicious
172.30.15.1189,50497,13.251.188.116,443,18,2648,9,1554,9,1094,3465.148681,2.074254,5993.480066,4219.348257,Benign
192.168.43.233,51472,54.81.94.76,80,18,2437,10,1466,8,971,3816.110145,233.062336,50.32130116,33.33013877,Benign
10.0.2.15,43723,119.254.87.201,80,12,1656,7,779,5,877,12200.58274,7.345914,848.3627769,955.0887745,Malicious
172.30.15.851,50155,157.240.16.52,443,28,10166,13,1702,15,8464,3342.280227,4.640783,2933.987648,14590.64128,Benign
192.168.43.233,51136,52.220.119.167,443,5,286,3,174,2,112,924.634559,14.552753,95.65200481,61.56910655,Benign
172.30.6.255,56319,50.57.31.206,80,7,398,4,228,3,170,590.941584,15.139916,120.4762299,89.82876787,Benign
172.30.15.987,50293,13.251.188.116,443,6,348,4,228,2,120,3442.725336,4.336012,420.6630424,221.4016013,Benign
172.30.6.255,56357,185.84.60.60,80,8,452,5,282,3,170,607.744415,26.49261,85.1558227,51.33507042,Benign
172.30.15.1822,51134,52.229.175.79,443,28,10060,15,2210,13,7850,3797.816266,109.553904,161.3817432,573.2337937,Benign
192.168.137.97,40228,210.176.156.55,443,21,7448,12,3061,9,4387,374.7599734,2.491361336,9829.164339,14087.07741,Benign
192.168.43.233,51168,184.50.104.173,443,151,96771,76,5533,75,91238,1011.671135,74.674034,592.7629409,9774.53555,Benign
172.30.15.314,49577,14.139.45.149,80,44,39863,12,1011,32,38852,729.353233,0.255379,31670.57589,1217077.363,Benign
172.30.15.596,49881,23.56.25.241,443,19,7963,11,1273,8,6690,2321.317112,4.74185,2147.684975,11286.73408,Benign
172.30.15.283,49546,216.58.196.206,443,18,5816,9,1285,9,4531,328.941368,5.777938,1779.181431,6273.518338,Benign
10.0.2.15,48926,119.254.87.201,80,11,1582,6,705,5,877,10281.13852,1.220748,4620.118157,5747.29592,Malicious
172.30.6.255,56139,161.69.38.37,80,7,398,4,228,3,170,367.095595,0.639118,2853.933077,2127.932557,Benign
172.30.15.385,49653,195.154.150.142,80,16,4760,8,1474,8,3286,1466.056197,4.450928,2649.33515,5906.184059,Benign
10.0.2.15,36519,119.254.87.201,80,13,1730,8,853,5,877,16350.19956,12.783719,533.8039736,548.8230772,Malicious
172.30.6.255,58103,157.240.16.16,443,373,101431,204,35615,169,65816,4889.939378,985.445735,289.1280462,534.3044079,Benign
172.30.15.330,49598,104.25.218.21,443,215,116361,99,8698,116,107663,956.190399,4.027581,17276.87165,213851.4409,Benign
192.168.43.233,50990,172.217.166.226,443,16,4829,8,1219,8,3610,513.71712,12.464285,782.3954603,2317.02019,Benign
192.168.215.49,37892,158.85.224.176,443,943,122154,517,54262,426,67892,6.699372218,1694.771967,256.1382938,320.477333,Benign
10.0.2.15,43447,119.254.87.201,80,11,1582,6,705,5,877,7070.018776,1.422474,3964.923085,4932.251837,Malicious
10.0.2.15,34488,119.254.87.201,80,11,1582,6,705,5,877,7130.112844,1.975814,2854.519707,3550.941536,Malicious
172.30.1.136,50432,52.84.103.186,443,1,66,1,66,0,0,857.229911,0,0,0,Benign
172.30.6.255,56914,54.245.243.190,80,7,402,4,228,3,174,1386.18548,18.459016,98.81350122,75.41030356,Benign
10.0.2.15,49808,119.254.87.201,80,11,1579,6,705,5,874,4006.632411,1.494498,3773.842454,4678.49405,Malicious
192.168.43.224,47534,104.24.19.65,443,6,356,4,236,2,120,728.9111655,12.4806328,151.2743809,76.91917675,Benign
172.30.15.245,49514,117.18.232.240,80,9,1727,5,596,4,1131,53.8567,0.032161,148254.0966,281334.5356,Benign
10.0.2.15,33019,119.254.87.201,80,11,1569,6,705,5,864,11089.46202,1.225769,4601.19321,5638.909126,Malicious
172.30.6.255,57682,103.243.221.75,80,77,53081,45,44898,32,8183,3641.837804,37.18334,9659.810012,1760.573418,Benign
172.30.1.136,50258,104.17.38.113,443,1,66,1,66,0,0,461.651445,0,0,0,Benign
10.0.2.15,45190,119.254.87.201,80,11,1579,6,705,5,874,18086.8733,1.442691,3909.361048,4846.498661,Malicious
192.168.137.97,46870,52.84.110.71,443,1066,906683,436,33795,630,872888,42.63008538,134.9687275,2003.130688,51738.68145,Benign
172.30.15.625,49912,172.217.166.200,80,49,31061,25,1918,24,29143,2392.057667,4.117385,3726.637174,56624.28945,Benign
192.168.42.240,50931,104.16.92.188,80,11,1337,6,569,5,768,44.893625,46.367873,98.17142141,132.5055389,Benign
172.30.15.845,50148,192.168.45.1,7680,3,198,3,198,0,0,3296.924546,9.010689,175.7912186,0,Benign
172.30.15.1232,50540,103.15.158.128,80,6,348,3,174,3,174,3468.435171,10.323009,134.8444044,134.8444044,Benign
10.0.2.15,32924,119.254.87.201,80,11,1579,6,705,5,874,130.622413,7.444208,757.6360037,939.2537124,Malicious
10.0.2.15,45879,119.254.87.201,80,13,1707,8,853,5,854,15686.62301,10.252931,665.5657782,666.3460429,Malicious
172.30.6.255,58100,74.125.68.188,5228,63,8720,31,2566,32,6154,4875.533059,990.690113,20.72090932,49.69465159,Benign
10.0.2.15,57799,119.254.87.201,80,12,1653,7,779,5,874,23888.63445,5.009151,1244.123006,1395.845324,Malicious
172.30.1.136,50244,172.217.161.3,443,56,11539,22,3340,34,8199,437.432933,43.119834,619.6684338,1521.156134,Benign
172.30.15.2131,51443,144.2.1.5,443,12,1482,7,962,5,520,4178.493347,8.858916,868.7293118,469.5834118,Benign
172.30.15.378,49646,195.154.150.142,80,14,3375,7,931,7,2444,1452.541804,8.008796,929.9774898,2441.315773,Benign
192.168.215.49,54038,103.243.220.231,443,16,3810,9,2330,7,1480,516.8791002,10.28815008,1811.793165,1150.838577,Benign
172.30.1.136,50640,157.240.16.20,443,922,571824,437,42089,485,529735,1746.037594,49.937493,6742.669281,84863.6915,Benign
10.0.2.15,40953,119.254.87.201,80,11,1582,6,705,5,877,5053.573058,1.768858,3188.49789,3966.400921,Malicious
172.30.1.136,50359,104.244.42.131,443,19,1110,12,696,7,414,650.261094,41.235166,135.0303767,80.31979306,Benign
192.168.137.97,53280,52.222.190.164,443,1600,1284489,585,47209,1015,1237280,306.6179645,49.09256623,7693.058827,201624.0087,Benign
172.30.15.923,50229,50.31.185.52,443,18,6955,10,2170,8,4785,3440.309718,1.368973,12681.039,27962.56756,Benign
192.168.43.233,50974,104.244.42.1,443,23,6473,12,1856,11,4617,496.809579,17.212413,862.6332636,2145.893199,Benign
172.30.15.807,50099,34.200.202.18,443,12,1416,6,904,6,512,2696.023168,10.462737,691.2149278,391.4845609,Benign
172.30.6.255,56392,176.34.247.152,80,15,2923,8,1444,7,1479,651.413808,95.639826,120.7865016,123.7141523,Benign
10.0.2.15,34425,119.254.87.201,80,11,1579,6,705,5,874,14272.94187,1.842245,3061.48205,3795.369237,Malicious
172.30.6.255,58191,173.241.248.220,80,9,2437,6,1300,3,1137,5089.846439,24.264092,428.6169044,374.8749387,Benign
192.168.43.224,45778,104.237.191.1,443,8,552,5,338,3,214,2876.987212,44.35261803,60.96596143,38.59975073,Benign
172.30.15.1305,50613,23.8.189.227,443,6,348,4,228,2,120,3485.887161,1.240494,1470.381961,773.8852425,Benign
192.168.137.97,45872,54.85.227.48,443,23,7349,14,2410,9,4939,16.21412602,0.996494547,19347.82288,39650.9947,Benign
192.168.43.224,50574,49.44.150.71,443,78,21789,43,16639,35,5150,2283.040528,315.6650962,421.68742,130.5180728,Benign
172.30.6.255,58421,216.58.196.162,80,24,6431,13,3645,11,2786,5572.165262,6.890491,4231.919032,3234.602585,Benign
192.168.43.224,51020,23.213.88.167,443,26,6677,14,1611,12,5066,94.24170198,12.0096583,1073.136278,3374.617246,Benign
172.30.6.255,58087,122.15.34.40,80,79,73986,24,2553,55,71433,4857.691968,14.825368,1377.638653,38546.36188,Benign
10.0.2.15,40012,119.254.87.201,80,11,1582,6,705,5,877,7155.451294,1.877984,3003.220475,3735.921073,Malicious
172.30.15.1888,51200,52.6.46.142,443,6,348,4,228,2,120,3968.841296,8.630935,211.3328394,111.2278102,Benign
192.168.43.233,50702,125.56.235.100,443,17,6654,8,1326,9,5328,1840.626112,0.731498,14501.74847,58269.46895,Benign
10.0.2.15,34982,119.254.87.201,80,11,1579,6,705,5,874,13522.00957,0.889322,6341.909904,7862.169158,Malicious
172.30.6.255,55822,4.78.226.233,80,5,294,3,174,2,120,91.142109,11.009749,126.4334001,87.19544832,Benign
192.168.43.233,51316,74.207.230.33,443,12,1381,6,904,6,477,2939.578341,18.138695,398.7056401,210.3789716,Benign
172.30.1.136,50586,104.113.230.86,443,508,357294,226,20456,282,336838,1595.136635,200.088695,817.8772919,13467.54748,Benign
192.168.43.224,48532,49.44.150.17,443,53,21960,26,5336,27,16624,3250.856874,95.93987282,444.945347,1386.201546,Benign
172.30.6.255,58403,173.241.248.220,80,9,3415,6,2264,3,1151,5550.849451,1.050087,17248.09468,8768.797252,Benign
172.30.15.2005,51317,151.101.2.2,443,26,13574,14,1450,12,12124,4079.555481,2.694371,4305.271991,35998.01215,Benign
192.168.42.240,51011,172.217.161.14,443,31,7364,16,2461,15,4903,395.155014,22.20918,886.4802753,1766.116534,Benign
172.30.6.255,57874,103.243.221.109,80,32,16247,18,12478,14,3769,4276.845309,27.202695,3669.636409,1108.419589,Benign
172.30.6.255,56276,157.240.16.20,443,29,8400,16,1897,13,6503,566.218215,65.802847,230.6283192,790.6040904,Benign
172.30.6.255,57533,103.243.220.231,80,32,23162,12,4660,20,18502,3133.855428,14.180068,2629.0424,10438.31384,Benign
172.30.6.255,56579,204.79.197.222,443,35,10000,15,1944,20,8056,894.917574,133.479314,116.5124358,482.8313697,Benign
172.30.6.255,57326,35.190.43.164,80,129,39369,67,29193,62,10176,2467.90152,581.1515,401.8642299,140.0805126,Benign
172.30.6.255,57442,103.243.221.109,80,72,48247,43,40227,29,8020,2860.874953,30.154673,10672.17675,2127.696759,Benign
172.30.6.255,57470,157.240.16.39,443,18,1879,9,1071,9,808,2985.090317,61.036154,140.3758173,105.9044448,Benign
192.168.43.224,34316,172.217.166.206,443,51,10245,26,3710,25,6535,1375.904095,241.3405559,122.9797449,216.6233512,Benign
172.30.15.1573,50882,104.113.143.112,443,26,8726,13,2078,13,6648,3560.332431,6.651638,2499.234023,7995.624536,Benign
172.30.15.723,50010,198.58.102.214,80,6,348,4,228,2,120,2409.691046,6.722796,271.3156847,142.7977288,Benign
172.30.6.255,55952,54.82.135.50,443,34,7768,16,2676,18,5092,161.006854,65.612873,326.2774364,620.8537767,Benign
172.30.15.2342,51676,192.168.121.37,443,236,201536,95,8027,141,193509,5310.995992,6.905239,9299.605705,224188.0404,Benign
172.30.6.255,56398,209.191.163.209,80,6,535,4,228,2,307,650.889358,26.271715,69.42828057,93.48457076,Benign
192.168.137.97,50862,104.197.3.80,80,10,911,5,425,5,486,342.3150289,0.796774636,4267.204108,4879.673404,Benign
172.30.15.1218,50526,173.241.248.143,80,13,4252,9,2402,4,1850,3467.151336,2.594479,7406.496642,5704.42081,Benign
172.30.1.136,51849,74.125.200.188,5228,7,402,4,228,3,174,3834.68718,18.132698,100.5917597,76.76739556,Benign
10.0.2.15,56450,119.254.87.201,80,11,1579,6,705,5,874,23702.94897,1.32332,4262.007678,5283.68044,Malicious
10.0.2.15,52665,119.254.87.201,80,11,1579,6,705,5,874,1779.977532,1.648011,3422.307254,4242.690128,Malicious
172.30.6.35,62078,172.30.6.255,56662,3,198,0,0,3,198,1094.411121,9.004183,0,175.9182371,Benign
10.0.2.15,58936,119.254.87.201,80,11,1513,6,705,5,808,6254.620727,1.491814,3780.63217,4332.979849,Malicious
10.0.2.15,42903,119.254.87.201,80,11,1582,6,705,5,877,7190.167876,1.430201,3943.501648,4905.604177,Malicious
192.168.215.49,46390,223.31.160.67,443,22,8311,10,1766,12,6545,282.9338351,10.12805131,1394.937641,5169.800034,Benign
192.168.43.233,51133,13.107.49.254,443,1,54,0,0,1,54,17.678756,0,0,0,Benign
172.30.15.2169,51481,104.19.198.151,443,32,12945,15,1810,17,11135,4245.545614,1.948986,7429.504368,45705.81831,Benign
172.30.15.1028,50334,173.241.248.143,80,9,1479,6,987,3,492,3446.930643,10.329395,764.4203751,381.0484544,Benign
172.30.6.255,56175,52.213.19.114,443,73,26674,41,18587,32,8087,435.654208,420.590774,353.5408031,153.8217289,Benign
192.168.43.233,51140,172.217.161.5,443,51,5823,24,2687,27,3136,244.18165,242.889991,88.5009708,103.2895588,Benign
172.30.15.2063,51375,54.236.156.42,443,16,4806,9,1153,7,3653,4104.821684,2.476118,3725.185956,11802.34545,Benign
10.0.2.15,40271,119.254.87.201,80,11,1582,6,705,5,877,9380.382927,1.22452,4605.886388,5729.592003,Malicious
192.168.43.233,50853,172.217.166.196,443,3,162,2,108,1,54,3.00711,0.124396,6945.560951,3472.780475,Benign
172.30.15.2165,51477,162.125.248.4,443,6,348,4,228,2,120,4235.245142,0.171254,10650.84611,5605.70848,Benign
172.30.6.255,58363,172.217.167.42,443,17,1793,10,1164,7,629,5472.744911,87.425707,106.5132936,57.55744131,Benign
172.30.1.136,50411,52.84.103.186,443,175,122930,77,5654,98,117276,827.09735,192.612732,234.833905,4870.95526,Benign
10.0.2.15,60396,119.254.87.201,80,11,1582,6,705,5,877,9980.959898,1.813465,3110.068295,3868.83673,Malicious
172.30.1.136,50829,74.125.68.188,443,23,2915,12,1831,11,1084,1986.470898,4.386862,3339.061042,1976.811671,Benign
10.0.2.15,37056,119.254.87.201,80,11,1579,6,705,5,874,25870.87953,1.401685,4023.728584,4988.281961,Malicious
192.168.43.233,51331,104.16.164.13,443,95,39947,45,3717,50,36230,3368.902466,409.050364,72.69520484,708.5680041,Benign
172.30.6.255,58075,172.217.166.197,443,50,11832,25,5262,25,6570,4845.889744,26.662171,1578.866177,1971.332342,Benign
172.30.15.294,49557,172.217.161.2,443,20,5150,10,1351,10,3799,575.247065,4.599194,2349.976974,6608.114378,Benign
172.30.6.255,55901,157.240.16.39,443,26,5413,15,3412,11,2001,118.090975,61.041378,447.1720806,262.2483392,Benign
192.168.137.97,39924,172.217.161.14,443,21,6678,11,2026,10,4652,5228.95261,14.77287724,1097.145785,2519.211349,Benign
192.168.137.97,52202,172.217.161.3,443,15,1054,8,552,7,502,8325.940886,45.56920166,96.90755684,88.12969843,Benign
172.30.15.374,49642,62.210.213.13,80,15,6010,7,785,8,5225,1443.111412,7.449086,843.0564501,5611.42669,Benign
172.30.1.136,50170,104.237.191.1,443,3,198,3,198,0,0,196.534676,9.00164,175.9679347,0,Benign
172.30.6.255,56235,172.217.166.197,443,1137,1062406,383,29475,754,1032931,490.85284,365.265355,645.5580765,22623.13654,Benign
192.168.43.224,48792,34.227.208.227,443,173,43474,95,21709,78,21765,361.1899425,96.02230105,1808.663176,1813.328759,Benign
172.30.15.2461,51795,14.139.45.128,80,10,1388,5,661,5,727,5421.048555,0.218269,24226.98597,26646.01936,Benign
10.0.2.15,59763,119.254.87.201,80,11,1582,6,705,5,877,14037.57342,0.894335,6306.36171,7844.935063,Malicious
172.30.1.136,50806,157.240.16.16,443,12,696,7,414,5,282,1947.861319,34.854487,95.02363354,64.72624314,Benign
172.30.1.136,50378,157.240.16.20,443,26,6784,8,2059,18,4725,690.136986,97.478561,168.9807464,387.777575,Benign
10.0.2.15,55496,119.254.87.201,80,11,1582,6,705,5,877,2590.984662,0.832541,6774.441139,8427.212594,Malicious
172.30.1.136,50534,176.34.146.169,443,77,16401,42,7152,35,9249,1135.927602,267.922072,213.5546339,276.1698558,Benign
172.30.6.255,56721,103.243.220.231,80,22,11005,10,4562,12,6443,1193.834729,28.62777,1274.846067,1800.489525,Benign
172.30.1.136,50138,104.17.161.9,443,17,5881,9,1091,8,4790,113.816643,18.237452,478.5756256,2101.170712,Benign
192.168.137.97,57148,18.211.245.141,443,11,742,6,404,5,338,6976.385394,110.908354,29.14117723,24.38048986,Benign
10.0.2.15,42735,119.254.87.201,80,11,1579,6,705,5,874,22387.04261,1.424303,3959.831581,4909.067804,Malicious
172.30.15.1854,51166,35.161.208.104,443,8,448,5,282,3,166,3898.503662,10.006667,225.4496927,132.7115212,Benign
10.0.2.15,41962,119.254.87.201,80,11,1513,6,705,5,808,4125.013805,1.864718,3024.586023,3466.475896,Malicious
10.0.2.15,57405,119.254.87.201,80,11,1579,6,705,5,874,2533.323236,0.885608,6368.506156,7895.140965,Malicious
192.168.42.240,51007,172.217.163.67,443,35,6368,19,4926,16,1442,379.21702,38.076456,1034.970271,302.969373,Benign
172.30.15.1729,51040,161.202.1.35,443,15,4222,9,3239,6,983,3623.565787,3.515936,7369.872489,2236.67325,Benign
192.168.137.97,50378,216.58.196.202,443,44,8185,20,2509,24,5676,591.0762886,240.5178463,83.45326683,188.7926435,Benign
192.168.43.233,51372,104.85.125.73,443,34,9951,19,1907,15,8044,3210.008014,70.607927,216.0663915,911.3990841,Benign
172.30.15.1883,51195,52.84.110.171,443,68,48055,28,2603,40,45452,3967.543899,9.748107,2136.209625,37301.19089,Benign
172.30.15.2021,51333,34.196.221.221,443,26,8961,13,2478,13,6483,4089.875679,7.717744,2568.626272,6720.098516,Benign
172.30.15.1266,50574,50.23.131.235,80,6,348,4,228,2,120,3469.53908,8.19229,222.6483682,117.1833517,Benign
172.30.6.255,56025,103.243.221.75,80,14,3815,8,2641,6,1174,237.855958,15.172857,1392.486596,619.0001,Benign
172.30.6.255,55620,157.240.16.17,443,15,4922,8,1025,7,3897,5.264851,0.088609,92541.3897,351837.8494,Benign
192.168.43.224,49100,172.217.166.206,443,26,8435,14,2260,12,6175,37.80208824,12.07804225,1496.931343,4090.066833,Benign
10.0.2.15,49903,119.254.87.201,80,11,1582,6,705,5,877,13494.38623,1.919965,2937.553549,3654.23328,Malicious
192.168.137.97,36320,52.84.103.186,443,15,1066,9,642,6,424,3744.044094,65.129988,78.8576838,52.08046407,Benign
10.0.2.15,47377,119.254.87.201,80,3,222,3,222,0,0,10433.65572,9.080082,195.5929473,0,Malicious
172.30.15.1386,50694,184.29.24.49,443,52,40683,19,2160,33,38523,3495.663528,1.354686,12755.72347,227494.7848,Benign
172.30.6.255,55744,103.231.98.48,80,15,4883,8,3642,7,1241,58.239737,0.422687,68930.43789,23487.82906,Benign
172.30.15.2134,51446,205.185.216.10,443,12,1423,6,904,6,519,4178.563531,9.06597,797.7083533,457.9763666,Benign
192.168.43.233,50877,172.217.166.206,443,21,6002,10,1351,11,4651,35.395534,30.980296,348.8669056,1201.021449,Benign
192.168.43.233,51200,52.46.6.85,443,8,480,5,294,3,186,749.541561,32.659723,72.01530766,45.56070485,Benign
10.0.2.15,55798,119.254.87.201,80,11,1579,6,705,5,874,19861.39488,2.314915,2436.374554,3020.413277,Malicious
172.30.15.1190,50498,37.157.6.252,80,12,1721,7,851,5,870,3465.312738,2.268703,3000.833516,3067.832149,Benign
192.168.137.97,51648,172.217.161.3,443,12,828,7,486,5,342,3619.405604,59.97559594,64.82636711,45.61855464,Benign
192.168.137.97,47520,172.217.166.206,443,23,6281,12,1575,11,4706,1231.205543,103.2118806,122.0789693,364.7642092,Benign
192.168.137.97,37032,52.22.149.115,443,21,3896,11,2246,10,1650,373.8610657,7.422791035,2420.652813,1778.306831,Benign
172.30.6.255,56061,103.243.221.87,80,37,25425,14,5218,23,20207,284.903716,19.211923,2172.81737,8414.358105,Benign
192.168.43.233,51368,205.185.216.10,443,34,11153,15,2643,19,8510,3470.719763,58.277727,362.8144248,1168.199302,Benign
172.30.6.255,58478,35.190.43.164,80,14,2928,8,2140,6,788,5682.079621,7.006183,2443.555928,899.7766687,Benign
10.0.2.15,38947,119.254.87.201,80,11,1554,6,705,5,849,23585.79527,2.159393,2611.845088,3145.32834,Malicious
172.30.1.136,51793,54.255.158.169,443,13,1560,7,1009,6,551,2977.307117,3.326062,2426.894027,1325.29099,Benign
172.30.15.2402,51736,14.139.45.128,80,10,1813,5,676,5,1137,5343.578805,0.042252,127993.9411,215279.7501,Benign
192.168.137.97,50624,192.168.121.7,443,24,2351,14,1429,10,922,2906.441026,18.00067671,635.0872351,409.7623728,Benign
10.0.2.15,40886,119.254.87.201,80,11,1582,6,705,5,877,26471.64571,1.321344,4268.381285,5309.745229,Malicious
192.168.43.233,51271,172.217.161.5,443,9,535,5,295,4,240,2564.50645,57.112882,41.3216759,33.61763463,Benign
172.30.15.706,49993,173.241.248.143,443,21,5096,12,1806,9,3290,2403.407107,2.961537,4878.547862,8887.277113,Benign
192.168.43.224,57742,13.32.226.81,443,9,618,5,338,4,280,106.5372431,68.31969193,39.5786328,32.78703309,Benign
10.0.2.15,48840,119.254.87.201,80,11,1582,6,705,5,877,19533.9868,1.364428,4133.600307,5142.081517,Malicious
172.30.6.255,56170,210.176.156.41,80,116,67250,59,48753,57,18497,434.870705,384.699639,1013.840307,384.6533373,Benign
192.168.43.224,48146,152.14.93.202,80,14,2953,7,862,7,2091,2216.887503,3.106139509,2220.119212,5385.463194,Benign
172.30.6.255,57581,103.243.221.17,80,72,48453,34,10739,38,37714,3315.858718,44.210185,1943.262621,6824.490782,Benign
192.168.137.97,45810,52.84.110.78,443,4714,4110535,1920,143877,2794,3966658,71.67808632,103.2314847,11149.85417,307399.0855,Benign
172.30.1.136,50819,172.217.161.3,443,20,2389,10,1357,10,1032,1956.672685,24.503106,443.0458734,336.9368765,Benign
172.30.6.255,58127,35.190.41.40,443,82,18438,35,5708,47,12730,4899.843669,9.106691,5014.335064,11182.98622,Benign
192.168.137.97,34518,172.217.161.19,443,78,12822,39,5302,39,7520,346.6315752,263.4148738,161.0235572,228.3849774,Benign
192.168.215.49,52242,34.196.177.243,443,27,7769,15,3162,12,4607,121.902769,20.84485005,1213.537154,1768.110584,Benign
10.0.2.15,41655,119.254.87.201,80,11,1582,6,705,5,877,4155.054646,1.810469,3115.214897,3875.238957,Malicious
192.168.43.233,51181,52.70.107.220,443,27,5767,14,4623,13,1144,1051.049041,87.8221,421.1240679,104.2106713,Benign
10.0.2.15,44537,119.254.87.201,80,11,1579,6,705,5,874,20852.27088,1.419708,3972.647897,4924.956399,Malicious
172.30.1.136,51827,172.217.160.227,443,12,697,6,349,6,348,3099.067771,70.896741,39.38121782,39.26837765,Benign
192.168.43.224,44418,172.217.166.238,443,19,6017,10,1443,9,4574,3062.206434,13.97788305,825.8761332,2617.849919,Benign
172.30.6.255,57426,103.243.221.109,80,38,27803,18,9425,20,18378,2792.846787,37.227536,2025.382502,3949.334708,Benign
172.30.6.255,57831,103.243.221.46,80,21,8821,12,4367,9,4454,4135.84583,3.643448,9588.719257,9779.747097,Benign
172.30.15.1958,51270,184.29.26.80,80,12,2524,7,617,5,1907,4050.821717,60.222638,81.96253376,253.3266643,Benign
192.168.137.97,37520,172.217.160.227,443,16,1107,8,528,8,579,21.27738003,240.0479,17.59648803,19.29614881,Benign
192.168.43.224,39774,54.148.54.246,443,29,7973,16,1947,13,6026,93.9716559,14.63582193,1064.238146,3293.836194,Benign
192.168.43.224,58740,104.197.3.80,80,11,977,6,491,5,486,923.8134086,1.109814865,3539.329057,3503.28701,Benign
172.30.15.1908,51220,52.86.72.168,443,22,7929,11,2023,11,5906,3984.931731,2.517801,6427.83127,18765.58155,Benign
10.0.2.15,38314,119.254.87.201,80,11,1579,6,705,5,874,18272.65878,1.08839,5181.966023,6424.167807,Malicious
172.30.15.496,49775,162.247.242.19,443,7,398,4,228,3,170,1849.416157,6.546459,278.6239095,207.7458974,Benign
10.0.2.15,54276,119.254.87.201,80,11,1579,6,705,5,874,21392.91261,2.078542,2713.440479,3363.896424,Malicious
172.30.6.255,57330,172.217.166.197,443,29,8431,16,5468,13,2963,2468.423937,68.025563,643.0523772,348.457241,Benign
192.168.43.233,50695,151.101.152.188,443,17,9673,6,1370,11,8303,1837.371318,0.858117,12772.15112,77406.69396,Benign
10.0.2.15,46527,119.254.87.201,80,11,1558,6,705,5,853,4212.710393,0.888148,6350.292969,7683.404117,Malicious
172.30.6.255,57406,103.243.221.17,80,29,15435,15,8341,14,7094,2721.864015,48.19494,1384.543689,1177.551004,Benign
172.30.1.136,50559,184.29.24.13,443,13,762,6,348,7,414,1472.510086,27.495647,101.252391,120.4554306,Benign
172.30.6.255,56546,103.243.221.109,80,6,348,4,228,2,120,832.683036,12.392434,147.1865817,77.46662197,Benign
172.30.15.559,49843,192.28.147.68,443,8,464,5,294,3,170,2253.579192,12.761914,184.2983741,106.567087,Benign
172.30.6.255,56536,23.198.119.247,443,23,10431,12,1698,11,8733,832.141489,41.445207,327.7580445,1685.695526,Benign
10.0.2.15,44683,119.254.87.201,80,11,1582,6,705,5,877,4092.550005,1.888717,2986.154093,3714.690978,Malicious
172.30.15.1703,51014,184.29.25.7,443,27,13183,12,3640,15,9543,3611.847515,5.281504,5513.58098,14454.97343,Benign
172.30.1.136,50177,172.217.161.3,443,23,3016,12,2054,11,962,347.537306,28.56923,575.1642589,269.3807288,Benign
10.0.2.15,33327,119.254.87.201,80,11,1585,6,705,5,880,19020.37059,1.781881,3165.194533,3950.881119,Malicious
10.0.2.15,34998,119.254.87.201,80,11,1579,6,705,5,874,25690.58592,2.055116,2744.370634,3402.241041,Malicious
172.30.6.255,56318,35.201.85.114,80,25,4034,13,1847,12,2187,590.812536,241.909367,61.08072698,72.32460742,Benign
192.168.43.233,51275,13.107.21.200,443,36,13748,20,2178,16,11570,2696.330759,23.220991,750.3555727,3986.048657,Benign
192.168.43.233,51106,182.161.72.82,443,15,6791,7,2566,8,4225,918.899967,18.333156,1119.719922,1843.654197,Benign
10.0.2.15,36682,119.254.87.201,80,11,1579,6,705,5,874,15776.76239,1.487336,3792.014716,4701.022499,Malicious
172.30.6.255,56877,103.231.98.53,80,8,468,5,294,3,174,1382.85896,22.333753,105.3114539,62.32718702,Benign
192.168.42.240,50976,172.217.161.14,443,17,942,9,498,8,444,295.397125,29.595203,134.6164106,120.0194504,Benign
172.30.15.2261,51578,104.121.244.70,443,267,220685,114,19364,153,201321,4487.527781,20.053779,7724.828323,80312.44385,Benign
192.168.137.97,42476,52.84.110.205,443,464,383370,197,14895,267,368475,382.2949564,162.637448,732.6725884,18124.97697,Benign
192.168.137.97,54060,140.98.193.112,443,40,22264,22,11545,18,10719,15.03448802,9.985834422,9249.101887,8587.364498,Benign
192.168.43.224,45696,209.197.3.15,80,120,80022,61,4494,59,75528,807.0730423,27.31407137,1316.244639,22121.34514,Benign
172.30.15.1566,50875,54.169.137.62,443,45,35414,17,3021,28,32393,3557.467262,9.593576,2519.185755,27012.24236,Benign
172.30.6.255,56135,157.240.16.39,443,28,5420,15,3274,13,2146,362.08887,61.028743,429.1748234,281.3100706,Benign
172.30.6.255,56599,103.243.221.87,80,116,92868,70,82292,46,10576,951.830728,45.220748,14558.27312,1870.999569,Benign
192.168.43.233,51206,13.68.93.109,443,24,6450,13,1403,11,5047,970.904097,2.921457,3841.918604,13820.50121,Benign
192.168.137.97,45562,192.168.121.7,8080,109,74189,53,5130,56,69059,2904.422288,91.11674443,450.4111759,6063.342182,Benign
192.168.43.224,59332,140.98.193.112,443,36,16332,19,4786,17,11546,49.88024908,7.354028817,5206.397874,12560.19011,Benign
172.30.6.255,57988,103.243.221.17,80,49,32245,25,13869,24,18376,4696.861945,12.952291,8566.20655,11349.96118,Benign
172.30.1.136,51867,172.217.160.238,443,10,600,6,360,4,240,4169.098964,14.837774,194.0991957,129.3994638,Benign
172.30.6.255,56513,23.198.119.247,443,20,9319,10,1234,10,8085,831.967945,41.616698,237.2124766,1554.183852,Benign
10.0.2.15,54650,119.254.87.201,80,11,1582,6,705,5,877,9592.714001,1.944357,2900.701877,3608.390846,Malicious
172.30.6.255,58465,157.240.16.39,443,28,5544,15,3399,13,2145,5669.088269,61.066977,445.2815799,281.0029388,Benign
172.30.15.586,49871,13.107.21.200,443,1273,872587,548,63914,725,808673,2310.232362,25.892082,19747.81325,249859.5517,Benign
172.30.6.255,55907,151.101.192.166,80,26,6310,14,2969,12,3341,121.805765,289.820092,81.95429046,92.22272968,Benign
172.30.15.1710,51021,184.29.25.7,443,195,157221,82,24995,113,132226,3618.866922,8.213722,24344.6272,128785.4641,Benign
172.30.15.1557,50866,54.169.137.62,443,101,89356,36,3306,65,86050,3555.428531,1.633495,16191.05048,421427.675,Benign
172.30.6.255,57383,103.231.98.53,80,39,17419,22,15781,17,1638,2648.872467,61.888877,2039.914216,211.7343315,Benign
192.168.43.224,33126,172.217.166.195,443,22,6237,12,1422,10,4815,70.4091101,17.02685599,668.1209969,2262.308439,Benign
192.168.43.233,51138,210.176.156.55,443,5,294,3,174,2,120,925.504186,13.92416,99.97012387,68.94491301,Benign
10.0.2.15,35499,119.254.87.201,80,11,1579,6,705,5,874,8026.31821,0.959232,5879.703763,7289.164665,Malicious
172.30.15.1163,50471,103.243.220.231,80,11,2994,7,1971,4,1023,3460.532432,7.096934,2221.804514,1153.174033,Benign
172.30.6.255,58371,103.243.221.51,80,19,7346,10,5293,9,2053,5484.892013,4.32827,9783.123511,3794.587676,Benign
172.30.15.2340,51674,111.221.29.253,443,33,8907,17,3578,16,5329,5306.5625,2.909418,9838.393796,14653.10244,Benign
172.30.15.623,49910,104.31.90.207,80,22,10971,12,1349,10,9622,2391.849885,4.439052,2431.149714,17340.6394,Benign
10.0.2.15,33906,119.254.87.201,80,11,1582,6,705,5,877,9680.709202,0.959247,5879.611821,7314.070307,Malicious
192.168.137.97,49472,157.240.16.52,443,523,439741,214,15141,309,424600,6967.968175,66.07134261,1833.291034,51411.09392,Benign
172.30.6.255,55224,52.230.83.250,443,15,1482,9,774,6,708,854.504061,387.239009,15.99012459,14.62662559,Benign
172.30.15.1045,50351,209.15.36.33,443,7,402,4,228,3,174,3447.783199,8.202553,222.3697915,169.7032619,Benign
172.30.6.255,58115,210.176.156.41,80,9,518,7,402,2,116,4892.098051,10.229577,314.3825009,90.71733856,Benign
192.168.43.224,32794,54.243.243.77,443,44,26812,19,4230,25,22582,29.11066779,67.32971455,502.6012694,2683.154105,Benign
192.168.43.233,51291,23.9.140.60,80,25,10728,13,9768,12,960,2798.603374,67.734428,1153.682142,113.3839943,Benign
172.30.6.255,56859,52.213.19.114,443,20,6624,10,1321,10,5303,1354.659616,22.889227,461.7019177,1853.448349,Benign
192.168.215.49,60512,159.153.113.136,80,6,356,4,236,2,120,1496.433054,21.64838163,87.21206196,44.34511625,Benign
10.0.2.15,55497,119.254.87.201,80,11,1582,6,705,5,877,18900.28289,1.748855,3224.967193,4011.767699,Malicious
192.168.215.24,49249,74.125.24.188,5228,10,753,0,0,10,753,1091.621558,59.99859328,0,100.402354,Benign
192.168.43.233,51497,198.252.206.25,443,40,8352,22,3439,18,4913,3828.871014,250.800511,109.6967462,156.7141943,Benign
172.30.15.1988,51300,184.29.26.86,443,16,5516,10,1219,6,4297,4077.23056,5.017372,1943.646993,6851.395511,Benign
192.168.43.233,51237,52.44.247.95,443,40,13496,20,5659,20,7837,1538.242736,208.478532,217.1542536,300.7312043,Benign
192.168.43.224,46100,54.85.84.151,443,60,6124,32,2570,28,3554,27.84341161,955.2322205,21.52356208,29.76449013,Benign
172.30.6.255,55951,52.206.154.207,443,36,7585,16,2482,20,5103,159.806672,11.548873,1719.301961,3534.890374,Benign
10.0.2.15,60073,119.254.87.201,80,11,1582,6,705,5,877,25570.43643,0.934859,6032.99535,7504.875067,Malicious
172.30.15.1804,51116,162.247.242.19,443,43,20755,23,13583,20,7172,3700.916915,6.496959,16725.36336,8831.20857,Benign
192.168.43.224,39250,54.89.94.62,443,6,412,4,272,2,140,3269.487455,46.62717994,46.66805934,24.02032466,Benign
192.168.43.233,51357,172.217.160.238,443,20,6150,11,1663,9,4487,3436.291214,28.53695,466.20259,1257.877944,Benign
10.0.2.15,57246,119.254.87.201,80,11,1513,6,705,5,808,18993.37976,1.665039,3387.308045,3882.191348,Malicious
10.0.2.15,33156,119.254.87.201,80,11,1544,6,705,5,839,641.228399,0.883881,6380.949472,7593.782421,Malicious
172.30.1.136,50466,157.240.16.39,443,75,37590,44,30434,31,7156,878.216134,162.20876,1500.979355,352.9279183,Benign
10.0.2.15,44723,219.234.85.243,80,9,1379,5,1123,4,256,176.599903,0.602682,14906.70038,3398.143631,Malicious
10.0.2.15,56700,119.254.87.201,80,11,1582,6,705,5,877,13734.62022,1.586592,3554.789133,4422.056836,Malicious
172.30.15.225,49434,131.253.61.64,443,1,54,0,0,1,54,34.740678,0,0,0,Benign
172.30.6.255,57284,103.243.220.231,80,39,24097,16,9599,23,14498,2336.874836,33.176117,2314.677152,3496.008891,Benign
172.30.1.136,50212,52.84.103.186,443,20,7272,11,1399,9,5873,370.444959,11.129369,1005.627543,4221.622987,Benign
172.30.15.2284,51605,162.125.34.137,443,26,8297,12,3242,14,5055,4639.597024,65.642512,395.1098032,616.064175,Benign
172.30.6.255,56462,103.243.221.75,80,18,5559,10,4278,8,1281,746.871319,15.629962,2189.64064,655.6637822,Benign
192.168.43.233,51671,54.172.100.225,443,11,642,6,348,5,294,870.387036,24.79303,112.2896233,94.86537144,Benign
192.168.137.97,36304,74.125.200.188,443,33,8767,17,2053,16,6714,19.4458989,111.2927909,147.5746979,482.6188612,Benign
10.0.2.15,60245,119.254.87.201,80,13,1730,8,853,5,877,18062.35268,10.018931,681.1105895,700.2743107,Malicious
192.168.137.97,57796,104.197.3.80,80,11,977,6,491,5,486,11723.81257,1.136379769,3456.590928,3421.391427,Benign
192.168.137.97,42268,35.194.103.20,443,23,9494,13,2336,10,7158,348.9602342,1.83326039,10193.86013,31236.15189,Benign
192.168.43.224,48266,104.237.191.1,443,7,474,4,272,3,202,1680.912336,46.28748169,47.0105506,34.91224714,Benign
192.168.43.233,51170,151.101.153.170,443,496,283598,241,21104,255,262494,1036.998074,647.670312,260.6758359,3242.316285,Benign
10.0.2.15,58762,119.254.87.201,80,11,1579,6,705,5,874,16975.91349,0.894989,6301.753429,7812.386521,Malicious
172.30.6.255,55872,210.176.156.55,443,15,4364,8,1279,7,3085,105.564588,15.823382,646.6379943,1559.717133,Benign
10.0.2.15,42670,115.182.31.2,80,9,773,5,517,4,256,180.01534,55.85667,74.04666265,36.66527203,Malicious
172.30.1.136,51553,172.217.161.14,443,1,66,1,66,0,0,735.980373,0,0,0,Benign
172.30.15.579,49864,52.175.23.79,443,26,10169,13,2124,13,8045,2262.50037,125.669703,135.2115872,512.136167,Benign
192.168.43.233,50991,172.217.166.226,443,17,4883,8,1219,9,3664,513.71795,12.861105,758.2552199,2279.119873,Benign
192.168.43.233,51085,23.37.48.123,443,5,294,3,174,2,120,916.410884,10.54811,131.9667694,91.01156511,Benign
10.0.2.15,43009,119.254.87.201,80,11,1582,6,705,5,877,15779.47794,1.286853,4382.78498,5452.060181,Malicious
172.30.1.136,50351,172.217.161.14,443,145,40239,74,27220,71,13019,632.585698,137.63348,1582.173175,756.7344806,Benign
172.30.6.255,58469,35.190.41.40,443,6,348,4,228,2,120,5672.930861,6.119707,298.0534852,156.8702554,Benign
10.0.2.15,40402,119.254.87.201,80,11,1579,6,705,5,874,15984.75771,2.218935,2541.759898,3151.061207,Malicious
10.0.2.15,33159,119.254.87.201,80,11,1593,6,705,5,888,703.091497,1.620244,3480.957189,4384.5248,Malicious
172.30.6.255,56855,103.243.220.231,80,46,36951,16,8890,30,28061,1352.883498,23.175702,3068.731208,9686.35168,Benign
10.0.2.15,48952,119.254.87.201,80,11,1579,6,705,5,874,12473.31556,1.689123,3339.010836,4139.426199,Malicious
172.30.6.255,56337,52.114.76.35,443,35,22041,24,15028,11,7013,602.43532,3.156783,38084.34093,17772.52348,Benign
10.0.2.15,53192,119.254.87.201,80,11,1582,6,705,5,877,4577.398984,0.817951,6895.278568,8577.530928,Malicious
172.30.15.2188,51500,77.88.21.119,443,17,3504,9,2378,8,1126,4277.920851,9.920512,1917.64296,908.0176507,Benign
192.168.137.97,50084,104.237.191.1,443,9,606,5,338,4,268,2152.091723,56.51761639,47.84348975,37.93507471,Benign
172.30.15.1370,50678,67.231.251.190,443,7,402,4,228,3,174,3493.459214,3.897166,468.0324112,357.1826296,Benign
10.0.2.15,49318,119.254.87.201,80,11,1513,6,705,5,808,6855.245356,0.885009,6372.816548,7303.880526,Malicious
172.30.15.1980,51292,52.84.108.203,443,17,6849,9,1141,8,5708,4076.769469,0.47811,19091.84079,95509.4016,Benign
192.168.43.224,39248,54.89.94.62,443,15,3130,8,2235,7,895,3269.236983,1.202726537,14866.22225,5953.140452,Benign
10.0.2.15,60156,119.254.87.201,80,11,1579,6,705,5,874,15504.23978,1.48967,3786.073426,4693.656984,Malicious
192.168.43.224,45776,104.237.191.1,443,27,5556,14,3429,13,2127,2876.820284,49.43230952,554.9406909,344.2283026,Benign
172.30.6.255,56683,157.240.16.39,443,25,5351,14,3349,11,2002,1155.47707,61.269182,437.2834617,261.403849,Benign
192.168.43.233,51300,172.217.161.3,443,9,535,5,295,4,240,2841.571366,62.446792,37.79217354,30.74617508,Benign
10.0.2.15,44658,119.254.87.201,80,11,1582,6,705,5,877,20795.25944,2.084917,2705.143658,3365.121969,Malicious
172.30.15.629,49916,104.16.208.165,443,6,348,4,228,2,120,2392.446169,3.718217,490.5577055,258.188266,Benign
10.0.2.15,44533,119.254.87.201,80,11,1513,6,705,5,808,26411.5562,0.861466,6546.979219,7503.48824,Malicious
192.168.42.240,50918,131.253.61.80,443,1,54,0,0,1,54,47.61006,0,0,0,Benign
192.168.43.224,49882,34.196.177.243,443,482,52424,276,23996,206,28428,1758.649358,156.6384977,1225.548015,1451.903608,Benign
172.30.15.325,49591,172.217.166.206,443,16,5626,7,1165,9,4461,814.227666,0.310001,30064.41915,115122.2093,Benign
172.30.15.432,49706,59.63.81.183,443,44,15657,22,3854,22,11803,1623.38306,7.479226,4122.351698,12624.83578,Benign
172.30.6.255,56430,85.114.159.93,80,7,402,4,228,3,174,679.144805,1.895193,962.4349605,734.4898382,Benign
172.30.15.499,49779,172.25.10.63,7680,3,198,3,198,0,0,1881.79518,9.018246,175.6439112,0,Benign
192.168.137.97,34312,192.229.237.96,443,181,117613,86,7036,95,110577,882.4417218,180.2702982,312.2422305,4907.164457,Benign
172.30.6.255,57439,103.243.221.109,80,16,5472,9,4245,7,1227,2829.862604,31.168094,1089.575769,314.9374485,Benign
172.30.6.255,57619,157.240.16.39,443,28,5560,15,3413,13,2147,3412.097767,61.060942,447.1598227,281.2927452,Benign
192.168.43.233,51312,104.104.201.9,443,22,8999,11,1062,11,7937,3132.070434,63.738279,133.2950957,996.1988462,Benign
172.30.15.610,49897,104.31.90.207,80,241,175393,119,19326,122,156067,2388.971988,7.317157,21129.51793,170631.2985,Benign
10.0.2.15,37044,119.254.87.201,80,11,1513,6,705,5,808,21090.00516,1.224927,4604.356015,5277.049163,Malicious
192.168.43.224,37450,157.240.16.20,443,42,13123,23,2605,19,10518,34.79584713,69.21893246,301.0736985,1215.621175,Benign
192.168.43.233,50862,157.240.16.16,443,13,828,6,372,7,456,20.896283,66.153603,44.98621186,55.14438873,Benign
10.0.2.15,40347,119.254.87.201,80,11,1579,6,705,5,874,2625.095745,1.39018,4057.028586,5029.564517,Malicious
10.0.2.15,55622,119.254.87.201,80,11,1582,6,705,5,877,12260.61955,0.820276,6875.734509,8553.218673,Malicious
172.30.15.271,49534,172.217.166.197,443,43,10547,21,4284,22,6263,176.621322,3.046267,11250.49117,16447.67186,Benign
10.0.2.15,43680,119.254.87.201,80,11,1579,6,705,5,874,15804.49605,1.114403,5061.005758,6274.211394,Malicious
192.168.42.240,51023,104.108.212.173,443,28,4309,12,1420,16,2889,491.58961,116.617621,97.4123799,198.1861729,Benign
172.30.6.255,58529,172.217.166.206,443,14,1617,8,1042,6,575,5784.415654,0.321625,25918.38321,14302.37077,Benign
10.0.2.15,37549,119.254.87.201,80,11,1582,6,705,5,877,15087.0538,1.723124,3273.124859,4071.67447,Malicious
172.30.15.847,50150,52.114.132.21,443,26,12939,16,8189,10,4750,3331.969873,1.459968,44872.21638,26027.96774,Benign
192.168.137.97,42474,52.84.110.205,443,30,7799,17,2968,13,4831,382.2948714,162.6375011,145.9933892,237.6327707,Benign
172.30.15.2078,51390,35.171.73.174,443,6,348,4,228,2,120,4122.698697,4.882422,373.5850772,196.6237249,Benign
172.30.6.255,58177,103.243.221.51,80,27,17918,12,5401,15,12517,5023.860959,17.669734,2445.311288,5667.091536,Benign
172.30.1.136,50752,172.217.161.3,443,10,612,5,306,5,306,1900.318707,8.940399,273.8132828,273.8132828,Benign
172.30.6.255,57368,103.231.98.53,80,40,17472,21,15726,19,1746,2580.879211,68.277941,1842.586319,204.5755891,Benign
172.30.6.255,55605,172.217.166.206,443,3,162,2,108,1,54,60.128353,0.04214,20503.08495,10251.54248,Benign
192.168.137.97,39660,192.168.125.6,80,28,16500,15,1574,13,14926,8266.284463,11.4100409,1103.589383,10465.16845,Benign
10.0.2.15,44464,119.254.87.201,80,11,1579,6,705,5,874,25474.8664,1.028716,5482.562729,6796.822447,Malicious
192.168.137.97,35484,104.198.143.177,80,11,977,6,491,5,486,11123.81359,1.248778813,3145.472969,3113.441676,Benign
172.30.6.255,55946,52.23.112.47,443,36,13439,21,6472,15,6967,152.97847,100.431394,515.5360086,554.9659104,Benign
10.0.2.15,54326,119.254.87.201,80,11,1582,6,705,5,877,20585.14219,1.889452,2984.992474,3713.245957,Malicious
172.30.15.1046,50352,4.78.226.234,443,7,398,4,228,3,170,3447.785606,9.616633,189.6713746,141.4216389,Benign
192.168.43.224,37366,151.101.194.217,443,19,8473,11,1344,8,7129,1274.764547,11.22530494,957.8358947,5080.66376,Benign
192.168.43.233,51464,172.217.160.238,443,12,696,6,348,6,348,3815.179802,14.224479,195.7189434,195.7189434,Benign
10.0.2.15,50887,119.254.87.201,80,12,1656,7,779,5,877,17906.66121,4.407626,1413.913068,1591.786599,Malicious
192.168.137.97,60964,206.189.157.46,443,435,395432,160,12429,275,383003,418.6641556,149.6782138,664.3050945,20470.74134,Benign
10.0.2.15,35032,119.254.87.201,80,11,1579,6,705,5,874,20524.48517,1.265923,4455.247278,5523.242725,Malicious
172.30.15.1873,51185,52.6.46.142,443,6,348,4,228,2,120,3953.877853,3.612062,504.9747208,265.7761688,Benign
172.30.15.371,49639,172.217.166.206,443,18,5757,10,1351,8,4406,1442.929237,7.454019,1449.956057,4728.724196,Benign
192.168.43.233,50962,163.53.78.128,443,31,9354,17,2206,14,7148,480.525801,98.924818,178.3981043,578.0551449,Benign
10.0.2.15,39315,119.254.87.201,80,11,1582,6,705,5,877,12743.6919,2.162122,2608.548454,3244.960275,Malicious
172.30.15.504,49786,172.217.166.197,443,83,41004,36,6739,47,34265,1996.660698,9.281125,5808.778569,29535.2126,Benign
172.30.6.255,56633,103.243.221.17,80,15,5427,9,4254,6,1173,1011.893799,13.177639,2582.556708,712.1154252,Benign
10.0.2.15,34835,119.254.87.201,80,11,1513,6,705,5,808,21062.62527,1.79518,3141.746232,3600.753128,Malicious
172.30.15.2329,51662,52.55.184.84,443,6,348,4,228,2,120,5081.665017,6.568743,277.6786974,146.1466829,Benign
192.168.137.97,41642,104.198.143.177,80,10,911,5,425,5,486,2281.528603,0.856605454,3969.155209,4538.845722,Benign
172.30.6.255,55807,151.101.66.49,80,22,2387,12,1313,10,1074,90.846811,303.151178,34.6493788,28.34229462,Benign
10.0.2.15,49640,119.254.87.201,80,11,1579,6,705,5,874,19077.83166,2.865099,1968.518365,2440.404328,Malicious
10.0.2.15,51194,119.254.87.201,80,11,1579,6,705,5,874,18482.855,1.667115,3383.089949,4194.071795,Malicious
172.30.15.2136,51448,54.229.135.68,443,15,5019,8,1087,7,3932,4178.574739,8.778326,990.6216743,3583.371135,Benign
172.30.15.1309,50617,151.101.193.2,443,8,480,5,294,3,186,3487.002959,10.142629,231.8925399,146.7075252,Benign
172.30.15.1454,50762,103.231.98.43,443,52,17586,18,8973,34,8613,3502.238838,4.830672,14860.04432,14263.85397,Benign
192.168.137.97,39734,172.217.161.14,443,11,1275,8,1093,3,182,3750.611612,45.51796282,192.0999855,31.98737179,Benign
172.30.15.1568,50877,151.101.130.2,443,39,16982,18,2781,21,14201,3557.571274,9.443661,2355.866014,12030.08028,Benign
192.168.43.233,51460,157.240.16.16,443,29,6893,14,1972,15,4921,3813.455862,69.69804,226.3478284,564.8365435,Benign
172.30.15.1119,50427,54.85.78.249,80,6,348,4,228,2,120,3458.279542,9.367696,194.7116986,102.4798414,Benign
10.0.2.15,43475,119.254.87.201,80,11,1582,6,705,5,877,7698.576264,1.221458,4617.432609,5743.955175,Malicious
172.30.6.255,56775,23.198.126.238,443,18,6428,9,1363,9,5065,1245.554968,1.763362,6183.642383,22978.83248,Benign
172.30.15.702,49989,34.239.20.30,443,29,10960,16,2577,13,8383,2403.252592,3.141471,6562.530738,21347.96088,Benign
172.30.15.758,50048,169.55.60.80,443,20,7668,11,1753,9,5915,2589.028365,7.365449,1904.025131,6424.591359,Benign
172.30.15.363,49631,195.154.150.142,80,15,4268,8,1248,7,3020,1400.278821,10.230631,975.8928848,2361.535667,Benign
10.0.2.15,59033,119.254.87.201,80,12,1587,7,779,5,808,21783.34548,7.432779,838.4481767,869.6612667,Malicious
10.0.2.15,33520,119.254.87.201,80,11,1513,6,705,5,808,1812.328634,1.619687,3482.154268,3990.894537,Malicious
192.168.137.97,40800,18.211.26.179,443,137,77561,68,22180,69,55381,38.10673252,136.8221923,1296.86564,3238.129667,Benign
192.168.43.224,41272,104.244.42.193,443,1212,419848,674,140848,538,279000,31.94408073,1514.938991,743.7817672,1473.326658,Benign
192.168.43.233,51231,172.217.166.195,443,21,7284,10,1856,11,5428,1435.63498,0.842435,17625.09867,51545.81659,Benign
192.168.42.240,51005,172.217.163.78,443,22,1308,12,720,10,588,356.702308,30.824128,186.8666001,152.6077234,Benign
172.30.6.255,57743,157.240.16.39,443,19,1933,10,1125,9,808,3839.088602,61.059259,147.3977927,105.8643702,Benign
10.0.2.15,37657,119.254.87.201,80,11,1582,6,705,5,877,3434.258962,1.739086,3243.082861,4034.303076,Malicious
192.168.43.224,43120,117.18.232.205,443,11,670,7,418,4,252,880.1586326,34.72364306,96.30325926,58.05842424,Benign
10.0.2.15,53772,119.254.87.201,80,11,1579,6,705,5,874,2653.53963,1.45201,3884.270769,4815.393833,Malicious
172.30.1.136,51828,13.107.4.52,80,13,924,5,460,8,464,3298.451173,3.790936,970.7365147,979.1777018,Benign
192.168.137.97,51918,151.139.237.11,443,23,7712,13,1389,10,6323,5243.811537,64.13989115,173.2463183,788.6511669,Benign
172.30.6.255,56878,103.243.220.231,80,6,348,4,228,2,120,1382.862191,22.779841,80.07079593,42.14252417,Benign
192.168.43.233,50914,66.77.51.230,80,237,218633,82,4853,155,213780,372.139163,135.983221,285.5058125,12576.84579,Benign
172.30.15.1219,50527,173.241.248.220,80,9,1939,6,1461,3,478,3467.151767,10.472151,1116.103081,365.1589821,Benign
10.0.2.15,51651,119.254.87.201,80,11,1582,6,705,5,877,11632.53045,8.381104,672.9423713,837.1212194,Malicious
10.0.2.15,36683,119.254.87.201,80,11,1579,6,705,5,874,16109.94254,2.154959,2617.219168,3244.609294,Malicious
192.168.43.233,50731,151.101.129.181,443,9,534,5,294,4,240,1855.991867,13.499015,174.2349349,142.2325999,Benign
192.168.215.49,36044,210.176.156.35,443,28,13269,17,5564,11,7705,480.1207857,134.7929262,330.225044,457.2940266,Benign
172.30.15.757,50047,104.16.37.47,443,32,10902,17,2033,15,8869,2588.690126,7.585162,2144.186242,9354.052029,Benign
172.30.6.255,56042,161.170.232.82,80,17,2015,9,962,8,1053,254.39964,157.476032,48.87092913,53.49385486,Benign
172.30.6.255,58152,103.243.221.87,80,25,14268,11,5346,14,8922,4957.840311,1.241926,34436.8344,57472.02329,Benign
192.168.137.97,60626,198.252.206.25,443,166,17194,82,7649,84,9545,731.7701266,2348.42331,26.05663116,32.51543267,Benign
192.168.43.233,51182,52.70.107.220,443,9,534,5,294,4,240,1051.300242,26.28766,89.47163802,73.03807186,Benign
172.30.6.255,57006,103.243.221.51,80,17,5534,10,4299,7,1235,1497.850073,25.51558,1347.882353,387.2144,Benign
172.30.6.255,57311,103.243.221.51,80,17,5496,9,4215,8,1281,2439.862107,14.025093,2404.262132,730.6903419,Benign
172.30.6.255,57102,115.114.126.194,443,17,6860,10,1174,7,5686,1781.11797,14.533034,646.2518425,3129.972723,Benign
10.0.2.15,50955,119.254.87.201,80,11,1579,6,705,5,874,19470.90802,2.084856,2705.222807,3353.708841,Malicious
172.30.15.2317,51647,52.55.184.84,443,97,84679,32,3813,65,80866,5039.289361,8.553513,3566.254006,75633.01769,Benign
10.0.2.15,47502,119.254.87.201,80,11,1513,6,705,5,808,9107.315654,1.813549,3109.924242,3564.281969,Malicious
192.168.43.224,48802,34.227.208.227,443,6,412,4,272,2,140,361.4677193,44.47014508,48.93170454,25.18543616,Benign
192.168.43.224,33536,172.217.166.195,443,18,5875,10,1443,8,4432,2081.220355,13.54464824,852.2923443,2617.712869,Benign
172.30.15.437,49711,59.63.81.183,443,48,17325,24,3347,24,13978,1623.844174,7.018342,3815.146084,15933.10785,Benign
192.168.43.224,56878,13.228.144.151,443,6,412,4,272,2,140,56.96538751,18.57582923,117.1414731,60.29340528,Benign
172.30.15.1511,50819,184.29.24.49,443,55,43073,21,3022,34,40051,3524.111974,2.925434,8264.072955,109524.9457,Benign
172.30.6.255,57247,103.243.220.231,80,37,20086,19,12026,18,8060,2225.856508,26.371442,3648.188825,2445.069177,Benign
10.0.2.15,44320,119.254.87.201,80,11,1579,6,705,5,874,25835.42512,2.023224,2787.63004,3455.870433,Malicious
172.30.6.255,56369,103.243.221.46,443,6,348,4,228,2,120,609.58353,22.497891,81.07426603,42.67066633,Benign
172.30.15.521,49804,23.9.250.106,443,49,25433,21,3338,28,22095,2136.985066,9.011617,2963.286167,19614.6818,Benign
192.168.43.233,50704,172.217.166.196,443,129,53711,57,7218,72,46493,1843.187767,4.156199,13893.46372,89491.38383,Benign
172.30.15.1652,50963,103.254.155.35,443,20,9230,10,3404,10,5826,3579.128627,8.370844,3253.196452,5567.897335,Benign
192.168.137.97,52760,184.29.25.201,443,8,552,5,338,3,214,349.5709837,14.16786452,190.8544506,120.8368415,Benign
10.0.2.15,53190,119.254.87.201,80,11,1579,6,705,5,874,2835.3573,1.635533,3448.417122,4275.058956,Malicious
10.0.2.15,51484,119.254.87.201,80,3,222,3,222,0,0,21335.83239,9.062415,195.9742519,0,Malicious
192.168.137.97,41512,104.198.143.177,80,10,911,5,425,5,486,1381.529538,0.846309302,4017.443731,4594.065067,Benign
192.168.137.97,45270,13.229.196.49,443,35,13394,19,5772,16,7622,24.28474497,72.41812074,637.630465,841.9992038,Benign
172.30.15.232,49501,172.217.166.197,443,767,489922,298,46029,469,443893,50.835682,18.651558,19742.69388,190393.9607,Benign
172.30.15.2054,51366,54.246.156.84,443,6,348,4,228,2,120,4094.356261,3.23676,563.5264895,296.5928892,Benign
172.30.6.255,57565,210.176.156.62,80,38,16301,20,11617,18,4684,3254.845788,263.646205,352.5027034,142.1298668,Benign
192.168.43.233,51696,52.216.0.24,80,51,29280,25,1856,26,27424,1492.293124,81.54162,182.0910598,2690.552383,Benign
10.0.2.15,41529,119.254.87.201,80,11,1579,6,705,5,874,6589.52468,1.427601,3950.683699,4897.727026,Malicious
172.30.6.255,58243,180.149.59.232,80,12,4896,8,3669,4,1227,5222.021523,37.200084,789.0304764,263.8703719,Benign
172.30.15.938,50244,54.169.20.177,80,38,18528,20,8500,18,10028,3441.007512,6.055168,11230.07652,13248.84793,Benign
192.168.43.224,55982,172.217.166.196,80,21,3008,11,1757,10,1251,3069.215364,287.3963907,48.90806028,34.8229843,Benign
10.0.2.15,40376,119.254.87.201,80,11,1582,6,705,5,877,5926.657083,1.752872,3217.57664,4002.574061,Malicious
172.30.15.1303,50611,23.8.189.227,443,1485,1354109,539,35009,946,1319100,3485.814136,11.219477,24963.01744,940578.6027,Benign
172.30.15.1997,51309,151.101.65.2,443,15,5470,9,1120,6,4350,4077.510839,4.736881,1891.540024,7346.606343,Benign
192.168.43.224,38554,34.236.23.199,443,33,11283,19,4530,14,6753,930.8025847,79.77475591,454.2790459,677.2067101,Benign
192.168.43.224,55458,23.213.88.167,443,43,12552,22,4204,21,8348,730.2535365,72.05241659,466.7712978,926.8807788,Benign
172.30.6.255,57582,103.243.221.17,80,16,6180,9,4498,7,1682,3315.859955,3.600305,9994.708782,3737.461132,Benign
10.0.2.15,33463,119.254.87.201,80,11,1582,6,705,5,877,5774.142721,1.819922,3099.033915,3855.110274,Malicious
10.0.2.15,53467,119.254.87.201,80,12,1653,7,779,5,874,17578.65966,3.985723,1563.580811,1754.261397,Malicious
10.0.2.15,46181,119.254.87.201,80,11,1582,6,705,5,877,24068.75875,2.019117,2793.30024,3474.786256,Malicious
192.168.137.97,36336,52.84.103.186,443,24,2564,18,1929,6,635,3757.631335,90.17881249,171.1266713,56.33252268,Benign
172.30.15.1346,50654,192.229.237.25,443,28,14413,14,2800,14,11613,3492.127894,4.883952,4586.449662,19022.29997,Benign
10.0.2.15,43969,119.254.87.201,80,11,1582,6,705,5,877,12833.74805,2.411051,2339.228826,2909.934298,Malicious
172.30.6.255,56060,103.243.221.87,80,14,3896,8,2714,6,1182,284.903264,19.211923,1130.131533,492.1943524,Benign
172.30.6.255,58527,172.217.166.226,80,28,6662,15,3726,13,2936,5781.82938,7.562682,3941.458863,3105.776496,Benign
172.30.6.255,56116,103.243.221.87,80,23,15112,8,2867,15,12245,323.862652,16.589173,1382.588511,5905.056268,Benign
10.0.2.15,59930,119.254.87.201,80,11,1582,6,705,5,877,16590.45682,1.418666,3975.565778,4945.491046,Malicious
192.168.43.224,58008,172.217.166.206,443,24,6860,13,2170,11,4690,24.41159697,13.25926831,1309.272849,2829.718738,Benign
192.168.43.224,55706,172.217.166.196,80,8,544,5,338,3,206,2216.80217,57.62708914,46.92237696,28.5976617,Benign
172.30.6.255,56724,103.243.221.46,80,19,6369,11,5138,8,1231,1195.1925,30.837373,1332.928068,319.3527542,Benign
172.30.15.1344,50652,13.232.120.220,443,21,7678,10,1658,11,6020,3492.021936,4.994841,2655.539986,9641.948563,Benign
192.168.43.224,54500,216.58.221.42,443,7,478,4,272,3,206,127.2414797,22.5146918,96.64800297,73.19664931,Benign
192.168.137.97,35202,172.217.161.1,443,3,198,2,132,1,66,3.965473851,1.572222438,671.6606852,335.8303426,Benign
192.168.42.240,50969,172.217.163.101,443,7694,5847053,4862,5674620,2832,172433,283.409933,324.817897,139761.2644,4246.884216,Benign
192.168.43.233,51292,74.207.230.33,443,15,1543,7,958,8,585,2516.716103,18.993633,403.5036372,246.3983589,Benign
172.30.15.2478,51812,14.139.45.128,80,24,14753,10,911,14,13842,5424.243168,0.280495,25982.63784,394787.7859,Benign
172.30.1.136,50519,104.237.191.1,443,1,66,1,66,0,0,1025.76296,0,0,0,Benign
192.168.43.233,51519,13.107.18.11,443,34,7059,18,1685,16,5374,3916.381895,2.313588,5826.447924,18582.39237,Benign
10.0.2.15,54519,119.254.87.201,80,11,1582,6,705,5,877,2560.960141,1.085365,5196.408581,6464.184859,Malicious
172.30.6.255,56899,198.8.71.209,80,19,9080,11,6002,8,3078,1385.173999,10.336926,4645.094683,2382.139526,Benign
192.168.137.97,46958,52.84.110.17,443,8,552,5,338,3,214,1755.358997,11.56967729,233.7143839,147.9730123,Benign
10.0.2.15,52954,119.254.87.201,80,11,1582,6,705,5,877,25387.87419,2.097841,2688.478297,3344.390733,Malicious
172.30.6.255,56388,70.42.132.21,80,13,1598,7,855,6,743,650.888338,96.316953,71.01553555,61.71291569,Benign
172.30.15.2533,51867,192.168.121.37,443,8,1165,4,800,4,365,5499.878114,0.390638,16383.45476,7474.951234,Benign
172.30.15.1583,50892,184.29.25.7,443,78,65658,30,7088,48,58570,3568.124286,8.943977,6339.908969,52388.32792,Benign
192.168.43.233,51114,13.126.200.177,443,30,9422,14,1936,16,7486,919.859116,60.74675,254.9601419,985.8634413,Benign
10.0.2.15,53440,119.254.87.201,80,11,1579,6,705,5,874,9317.540094,1.82095,3097.284385,3839.753975,Malicious
172.30.6.255,56416,107.178.242.85,80,6,348,4,228,2,120,678.86081,19.052425,95.73584465,50.38728666,Benign
192.168.43.224,36050,34.204.88.0,443,24,6226,13,2549,11,3677,32.24217104,2.526540941,8071.114016,11642.7957,Benign
172.30.15.1250,50558,172.217.160.226,80,8,468,5,282,3,186,3469.519431,7.988589,282.4028123,186.2656847,Benign
172.30.15.2304,51633,192.168.1.44,7680,3,198,3,198,0,0,4976.350603,9.002438,175.9523365,0,Benign
10.0.2.15,56454,119.254.87.201,80,11,1579,6,705,5,874,20792.23294,2.244298,2513.035256,3115.4508,Malicious
172.30.15.1471,50779,104.36.113.23,443,7,402,4,228,3,174,3507.654056,9.810865,185.9163285,141.8835138,Benign
10.0.2.15,42767,119.254.87.201,80,11,1582,6,705,5,877,15774.48626,0.902641,6248.331286,7772.746862,Malicious
192.168.43.224,47276,54.236.156.42,443,10,700,6,412,4,288,18.50863634,13.08660904,251.860508,176.0578308,Benign
192.168.43.224,36210,43.245.63.29,443,7,466,4,272,3,194,2470.115758,60.84179034,35.764891,25.50878255,Benign
172.30.15.253,49462,180.149.59.227,80,3,162,2,108,1,54,66.34964,0.010115,85417.69649,42708.84825,Benign
172.30.15.1070,50376,173.208.120.210,80,12,1398,7,927,5,471,3452.728576,1.489289,4979.557359,2530.066361,Benign
10.0.2.15,32983,119.254.87.201,80,12,1656,7,779,5,877,24006.20722,5.14414,1211.475582,1363.882009,Malicious
172.30.15.562,49846,151.101.0.84,443,23,8713,12,2201,11,6512,2253.725666,2.47537,7113.280035,21045.74266,Benign
172.30.6.255,56080,103.243.221.87,80,25,16506,10,3874,15,12632,303.864244,22.196359,1396.265036,4552.818775,Benign
172.30.15.732,50019,104.31.90.207,80,12,2646,7,1908,5,738,2454.909099,1.340576,11386.15043,4404.077053,Benign
172.30.6.255,55805,103.229.206.27,80,26,3833,14,2175,12,1658,90.848008,320.878203,54.22618251,41.3365566,Benign
10.0.2.15,51786,119.254.87.201,80,11,1582,6,705,5,877,9472.571845,0.969701,5816.225826,7235.219929,Malicious
172.30.1.136,50314,157.240.16.39,443,431,281901,186,12630,245,269271,567.130568,85.589773,1180.514873,25168.52101,Benign
172.30.15.2076,51388,54.85.199.48,443,6,348,4,228,2,120,4122.591717,4.98545,365.8646662,192.5603506,Benign
172.30.1.136,50154,172.217.24.234,443,11,618,6,336,5,282,142.38379,25.511507,105.3642186,88.43068346,Benign
10.0.2.15,51378,124.95.142.227,80,44,25147,20,1549,24,23598,59.020414,1.019177,12158.83011,185231.8096,Malicious
10.0.2.15,43282,119.254.87.201,80,11,1582,6,705,5,877,20495.11669,6.279878,898.1066193,1117.219156,Malicious
192.168.137.97,39732,192.168.125.6,80,18,4907,10,1263,8,3644,8296.007233,3.606988561,2801.228734,8082.088287,Benign
172.30.15.1751,51063,184.29.25.7,443,18,6798,9,1829,9,4969,3637.739404,9.431447,1551.405633,4214.835751,Benign
10.0.2.15,53625,119.254.87.201,80,11,1582,6,705,5,877,21362.91147,1.02499,5502.492707,6844.944829,Malicious
172.30.6.255,57385,103.243.221.75,80,70,49712,43,41800,27,7912,2648.904365,16.158778,20694.63421,3917.127892,Benign
172.30.6.255,57395,192.168.56.1,7680,3,198,3,198,0,0,2680.376588,9.00481,175.905988,0,Benign
172.30.15.1690,51001,184.29.25.7,443,86,68706,37,16999,49,51707,3609.470065,7.659112,17755.58315,54008.34979,Benign
172.30.15.2345,51679,192.168.121.37,443,158,131901,63,4944,95,126957,5313.049536,4.934309,8015.712028,205835.5081,Benign
172.30.6.255,56321,204.2.197.204,80,7,402,4,228,3,174,590.942284,15.131459,120.5435642,91.99377271,Benign
10.0.2.15,52182,119.254.87.201,80,11,1513,6,705,5,808,16645.47292,3.423951,1647.219835,1887.877484,Malicious
172.30.1.136,50150,172.217.24.234,443,18,4647,10,1186,8,3461,140.669979,25.023183,379.1683896,1106.493926,Benign
172.30.15.708,49995,52.84.114.126,443,25,9872,14,3098,11,6774,2403.766301,2.398303,10333.97365,22595.97724,Benign
172.30.15.1606,50916,54.201.247.66,443,14,4951,7,1033,7,3918,3573.727343,1.092618,7563.485134,28687.06172,Benign
172.30.6.255,56508,103.243.221.17,80,28,21136,11,4614,17,16522,828.851104,3.488988,10579.57207,37883.76458,Benign
10.0.2.15,34845,119.254.87.201,80,11,1582,6,705,5,877,1183.652361,1.621447,3478.374563,4326.999279,Malicious
172.30.1.136,50279,52.94.220.15,443,35,8069,16,1555,19,6514,483.456289,28.281944,439.8566096,1842.589038,Benign
10.0.2.15,55688,119.254.87.201,80,11,1582,6,705,5,877,8751.756079,1.015873,5551.875087,6906.375108,Malicious
192.168.43.233,50934,52.94.220.16,443,35,10879,18,2457,17,8422,440.983894,69.990194,280.8393416,962.6491391,Benign
172.30.15.2245,51562,104.121.244.70,443,94,83257,33,7869,61,75388,4468.149779,9.582584,6569.418019,62937.51247,Benign
172.30.6.255,55791,172.217.166.206,443,16,5627,8,1219,8,4408,80.057759,10.564951,923.0520804,3337.829016,Benign
10.0.2.15,48061,119.254.87.201,80,11,1582,6,705,5,877,10128.50381,1.816879,3104.224332,3861.567006,Malicious
192.168.215.49,60434,103.231.98.244,443,24,9107,11,2463,13,6644,480.132886,2.240852014,8793.084004,23719.54938,Benign
10.0.2.15,49957,119.254.87.201,80,11,1582,6,705,5,877,3015.594297,1.774627,3178.132644,3953.50685,Malicious
172.30.15.1576,50885,52.84.109.95,443,11,1342,6,904,5,438,3561.414882,5.567526,1298.961154,629.3639221,Benign
10.0.2.15,34220,119.254.87.201,80,11,1554,6,705,5,849,13046.24141,1.025527,5499.611419,6622.936305,Malicious
192.168.215.49,40698,13.127.63.105,443,32,8387,15,2563,17,5824,1255.75167,31.11777845,658.9159324,1497.279122,Benign
172.30.6.255,58133,216.58.196.194,80,10,1592,6,922,4,670,4910.814993,8.141315,905.9961444,658.3703001,Benign
172.30.1.136,50672,151.101.1.181,443,657,548415,270,18883,387,529532,1802.067805,157.428865,959.5698984,26909.01697,Benign
192.168.43.233,51253,172.217.160.229,443,9,534,5,294,4,240,2266.51883,28.591229,82.26299051,67.15346164,Benign
10.0.2.15,60167,119.254.87.201,80,11,1587,6,705,5,882,10098.4446,1.481493,3806.970401,4762.76297,Malicious
172.30.15.906,50212,104.28.18.232,443,42,12097,21,2372,21,9725,3439.403906,7.658915,2477.63554,10158.09681,Benign
172.30.1.136,50215,52.84.103.186,443,18,4766,10,1138,8,3628,370.537846,103.960216,87.57196118,279.1837216,Benign
192.168.137.97,55936,172.217.161.5,443,1276,903059,585,70030,691,833029,66.24264935,214.6001999,2610.621986,31054.17424,Benign
172.30.15.989,50295,52.220.73.112,80,10,1417,6,853,4,564,3442.830026,4.232849,1612.152949,1065.948726,Benign
10.0.2.15,41972,119.254.87.201,80,11,1579,6,705,5,874,7009.952752,2.150187,2623.027672,3251.810191,Malicious
172.30.15.888,50194,151.101.130.2,443,55,25488,26,2879,29,22609,3438.458176,8.563466,2689.565183,21121.35437,Benign
172.30.15.210,49477,52.175.39.99,443,1,54,1,54,0,0,9.437807,0,0,0,Benign
192.168.137.97,44030,172.217.161.10,443,25,5939,12,2411,13,3528,3838.540614,28.58871286,674.6718573,987.2427675,Benign
192.168.137.97,38818,157.240.16.16,443,41,7900,23,4773,18,3127,284.5360843,93.09859561,410.1458218,268.7043756,Benign
10.0.2.15,59045,119.254.87.201,80,11,1582,6,705,5,877,22591.77846,1.442266,3910.51304,4864.567285,Malicious
172.30.6.255,55811,103.243.221.75,80,12,3186,7,2090,5,1096,91.141818,10.925962,1530.300032,802.4922657,Benign
172.30.15.1701,51012,184.29.25.7,443,86,60647,40,22159,46,38488,3610.148023,6.981068,25393.24929,44105.57239,Benign
10.0.2.15,43442,119.254.87.201,80,11,1582,6,705,5,877,17096.06056,1.360636,4145.12037,5156.412148,Malicious
192.168.43.233,51653,172.217.166.211,443,53,5806,25,3169,28,2637,857.397481,282.6277,89.70104487,74.6423652,Benign
172.30.1.136,51511,131.253.33.254,443,1,54,0,0,1,54,113.686957,0,0,0,Benign
172.30.1.136,50609,157.240.16.20,443,1915,1376137,830,59488,1085,1316649,1613.472728,182.548618,2606.998646,57700.74907,Benign
172.30.6.255,57377,184.85.113.82,443,23,9076,12,1128,11,7948,2634.846867,62.515362,144.3485203,1017.094006,Benign
172.30.15.1378,50686,13.232.120.220,443,21,7562,10,1800,11,5762,3494.683079,2.33583,6164.832201,19734.31286,Benign
172.30.6.255,58249,176.34.147.227,443,6,348,4,228,2,120,5222.843482,36.312612,50.23048191,26.43709574,Benign
172.30.6.255,58479,103.231.98.53,80,19,6478,10,5744,9,734,5682.837045,6.307381,7285.432733,930.9727762,Benign
192.168.137.97,35370,104.17.38.113,443,16,932,8,476,8,456,3515.063356,17.82194151,213.6692009,204.6915033,Benign
10.0.2.15,33329,119.254.87.201,80,11,1582,6,705,5,877,18152.50259,2.053822,2746.099711,3416.070137,Malicious
10.0.2.15,49076,119.254.87.201,80,11,1579,6,705,5,874,15656.61487,1.486092,3795.188992,4704.957701,Malicious
172.30.15.821,50120,74.125.24.188,5228,98,7101,49,3514,49,3587,3097.886435,1821.684965,15.43186695,15.75244927,Benign
172.30.6.255,57328,180.149.59.210,80,10,1002,6,348,4,654,2468.086251,42.747058,65.12728899,122.3943879,Benign
172.30.6.255,57784,103.243.221.51,80,17,5485,9,4204,8,1281,3994.840998,47.218554,712.2623874,217.0333297,Benign
172.30.6.255,57666,103.243.221.75,80,63,45359,38,39157,25,6202,3571.833728,46.208234,6779.224672,1073.748025,Benign
172.30.6.255,57396,103.243.221.17,80,21,10669,10,4552,11,6117,2709.836207,12.197701,2985.480625,4011.903555,Benign
10.0.2.15,49528,119.254.87.201,80,11,1582,6,705,5,877,13616.99152,1.120558,5033.20667,6261.166312,Malicious
192.168.215.49,48650,104.237.191.1,443,8,552,5,338,3,214,173.8479013,20.48631193,131.9905705,83.56799437,Benign
172.30.15.455,49729,23.9.250.106,443,16,4947,7,1033,9,3914,1641.166769,0.162102,50980.247,193162.3299,Benign
172.30.1.136,50754,172.217.161.3,443,17,5113,8,1009,9,4104,1900.569613,7.259322,1111.949573,4522.736421,Benign
192.168.43.224,39024,103.37.200.184,443,78,48494,41,5209,37,43285,2460.539448,51.41979545,810.4271835,6734.371403,Benign
192.168.43.224,39218,169.55.74.49,443,7,478,4,272,3,206,2095.016185,49.31155602,44.12758744,33.42015814,Benign
10.0.2.15,41180,119.254.87.201,80,11,1582,6,705,5,877,9707.949619,2.478464,2275.602954,2830.785519,Malicious
192.168.43.224,42780,172.217.166.197,443,20,5949,11,2014,9,3935,49.98330491,20.42545177,788.8197618,1541.214381,Benign
172.30.15.2256,51573,184.29.25.145,443,12,1423,6,904,6,519,4486.378191,1.182289,6116.947718,3511.83171,Benign
172.30.1.136,50521,74.125.68.188,5228,21,2398,11,1392,10,1006,1029.604084,99.939655,111.4272408,80.52859498,Benign
192.168.43.224,52254,192.0.73.2,443,31,9773,17,1671,14,8102,1903.255891,11.45468068,1167.033842,5658.472882,Benign
192.168.137.97,37174,140.98.193.112,443,4,264,2,132,2,132,3.264295417,1.133687196,931.4738702,931.4738702,Benign
172.30.6.255,56831,103.231.98.53,80,16,10495,12,10267,4,228,1314.884364,2.603109,31553.03908,700.7005853,Benign
10.0.2.15,38685,119.254.87.201,80,11,1579,6,705,5,874,9202.225336,2.006045,2811.502234,3485.465181,Malicious
192.168.43.233,51656,157.240.16.39,443,17,5030,9,1079,8,3951,857.457089,36.244531,238.1600689,872.0763969,Benign
172.30.6.255,56348,18.207.56.96,80,15,5361,9,2805,6,2556,607.536173,24.938276,899.8216236,819.94441,Benign
192.168.43.224,36688,172.217.166.202,443,71,17774,37,8098,34,9676,24.18023291,243.5991273,265.9451235,317.7679693,Benign
172.30.15.2230,51547,104.121.244.70,443,222,180797,89,19438,133,161359,4457.919067,10.496528,14814.80352,122980.8561,Benign
10.0.2.15,42554,119.254.87.201,80,11,1582,6,705,5,877,23828.54741,1.124796,5014.242583,6237.575525,Malicious
172.30.1.136,50635,172.217.161.3,443,17,966,8,456,9,510,1726.47632,19.267566,189.3337228,211.7548215,Benign
10.0.2.15,52486,119.254.87.201,80,11,1579,6,705,5,874,14813.49527,1.42237,3965.21299,4915.739224,Malicious
172.30.15.2528,51862,52.221.28.239,443,63,49350,25,2908,38,46442,5492.264564,2.786102,8350.017336,133353.3374,Benign
192.168.43.224,45934,104.31.92.239,80,115,72297,57,5780,58,66517,804.2789285,76.62928794,603.4246336,6944.290026,Benign
172.30.6.255,56211,54.209.69.152,80,7,414,5,294,2,120,469.888227,21.179766,111.0493855,45.32627981,Benign
172.30.6.255,56278,103.243.221.46,80,15,4626,8,3398,7,1228,566.846736,22.210624,1223.918788,442.3108509,Benign
172.30.1.136,51853,74.125.200.188,5228,9,535,5,295,4,240,3864.024218,56.572842,41.71612945,33.93854599,Benign
192.168.137.97,46608,172.217.161.14,443,51,11279,25,5155,26,6124,1256.377187,240.916303,171.1797811,203.356931,Benign
172.30.15.307,49570,54.86.32.187,80,15,2378,9,1538,6,840,710.495335,4.704116,2615.581759,1428.536201,Benign
172.30.1.136,50491,157.240.16.17,443,14,4868,7,971,7,3897,955.15531,0.266219,29178.98422,117106.5927,Benign
192.168.43.233,51393,162.247.242.20,443,4,236,2,120,2,116,3479.222261,12.080441,79.46729759,76.81838767,Benign
192.168.137.97,46336,172.217.160.227,443,429,231215,172,17554,257,213661,3782.425156,424.6636352,330.6899587,4025.039722,Benign
192.168.43.233,51208,131.253.61.84,443,95,37944,40,10113,55,27831,1240.517742,66.276917,1220.696491,3359.359639,Benign
172.30.6.255,56843,115.114.126.194,443,7,402,4,228,3,174,1338.777892,14.104801,129.3176699,98.68980073,Benign
172.30.15.2453,51787,14.139.45.128,80,10,1391,5,655,5,736,5420.58188,1.170142,4478.088984,5031.867927,Benign
192.168.137.97,39674,172.217.161.14,443,11,754,6,412,5,342,3621.297021,58.1454229,56.68545925,47.05443462,Benign
10.0.2.15,51666,119.254.87.201,80,11,1593,6,705,5,888,9050.068783,1.962129,2874.428746,3620.557058,Malicious
172.30.15.1055,50361,184.72.247.8,80,10,1759,6,1318,4,441,3448.823316,8.496422,1240.992973,415.2336125,Benign
172.30.6.255,56300,54.246.129.36,80,7,614,5,282,2,332,569.160915,19.680595,114.6306806,134.9552694,Benign
172.30.1.136,51878,13.107.4.52,80,11,1573,6,490,5,1083,4396.020714,0.262717,14920.99864,32978.4521,Benign
172.30.15.1076,50382,173.208.120.210,80,15,4413,8,2345,7,2068,3452.775378,5.195483,3610.828868,3184.30452,Benign
192.168.137.97,38800,157.240.16.16,443,50,9439,26,5247,24,4192,281.0650642,109.0182926,385.0363,307.6180998,Benign
172.30.6.255,57894,103.243.221.75,80,27,14153,12,5393,15,8760,4368.839896,37.220158,1159.15682,1882.850685,Benign
10.0.2.15,41307,119.254.87.201,80,11,1579,6,705,5,874,13076.29526,2.109328,2673.837355,3314.799785,Malicious
172.30.15.1767,51079,162.247.242.19,443,29,8794,14,4631,15,4163,3640.901479,6.355953,5828.866261,5239.812189,Benign
172.30.1.136,51814,74.125.68.188,5228,7,402,4,228,3,174,3010.030656,4.388745,415.6085624,317.1749555,Benign
172.30.1.136,51851,13.107.4.52,80,10,1519,5,436,5,1083,3850.494491,0.353743,9860.265786,24492.35745,Benign
192.168.43.233,51141,103.243.221.75,443,22,7382,11,2278,11,5104,925.509806,11.980346,1521.15807,3408.24881,Benign
172.30.15.457,49731,151.101.2.110,443,28,10174,14,1920,14,8254,1641.199228,9.315187,1648.920199,7088.63923,Benign
192.168.43.224,32804,54.243.243.77,443,19,1978,11,1254,8,724,31.25411919,15.53067075,645.9476325,372.9394625,Benign
192.168.215.49,59158,223.31.160.61,443,500,462477,173,19630,327,442847,279.5025942,13.36598102,11749.23111,265059.1823,Benign
10.0.2.15,60766,119.254.87.201,80,11,1554,6,705,5,849,22176.83658,1.042495,5410.09789,6515.139161,Malicious
172.30.1.136,50435,52.84.103.186,443,157,101965,72,10292,85,91673,854.087659,187.568356,438.9653018,3909.955899,Benign
172.30.6.255,57910,103.243.220.231,80,36,28992,13,5459,23,23533,4433.894172,13.168395,3316.425426,14296.65498,Benign
172.30.15.1553,50862,151.101.2.2,443,18,8942,9,1120,9,7822,3554.60773,0.13162,68074.76067,475429.2661,Benign
192.168.43.224,37276,151.101.194.217,443,25,9349,14,1740,11,7609,728.4553822,11.21249791,1241.471803,5428.941926,Benign
172.30.15.447,49721,52.84.110.254,443,15,3321,8,1651,7,1670,1632.626475,7.947239,1661.960839,1681.086979,Benign
172.30.15.876,50182,104.18.255.119,443,66,35126,31,2856,35,32270,3436.186861,10.829603,2109.77263,23838.36231,Benign
10.0.2.15,43358,119.254.87.201,80,11,1579,6,705,5,874,17668.84213,1.192231,4730.626867,5864.635293,Malicious
192.168.43.233,51313,49.44.164.116,443,130,87675,68,8882,62,78793,3133.019341,66.735185,1064.745681,9445.4522,Benign
192.168.43.233,51695,52.84.110.12,443,41,10053,21,2456,20,7597,1492.281891,180.935593,108.5911272,335.8985316,Benign
192.168.137.97,48034,103.102.166.224,443,20,6238,11,1348,9,4890,4.238423643,10.46919156,1030.069985,3736.678211,Benign
192.168.43.224,55250,74.125.68.188,5228,123,12769,63,5215,60,7554,1224.03944,2213.98352,18.84386204,27.29559613,Benign
172.30.6.255,56038,103.243.221.46,80,6,348,4,228,2,120,253.718647,28.307069,64.43620143,33.91379023,Benign
10.0.2.15,53544,119.254.87.201,80,11,1579,6,705,5,874,21480.60262,2.127535,2650.955213,3286.432421,Malicious
10.0.2.15,58432,119.254.87.201,80,11,1582,6,705,5,877,20044.48005,1.429035,3946.71929,4909.606833,Malicious
10.0.2.15,50865,219.234.85.216,80,7,1435,4,695,3,740,36786.92858,0.908039,6123.085022,6519.543764,Malicious
172.30.15.2377,51711,14.139.45.128,80,11,1442,6,713,5,729,5334.650224,0.460148,12396.01172,12674.18309,Benign
192.168.43.224,35594,23.111.9.35,443,10,616,6,364,4,252,2589.658096,13.07975641,222.6341155,154.1313107,Benign
172.30.15.1197,50505,37.157.6.252,80,6,344,4,228,2,116,3465.377021,2.103717,867.0367735,441.1239725,Benign
172.30.15.2046,51358,34.205.118.138,443,6,348,4,228,2,120,4090.971872,6.621512,275.4657849,144.981992,Benign
172.30.6.255,55963,210.176.156.81,443,29,8291,15,4041,14,4250,165.859275,245.861429,131.4887013,138.28928,Benign
10.0.2.15,34251,119.254.87.201,80,11,1582,6,705,5,877,16497.46738,1.361918,4141.218487,5151.558317,Malicious
10.0.2.15,50853,219.234.85.243,80,11,1344,6,792,5,552,185.771341,5.241598,1208.79167,842.491164,Malicious
172.30.15.1399,50707,209.15.36.33,443,21,6998,12,2044,9,4954,3499.787381,6.592053,2480.56258,6012.087585,Benign
172.30.15.1679,50990,184.29.25.7,443,12,1423,6,904,6,519,3597.106094,9.929693,728.3206037,418.1398156,Benign
172.30.1.136,50755,172.217.161.14,443,10,612,5,306,5,306,1900.579773,8.559229,286.0070691,286.0070691,Benign
192.168.42.240,50924,117.18.232.200,443,5,365,2,108,3,257,46.115628,0.004164,0,0,Benign
172.30.6.255,57713,103.243.221.87,80,46,30146,27,25086,19,5060,3714.224186,24.829647,8082.595778,1630.309122,Benign
172.30.15.1161,50469,103.243.220.231,80,13,4127,7,1945,6,2182,3460.530436,7.105957,2189.712096,2456.530486,Benign
172.30.6.255,57842,157.240.16.39,443,19,1933,10,1125,9,808,4205.096751,61.019817,147.4930677,105.9327988,Benign
172.30.15.2350,51684,192.168.121.37,443,13,1529,7,1013,6,516,5321.476785,6.374678,1271.279898,647.56212,Benign
192.168.43.224,42146,192.229.237.25,443,108,58262,57,7678,51,50584,939.1730798,192.1819806,319.6137318,2105.670879,Benign
192.168.43.233,50928,52.16.255.206,443,7,402,4,228,3,174,433.443645,19.521602,93.43495477,71.30562338,Benign
172.30.15.695,49982,54.248.216.124,443,18,3877,10,2141,8,1736,2402.410225,3.908931,4381.76064,3552.889524,Benign
10.0.2.15,42225,119.254.87.201,80,11,1513,6,705,5,808,9620.649638,1.955432,2884.273143,3305.663403,Malicious
192.168.42.240,51013,172.217.166.206,443,34,12488,17,2551,17,9937,417.295051,37.723483,540.9892825,2107.334575,Benign
172.30.1.136,50555,54.229.103.82,443,10,564,5,282,5,282,1472.037436,28.212619,79.96421743,79.96421743,Benign
10.0.2.15,46873,119.254.87.201,80,11,1582,6,705,5,877,18813.20294,1.611704,3499.401875,4353.156659,Malicious
172.30.6.255,58106,35.190.41.40,443,74,17868,32,5132,42,12736,4890.842296,8.355178,4913.839059,12194.59358,Benign
10.0.2.15,54603,119.254.87.201,80,11,1579,6,705,5,874,24724.08467,2.250093,2506.563062,3107.427115,Malicious
172.30.1.136,51801,72.247.219.151,443,14,828,7,414,7,414,2977.633396,37.425214,88.49648796,88.49648796,Benign
172.30.1.136,50474,157.240.16.20,443,25,6688,11,1223,14,5465,899.967814,66.721635,146.6390924,655.259722,Benign
10.0.2.15,53489,119.254.87.201,80,11,1582,6,705,5,877,11334.64437,1.154051,4887.132371,6079.454028,Malicious
172.30.6.255,57208,103.243.221.109,80,39,24182,23,20079,16,4103,2103.840338,27.183561,5909.159584,1207.494485,Benign
172.30.6.255,57255,192.0.73.2,443,39,12026,18,2129,21,9897,2252.07232,181.06906,94.06355785,437.2696252,Benign
172.30.1.136,51226,52.84.108.120,443,1,66,1,66,0,0,1627.466207,0,0,0,Benign
192.168.43.233,51334,157.240.16.20,443,9,511,5,283,4,228,3077.009325,60.825772,37.22106478,29.98728894,Benign
192.168.137.97,42044,18.210.21.97,443,3,198,2,132,1,66,1.17006774,0.225135643,4690.505626,2345.252813,Benign
192.168.43.233,51327,209.197.3.15,443,49,28990,20,2147,29,26843,3075.031969,12.122147,1416.910717,17715.01369,Benign
10.0.2.15,40074,119.254.87.201,80,11,1579,6,705,5,874,250.808037,1.816278,3105.251509,3849.630949,Malicious
10.0.2.15,52536,119.254.87.201,80,11,1579,6,705,5,874,19594.02582,1.291866,4365.777875,5412.326046,Malicious
172.30.6.255,58578,173.241.248.220,80,7,2331,4,1192,3,1139,5880.108729,0.507886,18775.86703,17941.03401,Benign
172.30.6.255,55806,13.228.37.108,80,13,1533,7,893,6,640,90.848659,61.083012,116.9555948,83.82035909,Benign
172.30.6.255,56777,23.198.126.238,443,18,6433,9,1368,9,5065,1245.555039,1.761233,6213.828608,23006.60957,Benign
172.30.1.136,51832,52.84.110.227,443,9,534,5,294,4,240,3305.043211,14.785505,159.0747154,129.8569105,Benign
172.30.6.255,57058,103.231.98.53,80,27,11352,14,10166,13,1186,1663.850064,71.071279,1144.315976,133.4997784,Benign
10.0.2.15,48395,119.254.87.201,80,11,1582,6,705,5,877,21422.93667,2.096168,2690.624034,3347.059968,Malicious
172.30.1.136,51808,103.243.221.46,443,7,394,4,228,3,166,2977.851748,36.56725,49.88069926,36.31664946,Benign
10.0.2.15,50674,119.254.87.201,80,11,1534,6,705,5,829,11479.88669,1.955102,2884.759977,3392.150384,Malicious
192.168.137.97,41358,157.240.16.52,443,65,27512,30,3371,35,24141,2850.435526,101.3007767,266.21711,1906.480941,Benign
192.168.137.97,52792,74.125.68.188,5228,2,120,1,66,1,54,23.99742188,0.614901369,858.6742958,702.5516965,Benign
172.30.1.136,50502,157.240.16.20,443,16,2421,7,1488,9,933,965.483902,0.772283,15414.03864,9664.850838,Benign
172.30.6.255,56286,104.20.68.222,80,7,402,4,228,3,174,569.159706,19.751353,92.34810395,70.47618459,Benign
10.0.2.15,57425,119.254.87.201,80,11,1560,6,705,5,855,19708.5797,2.256585,2499.351897,3031.128896,Malicious
192.168.43.224,38242,140.98.193.112,443,23,9423,12,4034,11,5389,2296.719544,5.111762573,6313.282266,8433.88154,Benign
172.30.15.341,49609,172.217.166.206,443,16,5420,8,1054,8,4366,1033.696829,6.454511,1306.373171,5411.409168,Benign
172.30.15.1027,50333,50.116.239.135,443,6,344,4,228,2,116,3446.759906,0.409268,4456.737395,2267.462885,Benign
192.168.43.233,51417,13.107.246.10,443,19,4992,8,1056,11,3936,3649.367682,125.774216,67.1679798,250.3533793,Benign
10.0.2.15,60771,119.254.87.201,80,11,1513,6,705,5,808,11812.65308,1.419368,3973.599518,4554.139589,Malicious
172.30.6.255,57925,103.243.220.231,80,33,16899,17,4754,16,12145,4488.852825,11.208423,3393.162446,8668.480838,Benign
172.30.6.255,57287,103.243.221.46,80,54,36034,32,30004,22,6030,2338.460133,31.591631,7597.961625,1526.986688,Benign
192.168.43.233,51201,52.46.6.85,443,8690,7197901,3771,234753,4919,6963148,749.552017,668.166957,2810.710677,83370.15684,Benign
10.0.2.15,56339,119.254.87.201,80,11,1579,6,705,5,874,9437.637615,5.680309,992.9037311,1230.918952,Malicious
172.30.15.1719,51030,184.29.25.7,443,141,104211,61,19047,80,85164,3618.90116,8.179847,18628.22129,83291.53345,Benign
172.30.6.255,57526,103.243.220.231,80,29,18146,12,5383,17,12763,3122.85617,10.910597,3946.988419,9358.24135,Benign
10.0.2.15,53889,119.254.87.201,80,11,1579,6,705,5,874,1844.399462,1.625483,3469.737918,4301.490695,Malicious
192.168.43.224,32914,172.217.166.195,443,73,15322,37,6775,36,8547,9.106778592,293.2161092,184.8465971,233.1931904,Benign
172.30.6.255,56786,35.190.43.164,80,109,32215,57,24315,52,7900,1253.8374,668.048068,291.1766523,94.60397092,Benign
192.168.137.97,52102,172.217.161.3,443,23,6237,13,1657,10,4580,8268.989401,19.3224453,686.0415334,1896.240328,Benign
192.168.137.97,41658,104.198.143.177,80,11,977,6,491,5,486,2581.529555,0.853577614,4601.807657,4554.946072,Benign
172.30.15.2333,51666,52.175.23.79,443,27,10025,14,2175,13,7850,5110.063498,158.902925,109.5008163,395.2098427,Benign
172.30.15.871,50177,180.149.59.139,80,19,9280,10,1014,9,8266,3435.215181,1.828645,4436.071517,36162.29503,Benign
10.0.2.15,57872,119.254.87.201,80,11,1582,6,705,5,877,6885.287818,2.087217,2702.162736,3361.413787,Malicious
192.168.137.97,51822,38.81.32.37,443,50,13021,25,4817,25,8204,127.7322022,552.7216672,69.72044392,118.7433095,Benign
10.0.2.15,43425,119.254.87.201,80,11,1579,6,705,5,874,15719.41399,2.048507,2753.224666,3413.217529,Malicious
172.30.6.255,57038,103.243.221.75,80,40,24212,24,20117,16,4095,1593.88139,16.486157,9761.886897,1987.12168,Benign
172.30.6.255,58313,210.176.156.21,80,14,5528,8,3970,6,1558,5353.882872,5.2236,6080.098017,2386.093882,Benign
10.0.2.15,53745,119.254.87.201,80,11,1513,6,705,5,808,11362.38774,1.384337,4074.152464,4669.38325,Malicious
192.168.43.224,56876,13.228.144.151,443,26,9848,14,2535,12,7313,56.90139991,105.6703985,191.9175122,553.6460618,Benign
172.30.6.255,57274,103.243.220.231,80,3,198,3,198,0,0,2285.869845,9.006017,175.8824128,0,Benign
10.0.2.15,42582,119.254.87.201,80,11,1593,6,705,5,888,13073.97518,2.08335,2707.178343,3409.892721,Malicious
172.30.6.255,58081,103.243.221.51,80,41,27360,18,8738,23,18622,4857.237323,15.471839,4518.144223,9628.848904,Benign
172.30.15.975,50281,52.187.52.94,80,5,294,3,174,2,120,3442.512677,4.527853,307.4304753,212.0210175,Benign
172.30.15.2431,51765,14.139.45.128,443,3,198,3,198,0,0,5407.722548,9.022538,175.5603579,0,Benign
172.30.6.255,58566,35.190.43.164,80,7,1467,4,1067,3,400,5879.848172,0.830178,10282.13227,3854.595039,Benign
10.0.2.15,40546,119.254.87.201,80,11,1582,6,705,5,877,8509.440457,1.885962,2990.516246,3720.117372,Malicious
172.30.6.255,56770,23.198.126.238,443,19,6516,10,1451,9,5065,1245.554338,1.282955,9047.862162,31583.33691,Benign
172.30.27.232,59065,172.30.1.136,7680,3,198,3,198,0,0,402.218137,9.282106,170.6509277,0,Benign
172.30.15.328,49596,52.229.170.171,443,30,10141,17,2291,13,7850,897.024418,64.752594,283.0465757,969.8453162,Benign
172.30.6.255,57739,103.243.221.87,80,24,13513,11,4606,13,8907,3799.841942,45.22558,814.7601424,1575.568517,Benign
172.30.6.255,55657,35.190.43.164,80,36,10453,18,7661,18,2792,37.639212,20.97118,2922.486956,1065.080744,Benign
10.0.2.15,37398,119.254.87.201,80,11,1579,6,705,5,874,4907.715749,1.746791,3228.777799,4002.768505,Malicious
10.0.2.15,33640,119.254.87.201,80,11,1582,6,705,5,877,26556.33413,0.820863,6870.817664,8547.102257,Malicious
192.168.43.224,52208,151.101.153.176,443,8,552,5,338,3,214,31.74117419,12.39446895,218.1618277,138.1261276,Benign
172.30.15.1597,50906,172.217.166.198,443,34,8141,16,2629,18,5512,3572.939606,4.211788,4993.603667,10469.66277,Benign
172.30.6.255,58542,157.240.16.17,443,433,365558,178,11892,255,353666,5811.12452,7.953883,11960.95039,355716.5726,Benign
172.30.6.255,57683,103.243.220.231,80,52,37631,20,9533,32,28098,3641.844033,37.17711,2051.369781,6046.301071,Benign
10.0.2.15,55196,119.254.87.201,80,11,1579,6,705,5,874,3013.824514,1.66246,3392.562829,4205.815478,Malicious
10.0.2.15,59770,119.254.87.201,80,11,1579,6,705,5,874,5328.240081,1.82207,3095.380529,3837.393734,Malicious
172.30.6.255,57169,103.243.221.46,80,16,5473,9,4245,7,1228,1982.869715,25.155802,1349.986774,390.5262094,Benign
192.168.43.233,51103,52.84.102.201,443,36,13513,18,2487,18,11026,918.755229,157.445008,126.3679316,560.2464068,Benign
10.0.2.15,53472,119.254.87.201,80,11,1582,6,705,5,877,14665.6076,2.484651,2269.936502,2823.736613,Malicious
172.30.6.255,58128,216.58.196.194,80,10,1609,6,939,4,670,4899.844212,9.287792,808.8036425,577.1016405,Benign
10.0.2.15,56244,119.254.87.201,80,11,1579,6,705,5,874,24543.9674,1.509193,3737.096581,4632.939591,Malicious
192.168.137.97,39650,192.168.125.7,8380,223,149291,107,8990,116,140301,8299.979945,828.3445319,86.82377589,1355.0014,Benign
172.30.15.1296,50604,210.176.156.62,80,10,3902,5,3620,5,282,3471.141719,0.521016,55583.70568,4330.001382,Benign
172.30.6.255,58098,161.69.38.37,80,7,398,4,228,3,170,4873.358189,0.562961,3240.011297,2415.797897,Benign
172.30.15.1072,50378,108.59.8.1,80,10,2407,6,1443,4,964,3452.739931,4.612067,2502.999198,1672.135292,Benign
172.30.15.537,49821,52.22.176.255,443,6,348,4,228,2,120,2249.173645,7.094771,257.0907504,135.3109212,Benign
172.30.6.255,56127,103.243.221.109,80,48,33586,28,29276,20,4310,345.83748,23.188727,10100.08009,1486.929403,Benign
172.30.15.601,49887,13.107.21.200,443,49,14164,23,5224,26,8940,2347.877805,8.255406,5062.37973,8663.41401,Benign
192.168.215.49,58284,157.240.16.16,443,220,17820,110,9020,110,8800,2.701886225,1674.205709,43.10103569,42.04979092,Benign
192.168.43.233,51679,54.255.158.169,443,50,13031,26,5079,24,7952,894.61006,64.842754,626.6236008,981.0810935,Benign
172.30.1.136,50472,157.240.16.20,443,25,6687,11,1223,14,5464,899.668083,67.021373,145.9832821,652.2098555,Benign
172.30.1.136,50310,104.17.161.9,443,9,534,5,294,4,240,552.844348,16.163754,145.510752,118.7842874,Benign
172.30.15.1586,50895,104.122.123.186,443,18,6530,9,1514,9,5016,3571.275291,5.79122,2091.441872,6929.109928,Benign
192.168.43.224,59346,140.98.193.112,443,30,14929,16,4583,14,10346,51.74753495,5.969452723,6141.936573,13865.25764,Benign
172.30.6.255,57300,103.243.221.51,80,36,22444,16,8677,20,13767,2402.880333,21.152781,3281.648876,5206.691262,Benign
172.30.6.255,56272,147.75.111.32,443,31,12050,16,5020,15,7030,531.274171,36.898299,1088.397056,1524.189503,Benign
10.0.2.15,44291,119.254.87.201,80,11,1579,6,705,5,874,6166.891599,1.626,3468.634686,4300.123001,Malicious
10.0.2.15,40043,119.254.87.201,80,11,1582,6,705,5,877,17038.12834,2.159633,2611.554834,3248.700126,Malicious
10.0.2.15,47882,119.254.87.201,80,11,1582,6,705,5,877,19894.33355,1.463011,3855.063291,4795.58937,Malicious
192.168.43.233,51407,151.101.152.223,443,100,34411,44,4507,56,29904,3646.580058,416.7314,86.5209581,574.0676129,Benign
192.168.43.233,51235,204.79.197.213,443,36,15430,19,5208,17,10222,1632.14445,71.234971,584.8812657,1147.97548,Benign
10.0.2.15,58177,119.254.87.201,80,11,1568,6,705,5,863,26496.23898,1.223642,4609.19125,5642.173119,Malicious
10.0.2.15,59820,119.254.87.201,80,11,1579,6,705,5,874,15684.42806,1.28863,4376.74119,5425.917447,Malicious
172.30.1.136,50453,157.240.16.20,443,3,198,3,198,0,0,857.463514,9.00542,175.8940727,0,Benign
192.168.137.97,39904,172.217.161.14,443,9,606,5,338,4,268,5007.187024,56.0196623,48.26876652,38.27227641,Benign
172.30.15.1401,50709,204.2.197.204,443,19,7648,10,1722,9,5926,3499.814109,1.42891,9640.915103,33177.73688,Benign
10.0.2.15,60497,119.254.87.201,80,11,1579,6,705,5,874,72.390246,1.837892,3068.733092,3804.358472,Malicious
172.30.6.255,55916,72.251.245.181,80,11,1856,6,923,5,933,121.807391,30.18392,244.6335665,247.2839843,Benign
172.30.15.842,50145,52.175.23.79,443,25,10117,12,2071,13,8046,3240.577953,121.393953,136.4812628,530.2405796,Benign
172.30.6.255,58274,210.176.156.41,80,14,5528,8,3970,6,1558,5287.876908,36.195672,877.4529728,344.3505621,Benign
192.168.137.97,39780,172.217.167.10,443,9,618,5,338,4,280,149.5717802,25.41712227,106.3849782,88.12956777,Benign
172.30.15.982,50288,13.251.188.116,443,23,8583,12,2393,11,6190,3442.647923,4.414694,4336.427395,11217.08549,Benign
192.168.137.97,35230,35.241.16.233,443,123,44282,61,6969,62,37313,346.4309014,266.9266951,208.8663331,1118.299539,Benign
10.0.2.15,34349,119.254.87.201,80,12,1632,7,779,5,853,16170.00217,3.913807,1592.311527,1743.570902,Malicious
172.30.15.1115,50423,52.84.112.65,80,8,480,5,294,3,186,3458.274285,8.758136,268.5502943,169.8991658,Benign
172.30.6.255,57551,103.243.221.17,80,39,24244,23,20150,16,4094,3218.837089,35.194013,4580.3245,930.6128289,Benign
10.0.2.15,38834,119.254.87.201,80,11,1582,6,705,5,877,5323.837198,1.827952,3085.420186,3838.175182,Malicious
10.0.2.15,54907,119.254.87.201,80,11,1513,6,705,5,808,15113.84762,1.662865,3391.736551,3887.266856,Malicious
172.30.6.255,57779,103.243.221.51,80,17,6250,9,4487,8,1763,3981.839346,13.209556,2717.426687,1067.71189,Benign
172.30.6.255,57855,103.243.221.51,80,15,7424,10,6355,5,1069,4225.152392,12.904672,3939.658443,662.7057239,Benign
172.30.6.255,57514,103.243.221.109,80,40,26854,16,8594,24,18260,3072.844531,50.184948,1369.972526,2910.832945,Benign
192.168.215.49,42260,111.119.15.1,443,17,5301,9,1233,8,4068,509.9891671,0.433816292,22737.73526,75017.92948,Benign
192.168.43.224,52630,192.229.237.96,443,384,212563,183,14365,201,198198,977.7080584,560.3491845,205.0864054,2829.635599,Benign
192.168.43.224,48370,169.237.6.105,80,18,3505,10,608,8,2897,27.61240033,16.34906956,297.5092853,1417.573026,Benign
10.0.2.15,56779,119.254.87.201,80,11,1568,6,705,5,863,20434.97862,1.985465,2840.644383,3477.271067,Malicious
192.168.137.97,59190,18.210.21.97,443,31,6762,16,2130,15,4632,8284.2403,76.38900138,223.0687624,485.0960129,Benign
10.0.2.15,37351,119.254.87.201,80,11,1579,6,705,5,874,9257.480711,1.857933,3035.631532,3763.321928,Malicious
172.30.15.1670,50981,172.25.10.224,7680,3,198,3,198,0,0,3593.591966,9.011172,175.7817962,0,Benign
10.0.2.15,37356,119.254.87.201,80,11,1579,6,705,5,874,5594.00602,1.282266,4398.463345,5452.846757,Malicious
172.30.6.255,56550,172.217.166.195,443,28,7561,16,2323,12,5238,833.442871,22.672091,819.6861948,1848.263577,Benign
192.168.215.49,36494,157.240.16.52,443,30,6563,15,1982,15,4581,243.2837414,65.13811534,243.4212276,562.6199009,Benign
172.30.6.255,56019,34.234.151.4,443,38,19032,21,13708,17,5324,229.437197,120.991608,906.3769117,352.0244148,Benign
192.168.137.97,41438,119.81.21.130,443,16,5473,9,1257,7,4216,376.9935929,13.09048182,768.1917396,2576.52854,Benign
172.30.15.2058,51370,54.236.156.42,443,28,6980,14,2058,14,4922,4103.72266,3.799656,4333.023832,10363.04339,Benign
10.0.2.15,40777,119.254.87.201,80,11,1579,6,705,5,874,1301.839328,1.680155,3356.833149,4161.520812,Malicious
192.168.42.240,51010,172.217.163.67,443,32,5902,17,4242,15,1660,390.169227,27.125004,1251.09659,489.5851813,Benign
172.30.15.618,49905,192.0.73.2,443,21,8410,10,1145,11,7265,2391.296711,0.739028,12394.65893,78643.84029,Benign
192.168.137.97,39758,172.217.167.10,443,12,836,7,490,5,346,94.57687566,45.86927408,85.46025805,60.34540671,Benign
172.30.1.136,51917,52.84.108.135,443,13,776,7,416,6,360,5787.23273,132.969939,25.02821333,21.65903077,Benign
192.168.43.233,51260,52.84.108.242,443,37,15462,18,2805,19,12657,2300.637757,214.654209,104.5402282,471.716816,Benign
10.0.2.15,59277,119.254.87.201,80,11,1582,6,705,5,877,4967.800186,1.752741,3217.817122,4002.873214,Malicious
192.168.43.233,51209,52.175.28.154,443,40,18438,23,8225,17,10213,1242.273385,127.36359,516.6311659,641.502018,Benign
10.0.2.15,51205,119.254.87.201,80,11,1582,6,705,5,877,15446.38317,3.030059,1861.349895,2315.466465,Malicious
172.30.6.255,57862,103.243.221.87,80,18,7220,10,3900,8,3320,4226.114077,11.942987,2612.411786,2223.899264,Benign
10.0.2.15,54141,119.254.87.201,80,11,1544,6,705,5,839,16410.31092,1.233379,4572.803656,5441.960663,Malicious
172.30.6.255,58030,157.240.16.39,443,24,3843,13,2387,11,1456,4802.184336,1.71335,11145.41687,6798.377448,Benign
172.30.15.1713,51024,184.29.25.7,443,137,111987,53,22004,84,89983,3618.87762,8.202086,21461.85739,87765.96588,Benign
172.30.15.2365,51699,14.139.45.128,80,13,4400,6,689,7,3711,5332.900278,0.421893,13064.92404,70368.55316,Benign
10.0.2.15,32944,119.254.87.201,80,11,1579,6,705,5,874,22501.67361,1.087044,5188.382439,6432.122343,Malicious
172.30.15.1178,50486,104.36.113.23,443,7,402,5,282,2,120,3464.443425,3.756601,600.5428844,255.5501636,Benign
192.168.43.224,41576,103.102.166.240,443,20,6165,11,1336,9,4829,29.98782559,13.96784003,765.186312,2765.781962,Benign
172.30.6.255,57942,103.243.221.17,80,14,7280,10,5660,4,1620,4558.855966,1.990155,22751.9967,6512.055594,Benign
192.168.43.224,41866,23.251.156.28,443,9,610,5,338,4,272,478.4052377,64.09957731,42.18436554,33.94718173,Benign
172.30.6.255,58287,23.58.57.98,443,16,2742,8,1838,8,904,5320.816051,3.176019,4629.695225,2277.064463,Benign
172.30.6.255,57691,13.67.76.139,443,24,9649,14,1578,10,8071,3662.042535,0.338552,37288.2157,190718.1172,Benign
172.30.6.255,58545,103.243.221.51,80,15,8347,11,6727,4,1620,5813.893605,1.547264,34781.39477,8376.075447,Benign
192.168.215.49,39054,192.229.179.87,443,50,15583,25,2731,25,12852,1298.949305,179.7537062,121.5440864,571.9826432,Benign
172.30.15.361,49629,195.154.150.142,80,12,2691,6,697,6,1994,1399.654361,2.304096,2420.038054,6923.322639,Benign
10.0.2.15,39588,119.254.87.201,80,11,1579,6,705,5,874,9770.737205,1.99828,2822.427287,3499.009148,Malicious
172.30.6.255,56565,103.231.98.53,80,44,17682,26,15990,18,1692,887.874181,82.870048,1543.621647,163.3400767,Benign
192.168.43.233,51081,185.167.164.39,443,96,49077,48,4962,48,44115,916.286696,186.080864,213.3266105,1896.594805,Benign
10.0.2.15,48616,119.254.87.201,80,11,1559,6,705,5,854,21633.1382,2.182389,2584.323876,3130.514313,Malicious
172.30.15.1261,50569,104.18.255.119,443,12,2051,7,1001,5,1050,3469.533995,7.413796,1080.148415,1133.022813,Benign
172.30.1.136,50601,157.240.16.35,443,48,9218,28,2923,20,6295,1604.491965,211.69812,110.4591765,237.8859104,Benign
192.168.43.224,37810,117.18.237.66,443,27,8498,14,3235,13,5263,106.2886368,181.0785391,142.9214093,232.5178909,Benign
172.30.6.255,56649,103.243.221.17,80,20,11418,9,4506,11,6912,1071.850084,19.218097,1875.732025,2877.288006,Benign
172.30.6.255,56464,103.243.221.75,80,26,16610,10,4279,16,12331,746.871979,15.629593,2190.204185,6311.616688,Benign
10.0.2.15,49603,119.254.87.201,80,11,1513,6,705,5,808,11604.99117,1.614589,3493.14903,4003.495626,Malicious
172.30.6.255,56303,52.5.131.6,80,6,348,4,228,2,120,569.288757,19.820172,92.02745566,48.43550298,Benign
10.0.2.15,54783,119.254.87.201,80,11,1579,6,705,5,874,16830.77492,2.09312,2694.542119,3340.467818,Malicious
192.168.43.233,51157,182.161.72.84,443,19,7353,8,2012,11,5341,949.155098,12.770016,1260.45261,3345.962918,Benign
172.30.6.255,58182,180.149.59.210,80,20,9565,13,7165,7,2400,5024.672315,89.281483,642.0144253,215.0501913,Benign
10.0.2.15,48958,119.254.87.201,80,11,1579,6,705,5,874,22747.50981,1.419505,3973.216015,4925.660706,Malicious
192.168.137.97,50280,104.244.42.8,443,13,914,8,552,5,362,31.35575379,21.47174301,205.6656508,134.8749376,Benign
10.0.2.15,48239,119.254.87.201,80,11,1579,6,705,5,874,11514.84893,1.623744,3473.453943,4306.097513,Malicious
172.30.6.255,57141,172.217.166.234,443,17,1793,10,1164,7,629,1870.510936,169.664373,54.88482841,29.65855419,Benign
10.0.2.15,59094,119.254.87.201,80,11,1587,6,705,5,882,13944.87811,1.63344,3452.835733,4319.717896,Malicious
192.168.137.97,43292,108.177.122.94,443,18,5950,10,1443,8,4507,342.2858559,13.42527796,859.8704652,2685.679963,Benign
172.30.15.2436,51770,14.139.45.128,80,137,128608,46,2871,91,125737,5418.721203,1.473848,15583.69655,682496.4311,Benign
172.30.6.255,56487,204.79.197.200,443,652,384059,323,298462,329,85597,814.683107,213.71325,11172.42848,3204.181304,Benign
192.168.43.224,54414,52.206.154.207,443,37,8006,20,2582,17,5424,36.39637273,15.25726847,1353.846532,2844.021529,Benign
172.30.6.255,55935,139.162.37.98,80,10,1717,5,803,5,914,152.441559,0.273384,23498.08328,26746.26167,Benign
172.30.6.255,57995,161.69.226.24,443,57,12707,34,7938,23,4769,4722.315421,453.132103,140.1445618,84.19619742,Benign
172.30.15.1483,50791,104.244.43.48,443,19,2634,10,1599,9,1035,3520.927009,6.191559,2066.038618,1337.304546,Benign
172.30.15.1323,50631,52.84.110.244,443,43,29794,19,2069,24,27725,3488.538973,8.472812,1953.542696,26177.84981,Benign
172.30.6.255,57191,157.240.16.39,443,18,1879,9,1071,9,808,2070.09081,61.024465,140.4027057,105.9247304,Benign
172.30.15.1742,51053,54.201.247.66,443,6,348,4,228,2,120,3632.842358,4.45544,409.3871761,215.4669348,Benign
10.0.2.15,41753,119.254.87.201,80,11,1579,6,705,5,874,25480.26187,0.817334,6900.483768,8554.642288,Malicious
192.168.43.233,51365,52.216.18.144,443,66,33692,30,3600,36,30092,3464.948712,14.457126,1992.097184,16651.71902,Benign
172.30.6.255,57069,103.243.221.17,80,35,24221,15,6051,20,18170,1679.88125,16.110789,3004.694556,9022.525216,Benign
172.30.1.136,50485,172.217.161.3,443,19,1938,11,1233,8,705,945.714787,9.422254,1046.883262,598.5828869,Benign
10.0.2.15,35126,119.254.87.201,80,11,1579,6,705,5,874,7215.462943,2.078669,2713.274696,3363.6909,Malicious
10.0.2.15,42435,119.254.87.201,80,11,1561,6,705,5,856,24606.91322,1.548901,3641.291471,4421.199289,Malicious
10.0.2.15,45055,119.254.87.201,80,11,1579,6,705,5,874,19981.42692,1.485717,3796.146911,4706.145248,Malicious
192.168.43.233,51373,131.253.33.254,443,35,9393,19,1883,16,7510,3210.644555,0.455337,33083.18893,131946.2288,Benign
172.30.15.535,49819,52.22.176.255,443,23,9108,12,2249,11,6859,2249.017075,7.249277,2481.902678,7569.306567,Benign
172.30.15.2399,51733,14.139.45.128,80,23,14691,9,849,14,13842,5343.451017,0.031962,212502.3465,3464614.229,Benign
10.0.2.15,38480,119.254.87.201,80,11,1579,6,705,5,874,5448.392143,0.826866,6820.935919,8456.025523,Malicious
192.168.43.224,49678,34.227.238.173,443,10,701,5,294,5,407,25.02743882,14.7850057,159.0800875,220.2231144,Benign
10.0.2.15,33108,119.254.87.201,80,11,1579,6,705,5,874,18663.02222,3.652031,1544.346146,1914.551109,Malicious
172.30.15.802,50094,52.84.108.93,443,14,3306,8,1483,6,1823,2685.64787,0.578338,20513.95551,25217.08759,Benign
172.30.1.136,50183,172.217.161.4,443,25,6680,13,1889,12,4791,356.874619,8.610089,1755.150266,4451.52193,Benign
192.168.137.97,35166,117.18.237.29,80,18,3532,10,1432,8,2100,143.5819448,181.2256656,63.21400427,92.70210123,Benign
192.168.137.97,50914,104.197.3.80,80,11,977,6,491,5,486,1242.317088,1.046014698,3755.205359,3716.964979,Benign
192.168.215.49,60554,54.82.135.50,443,28,6548,14,1990,14,4558,1275.478378,60.90130032,261.4065696,598.7392684,Benign
172.30.6.255,57425,103.243.221.109,80,34,18941,16,9314,18,9627,2792.84597,37.228064,2001.500803,2068.761889,Benign
172.30.15.2513,51847,14.139.45.128,80,10,1401,5,665,5,736,5476.326483,0.080881,65775.6457,72798.30863,Benign
192.168.43.233,51321,117.18.232.102,443,266,201421,96,7671,170,193750,2979.980036,183.759887,333.957541,8434.920294,Benign
192.168.137.97,34182,192.229.237.96,443,22,7329,13,1509,9,5820,144.4495903,0.695166921,17365.6134,66976.71968,Benign
172.30.6.255,56585,13.107.246.254,443,36,10878,18,1880,18,8998,899.701297,127.923793,117.5699973,562.7100191,Benign
172.30.15.1945,51257,172.217.166.206,443,42,21135,18,2919,24,18216,4027.435994,9.858654,2368.680349,14781.7339,Benign
192.168.43.224,42014,23.251.156.28,443,798,589937,380,35970,418,553967,1288.072346,470.5111168,611.5902254,9418.982553,Benign
192.168.43.224,50168,52.207.90.113,443,22,6135,12,1972,10,4163,368.8555035,36.74362577,429.3533823,906.3885042,Benign
172.30.1.136,50438,157.240.16.17,443,644,444359,281,37387,363,406972,855.256114,99.653636,3001.355615,32670.92031,Benign
172.30.6.255,56738,103.243.221.46,80,15,7537,10,6468,5,1069,1223.664015,18.982788,2725.837743,450.5133809,Benign
192.168.137.97,39688,192.168.125.6,80,33,19321,17,1690,16,17631,8274.175245,4.743970483,2849.933415,29732.05683,Benign
172.30.6.255,55959,52.212.169.136,443,31,8961,15,2015,16,6946,165.835247,60.77575,265.2373685,914.3120406,Benign
192.168.43.233,51272,151.101.193.181,443,788,415061,324,27899,464,387162,1989.879136,1067.462174,209.0865657,2901.551058,Benign
10.0.2.15,37477,119.254.87.201,80,11,1560,6,705,5,855,7490.460684,1.472394,3830.496457,4645.495703,Malicious
172.30.6.255,57785,103.243.221.51,80,22,10399,10,4259,12,6140,3994.842657,47.216894,721.6061268,1040.305616,Benign
192.168.137.97,45524,74.125.68.188,5228,99,9825,50,3357,49,6468,7.386132425,1954.32721,13.74181348,26.47663079,Benign
192.168.137.97,50660,192.168.121.7,443,17,2932,9,1758,8,1174,3026.536234,11.00153958,1278.366532,853.6986965,Benign
192.168.43.233,51062,49.44.170.52,443,310,227067,136,10861,174,216206,895.933879,169.199955,513.5225952,10222.50863,Benign
172.30.6.255,58422,35.190.41.40,443,6,348,4,228,2,120,5572.173449,6.880096,265.1125798,139.5329367,Benign
10.0.2.15,46885,119.254.87.201,80,11,1579,6,705,5,874,24757.27015,1.29744,4347.021828,5389.073869,Malicious
192.168.43.233,51149,182.161.72.94,443,19,6329,9,2391,10,3938,925.908001,17.998833,1062.735567,1750.335702,Benign
172.30.15.1778,51090,161.202.1.35,443,16,4702,9,3665,7,1037,3641.845718,5.772686,5079.091432,1437.112637,Benign
192.168.43.224,38684,52.76.199.39,443,23,7612,13,2684,10,4928,54.29144998,108.280273,198.3002019,364.092174,Benign
192.168.43.233,51173,172.217.161.1,443,2928,2681928,1082,63644,1846,2618284,540.846124,91.191326,5583.338047,229695.8814,Benign
172.30.15.538,49822,104.16.241.231,443,148,84377,64,6500,84,77877,2249.174309,6.920124,7514.316217,90029.60063,Benign
172.30.6.255,56044,13.250.67.150,80,13,1509,7,869,6,640,254.482535,69.434008,100.1238471,73.73908186,Benign
10.0.2.15,57644,119.254.87.201,80,11,1579,6,705,5,874,14608.24336,29.687233,189.980656,235.5221182,Malicious
172.30.15.1195,50503,72.21.206.140,80,9,1765,6,871,3,894,3465.369549,2.283769,3051.096674,3131.665243,Benign
172.30.15.709,49996,107.178.254.65,443,33,9301,18,2462,15,6839,2404.275319,1.934436,10181.77908,28283.17918,Benign
172.30.6.255,57736,103.243.221.87,80,17,6593,9,5331,8,1262,3782.846661,17.218514,2476.868794,586.3456045,Benign
172.30.15.2187,51499,77.88.21.119,443,31,12757,17,8875,14,3882,4277.669911,10.171882,6980.025919,3053.122323,Benign
172.30.6.255,56143,103.243.221.87,80,34,29055,9,3923,25,25132,368.850351,25.174605,1246.653125,7986.460959,Benign
172.30.1.136,50336,172.217.161.3,443,28,3090,13,2072,15,1018,596.09712,19.385698,855.0633565,420.1035217,Benign
10.0.2.15,58810,119.254.87.201,80,11,1582,6,705,5,877,26081.08761,0.818485,6890.779917,8571.934733,Malicious
10.0.2.15,44959,119.254.87.201,80,11,1582,6,705,5,877,26195.90245,1.293231,4361.169814,5425.171528,Malicious
10.0.2.15,37097,119.254.87.201,80,11,1551,6,705,5,846,23132.36992,2.122257,2657.548073,3189.057687,Malicious
10.0.2.15,52491,209.141.55.182,80,11,1345,6,530,5,815,24.059667,9.465076,447.9625943,688.8481403,Malicious
172.30.6.255,57236,52.84.108.179,443,24,8202,12,1898,12,6304,2199.178143,138.603966,109.5495348,363.8568322,Benign
192.168.137.97,39660,192.168.125.7,8380,193,145665,95,8078,98,137587,8302.616093,103.7699399,622.7622379,10607.07948,Benign
192.168.42.240,50991,216.58.221.46,443,26,1572,14,840,12,732,327.17239,39.436208,170.401779,148.4929788,Benign
172.30.15.1540,50848,23.11.214.58,443,146,104998,64,5033,82,99965,3532.170519,4.823684,8347.147118,165790.2964,Benign
172.30.15.667,49954,52.84.110.109,80,6,348,4,228,2,120,2397.044261,9.132516,199.7259025,105.118896,Benign
192.168.137.97,44290,172.217.161.10,443,30,3796,14,2704,16,1092,7293.859657,33.8539085,638.9808728,258.0499679,Benign
172.30.6.255,55701,173.241.248.220,80,6,535,4,228,2,307,53.405173,5.328422,342.3152295,460.9244538,Benign
10.0.2.15,44006,119.254.87.201,80,11,1513,6,705,5,808,218.445217,1.669368,3378.524088,3872.124061,Malicious
172.30.15.780,50072,34.200.202.18,443,12,1416,6,904,6,512,2661.121034,5.333332,1356.000339,768.000192,Benign
192.168.137.97,39440,35.171.73.174,443,26,1780,15,998,11,782,3714.184898,81.90590006,97.4777152,76.38033396,Benign
172.30.6.255,57528,104.25.219.21,443,16,6376,8,1037,8,5339,3133.674722,0.261035,31781.17877,163625.5675,Benign
172.30.15.1062,50368,180.149.59.138,80,17,8304,9,1441,8,6863,3451.969848,5.134655,2245.136236,10692.83136,Benign
192.168.215.49,48648,104.237.191.1,443,49,8959,24,2936,25,6023,173.5986034,241.8930098,97.1007803,199.195504,Benign
172.30.6.255,58205,161.69.226.24,443,61,14594,39,9370,22,5224,5155.096744,701.847706,106.8037971,59.54568155,Benign
10.0.2.15,56225,119.254.87.201,80,11,1582,6,705,5,877,1271.892211,1.38354,4076.499415,5071.049626,Malicious
172.30.1.136,50144,172.217.161.14,443,9,534,5,294,4,240,117.544081,14.640713,160.6479138,131.1411541,Benign
172.30.15.1579,50888,52.84.110.128,443,8,480,5,294,3,186,3562.003645,4.979305,472.3550777,298.8368859,Benign
10.0.2.15,37725,119.254.87.201,80,11,1552,6,705,5,847,14933.56665,0.949739,5938.473623,7134.591714,Malicious
172.30.13.95,50855,172.30.6.255,445,2,132,2,132,0,0,3506.737162,5.906892,178.7742183,0,Benign
172.30.6.255,56238,103.243.221.17,80,16,4442,9,3214,7,1228,500.863073,21.582922,1191.312279,455.1746978,Benign
10.0.2.15,32913,119.254.87.201,80,11,1587,6,705,5,882,7848.707183,2.080063,2711.456336,3392.204948,Malicious
192.168.137.97,48492,185.199.110.153,80,31,2943,16,1523,15,1420,0.128042665,403.8668425,30.16835927,28.12808284,Benign
192.168.137.97,43326,169.60.79.77,443,34,8345,19,3393,15,4952,4040.934067,8.636980472,3142.765008,4586.788187,Benign
192.168.43.233,51384,173.241.248.143,443,11,632,6,338,5,294,3478.161879,148.022106,18.26754174,15.88951856,Benign
172.30.6.255,56008,204.11.109.67,443,29,9485,14,2682,15,6803,227.942517,183.918495,116.6603718,295.9136872,Benign
192.168.43.224,41942,34.232.42.95,443,9,610,5,338,4,272,216.3181752,84.25611676,32.09262548,25.82601814,Benign
172.30.15.2246,51563,104.121.244.70,443,188,154148,78,9073,110,145075,4468.150884,9.580842,7575.952093,121137.5785,Benign
172.30.1.136,50122,52.230.84.0,443,100,24668,52,13792,48,10876,101.697218,1067.571918,103.3522877,81.50083243,Benign
172.30.15.767,50058,209.197.3.15,443,117,97619,41,3900,76,93719,2618.657888,7.718869,4042.042947,97132.36486,Benign
10.0.2.15,50806,119.254.87.201,80,11,1582,6,705,5,877,12713.63321,2.26107,2494.394247,3102.95568,Malicious
192.168.137.97,57492,104.197.3.80,80,10,911,5,425,5,486,6923.810773,1.514806961,2244.510415,2566.663674,Benign
192.168.137.97,35264,172.217.161.16,443,20,6711,10,1912,10,4799,2193.809073,1.188440825,12870.64503,32304.51125,Benign
192.168.42.240,50989,216.58.221.46,443,37,5758,19,4050,18,1708,323.428167,50.435994,642.3983634,270.9176308,Benign
172.30.6.255,57959,103.243.221.17,80,37,19828,18,9445,19,10383,4629.86493,17.166177,4401.678953,4838.817635,Benign
192.168.42.240,50970,172.217.163.101,443,19,2730,9,1330,10,1400,283.711263,12.860452,827.342616,870.8869642,Benign
172.30.6.255,55953,54.86.11.75,443,136,17387,66,6765,70,10622,161.231571,147.992625,365.6938986,574.1907747,Benign
10.0.2.15,48685,119.254.87.201,80,11,1579,6,705,5,874,3582.12014,1.876814,3005.092673,3725.462406,Malicious
192.168.137.97,55944,172.217.161.5,443,12,840,7,486,5,354,68.27845479,15.97268593,243.4155419,177.3026787,Benign
10.0.2.15,55934,119.254.87.201,80,11,1513,6,705,5,808,883.497615,1.584279,3559.979019,4080.089429,Malicious
10.0.2.15,34241,119.254.87.201,80,11,1579,6,705,5,874,20579.45802,1.502427,3753.926147,4653.803479,Malicious
172.30.1.136,50476,157.240.16.16,443,1,66,1,66,0,0,902.27894,0,0,0,Benign
172.30.15.1196,50504,34.228.252.44,80,6,348,4,228,2,120,3465.37584,2.265482,805.1266794,423.7508839,Benign
10.0.2.15,49394,119.254.87.201,80,11,1513,6,705,5,808,23708.43624,0.879197,6414.944546,7352.163395,Malicious
192.168.43.224,43134,117.18.232.205,443,28,7560,15,2097,13,5463,926.3348796,186.5505173,89.92738398,234.2743437,Benign
192.168.137.97,60278,198.252.206.25,443,103,9238,52,4869,51,4369,179.7780941,549.4712983,70.88996298,63.61023789,Benign
192.168.43.224,33936,52.84.108.93,443,239,177899,112,9604,127,168295,2848.410526,158.0045342,486.2645264,8521.021291,Benign
172.30.15.663,49950,172.217.166.193,443,22,8097,12,1483,10,6614,2397.030959,9.072451,1307.695131,5832.161563,Benign
172.30.15.2025,51337,205.185.216.10,443,23,7323,11,1753,12,5570,4090.439781,7.153015,1960.571871,6229.54097,Benign
192.168.43.224,34236,172.217.166.206,443,11,754,6,412,5,342,1171.368813,31.33428232,105.1883035,87.3165044,Benign
172.30.6.255,57678,103.243.220.231,80,22,10723,11,4606,11,6117,3617.864903,24.164219,1524.899274,2025.143043,Benign
172.30.6.255,56906,173.241.248.143,80,14,2595,8,1929,6,666,1385.419825,67.60245,228.2757504,78.81371163,Benign
172.30.15.2026,51338,52.207.90.113,443,16,4806,9,1153,7,3653,4090.472253,6.801785,1356.114608,4296.519223,Benign
192.168.43.224,58376,162.213.83.13,443,28,8145,15,5062,13,3083,655.0840861,72.47106484,558.7885329,340.3289307,Benign
172.30.15.282,49545,184.29.26.80,80,16,4639,9,942,7,3697,328.939431,95.570648,78.85266196,309.4674005,Benign
172.30.15.2074,51386,35.171.73.174,443,43,10404,24,4647,19,5757,4122.447102,5.152478,7215.16909,8938.611674,Benign
172.30.15.434,49708,59.63.81.183,443,47,19703,23,2689,24,17014,1623.387474,7.481274,2875.44608,18193.69268,Benign
192.168.215.49,54442,157.240.16.20,443,114,87182,44,3949,70,83233,512.9676252,65.25165359,484.1563127,10204.55365,Benign
172.30.6.255,55613,157.240.16.39,443,711,447167,308,113780,403,333387,2.586415,56.01656,16249.48051,47612.63455,Benign
10.0.2.15,39193,119.254.87.201,80,11,1585,6,705,5,880,10759.11211,1.020085,5528.951019,6901.385669,Malicious
192.168.215.49,60510,159.153.113.136,80,6,356,4,236,2,120,1496.210959,21.87081203,86.32509836,43.89411781,Benign
172.30.15.1492,50800,52.84.108.64,443,16,3204,9,2254,7,950,3520.966723,6.013167,2998.752571,1263.893053,Benign
10.0.2.15,53374,119.254.87.201,80,11,1582,6,705,5,877,14638.41216,1.287443,4380.776469,5449.56165,Malicious
172.30.15.1903,51215,184.29.26.86,443,15,2697,8,1797,7,900,3984.828643,2.397571,5996.068521,3003.039326,Benign
172.30.15.2388,51722,14.139.45.128,80,66,51525,28,2009,38,49516,5336.313252,1.086558,14791.66322,364571.4265,Benign
10.0.2.15,56309,119.254.87.201,80,11,1513,6,705,5,808,6497.306697,2.054456,2745.252271,3146.331681,Malicious
172.30.6.255,57777,172.217.166.206,443,34,6083,19,3731,15,2352,3978.419007,82.051719,363.7705628,229.3187788,Benign
172.30.6.255,56979,103.243.221.51,80,26,13150,15,10940,11,2210,1436.864287,16.192554,5404.953413,1091.859876,Benign
172.30.1.136,50578,172.217.161.4,443,37,4633,19,2791,18,1842,1586.161444,209.717124,106.4672239,70.26607899,Benign
172.30.6.255,56853,103.243.220.231,80,23,13621,10,5285,13,8336,1352.88302,23.176181,1824.286754,2877.436969,Benign
192.168.137.97,60872,52.84.110.140,443,8,552,5,338,3,214,10.25685463,11.87199759,227.7628495,144.204881,Benign
172.30.15.279,49542,172.25.10.224,7680,3,198,3,198,0,0,287.835532,9.005062,175.9010654,0,Benign
172.30.15.2231,51548,104.121.244.70,443,240,182356,107,21084,133,161272,4457.924394,10.20062,16535.46549,126480.1551,Benign
172.30.15.976,50282,173.241.248.220,80,14,3928,8,2984,6,944,3442.538524,4.687395,5092.807412,1611.129423,Benign
10.0.2.15,52609,119.254.87.201,80,11,1582,6,705,5,877,12170.57054,1.423299,3962.62486,4929.39291,Malicious
172.30.6.255,57109,103.243.221.87,80,46,27632,22,12717,24,14915,1800.857652,41.174185,2470.868579,2897.932285,Benign
172.30.6.255,56040,172.217.166.194,80,20,4188,11,1898,9,2290,254.211903,157.430157,96.44911934,116.3690639,Benign
10.0.2.15,50549,119.254.87.201,80,11,1513,6,705,5,808,6554.926065,1.942348,2903.702117,3327.930937,Malicious
172.30.6.255,56602,103.243.221.109,80,18,9168,10,4584,8,4584,951.842213,2.32535,15770.52917,15770.52917,Benign
172.30.1.136,50164,172.217.161.3,443,14,1535,7,977,7,558,165.695971,18.569379,420.9079905,240.3957612,Benign
192.168.215.49,43616,34.227.208.227,443,24,5596,13,1509,11,4087,552.7652981,81.51594333,148.0937288,401.0994496,Benign
10.0.2.15,42031,119.254.87.201,80,11,1544,6,705,5,839,20915.29589,4.276288,1318.900879,1569.585585,Malicious
192.168.137.97,37712,172.217.161.3,443,52,14306,26,6075,26,8231,328.6256932,240.7428592,201.8751466,273.5200546,Benign
10.0.2.15,47984,119.254.87.201,80,11,1582,6,705,5,877,2593.38706,0.889196,6342.80856,7890.27391,Malicious
192.168.43.224,60692,54.165.86.233,443,9,626,6,412,3,214,54.18613232,17.12115735,192.5103504,99.99324025,Benign
10.0.2.15,59796,119.254.87.201,80,11,1560,6,705,5,855,3672.183177,3.183974,1771.371249,2148.258748,Malicious
192.168.43.233,51346,139.59.46.160,443,889,820808,314,30035,575,790773,3083.951522,188.134801,1277.169342,33625.8043,Benign
192.168.215.49,43448,54.85.227.48,443,31,7060,15,2159,16,4901,552.8186,60.89072467,283.6556814,643.9075936,Benign
10.0.2.15,51978,119.254.87.201,80,11,1579,6,705,5,874,14755.63643,1.707805,3302.484768,4094.144238,Malicious
192.168.137.97,36332,52.84.103.186,443,21,2297,16,1821,5,476,3757.63094,90.1791921,161.5450267,42.2270361,Benign
192.168.43.233,50847,23.9.184.115,80,4,216,2,108,2,108,49.112081,1.489393,580.1020953,580.1020953,Benign
172.30.15.1696,51007,184.29.25.7,443,91,68738,42,14985,49,53753,3609.561611,7.56678,15842.93451,56830.51443,Benign
172.30.6.255,56233,157.240.16.39,443,26,5276,14,3220,12,2056,484.088275,61.061602,421.8690496,269.3673186,Benign
172.30.6.255,56317,152.163.13.4,80,7,414,5,294,2,120,591.077486,15.063698,156.1369592,63.7293711,Benign
172.30.1.136,50662,172.217.161.3,443,26,3999,13,2020,13,1979,1790.571536,4.867943,3319.677326,3252.297736,Benign
172.30.15.397,49669,195.154.150.142,80,6,348,4,228,2,120,1480.002641,0.609327,2993.466562,1575.508717,Benign
172.30.15.439,49713,54.222.61.197,443,24,10987,11,2369,13,8618,1623.934547,6.958418,2723.607579,9907.999203,Benign
192.168.43.224,51976,157.240.16.20,443,9,626,6,412,3,214,2461.563297,15.19208375,216.9550968,112.6902687,Benign
192.168.137.97,33844,172.217.161.5,443,46,8583,23,4712,23,3871,9564.23503,241.5494928,156.0591147,128.2056097,Benign
172.30.15.1546,50855,180.179.41.214,443,17,4022,9,2863,8,1159,3543.93225,0.243926,93897.32952,38011.52809,Benign
192.168.43.233,51449,216.58.196.194,80,9,534,5,294,4,240,3808.823045,20.347239,115.5930787,94.36169694,Benign
172.30.1.136,51880,13.107.4.52,80,10,1519,5,436,5,1083,4411.548269,0.224403,15543.46421,38609.1095,Benign
10.0.2.15,48271,119.254.87.201,80,11,1579,6,705,5,874,17996.78346,1.076387,5239.75113,6495.804947,Malicious
10.0.2.15,56207,119.254.87.201,80,11,1579,6,705,5,874,14573.26649,0.889749,6338.866354,7858.39602,Malicious
10.0.2.15,33602,119.254.87.201,80,11,1579,6,705,5,874,21720.73312,1.825571,3089.444344,3830.034548,Malicious
172.30.6.255,56572,103.243.221.87,80,58,40042,34,35516,24,4526,888.103332,59.617576,4765.842878,607.3376751,Benign
10.0.2.15,41737,119.254.87.201,80,12,1653,7,779,5,874,23678.41676,3.846038,1620.368806,1817.974757,Malicious
10.0.2.15,41187,119.254.87.201,80,11,1534,6,705,5,829,13404.27831,2.10188,2683.312083,3155.27052,Malicious
192.168.215.49,49920,172.217.161.14,443,24,5599,12,1422,12,4177,1313.632694,156.6923732,72.60085328,213.2586246,Benign
172.30.15.697,49984,54.248.216.124,443,13,1470,7,958,6,512,2402.411125,4.769801,1606.775629,858.7360353,Benign
172.30.15.1284,50592,54.231.114.138,443,7,409,4,228,3,181,3469.807933,7.816446,233.3541356,185.2504322,Benign
192.168.43.224,54028,151.101.194.217,443,19,8473,11,1344,8,7129,46.43999708,19.50841172,551.1468671,2923.456857,Benign
192.168.43.233,51050,162.212.45.11,443,35,11430,19,2037,16,9393,888.508035,113.80067,143.1977509,660.3124569,Benign
172.30.15.1211,50519,172.217.166.198,443,28,7758,16,2829,12,4929,3466.647561,10.860831,2083.818448,3630.661411,Benign
10.0.2.15,54035,119.254.87.201,80,11,1582,6,705,5,877,18927.76783,1.920452,2936.808626,3653.306617,Malicious
172.30.15.1312,50620,23.58.57.98,443,7,402,4,228,3,174,3487.367813,9.665147,188.7193232,144.0226414,Benign
172.30.6.255,57234,157.240.16.39,443,20,2025,11,1217,9,808,2192.098706,61.05479,159.4633279,105.8721191,Benign
172.30.6.255,57906,52.229.174.29,443,30,10163,17,2314,13,7849,4423.800169,82.617955,224.0675166,760.028495,Benign
192.168.43.224,49236,172.217.166.206,443,22,7158,12,1599,10,5559,1153.554052,21.03774976,608.0498222,2113.914297,Benign
10.0.2.15,38960,119.254.87.201,80,11,1582,6,705,5,877,4665.445347,3.677591,1533.612628,1907.770603,Malicious
10.0.2.15,33422,119.254.87.201,80,11,1579,6,705,5,874,25207.66201,2.054961,2744.577634,3402.497663,Malicious
172.30.6.255,56110,157.240.16.20,443,2240,2157761,736,54045,1504,2103716,312.910159,65.503422,6600.571188,256928.9891,Benign
172.30.6.255,56686,35.190.43.164,80,23,6319,13,4851,10,1468,1155.903106,86.579985,448.2329259,135.6433591,Benign
10.0.2.15,56851,119.254.87.201,80,11,1587,6,705,5,882,1181.731215,1.818478,3101.494767,3880.167921,Malicious
10.0.2.15,47594,119.254.87.201,80,11,1582,6,705,5,877,12620.90197,2.091121,2697.117957,3355.138225,Malicious
192.168.43.224,58290,172.217.166.206,443,26,7895,13,2193,13,5702,353.6308321,10.44708465,1679.320172,4366.385601,Benign
172.30.1.136,50404,157.240.16.16,443,10,564,7,390,3,174,783.676742,31.660988,98.54398732,43.96577896,Benign
192.168.43.224,57450,151.101.193.69,443,60,9841,32,3289,28,6552,59.27590133,602.0338875,43.70518096,87.06486642,Benign
172.30.1.136,50434,52.84.103.186,443,153,81191,78,6647,75,74544,853.820486,173.141086,307.1252539,3444.312461,Benign
172.30.15.2017,51329,52.84.108.91,443,20,3049,10,1594,10,1455,4089.47653,8.084198,1577.398277,1439.845981,Benign
172.30.15.1012,50318,35.203.66.107,443,6,348,4,228,2,120,3444.210841,3.05352,597.3433939,314.3912599,Benign
172.30.6.255,55748,103.231.98.48,80,22,9113,11,7030,11,2083,58.285182,0.463235,121407.0612,35973.10221,Benign
172.30.6.255,56917,54.148.146.218,80,6,348,4,228,2,120,1386.023476,18.635935,97.87542187,51.51337993,Benign
192.168.137.97,44128,172.217.161.10,443,7,466,4,272,3,194,5227.734374,55.51741449,39.19490884,27.95519234,Benign
192.168.137.97,33098,172.217.161.5,443,1569,1051149,708,77591,861,973558,14.70828699,305.0888543,2034.581045,25528.51043,Benign
192.168.42.240,51009,172.217.163.67,443,32,5902,17,4242,15,1660,389.182332,28.111524,1207.191755,472.4041286,Benign
172.30.15.584,49869,172.217.166.197,443,35,6891,17,3864,18,3027,2299.689099,6.515036,4744.716683,3716.940321,Benign
192.168.137.97,44550,172.217.161.10,443,37,4396,19,2738,18,1658,11107.23984,289.5969649,75.6361518,45.80158498,Benign
192.168.215.49,38434,158.85.224.176,443,7,478,4,272,3,206,1541.317621,41.64590578,52.25003417,39.57171706,Benign
172.30.15.1917,51229,13.56.57.63,443,6,348,4,228,2,120,3985.318953,2.216936,822.7571748,433.030092,Benign
192.168.43.233,51364,117.18.237.29,80,23,5080,11,2032,12,3048,3158.012841,63.756646,254.9694976,382.4542464,Benign
172.30.15.1749,51061,184.29.25.7,443,102,81733,42,17670,60,64063,3637.516113,9.654971,14641.16257,53081.87875,Benign
172.30.15.1152,50460,180.149.59.136,80,112,95311,44,3630,68,91681,3459.393197,7.639055,3801.517334,96012.92306,Benign
192.168.43.224,49238,172.217.166.206,443,7,478,4,272,3,206,1153.804646,20.36681548,106.8404632,80.91593904,Benign
172.30.1.136,51798,107.22.42.44,443,7,402,4,228,3,174,2977.402461,37.01627,49.27562934,37.60508555,Benign
10.0.2.15,42126,119.254.87.201,80,11,1579,6,705,5,874,21122.58195,3.640279,1549.331796,1920.7319,Malicious
192.168.215.49,54644,13.127.131.111,443,21,7377,12,1419,9,5958,281.4406961,11.42467162,993.6390628,4172.023634,Benign
10.0.2.15,46362,119.254.87.201,80,12,1653,7,779,5,874,13794.67961,12.862821,484.497141,543.5821582,Malicious
172.30.6.255,55829,103.231.98.48,80,20,5266,14,4121,6,1145,91.304285,79.449468,414.9555791,115.2934089,Benign
192.168.43.233,50892,54.239.25.120,443,22,7134,12,1454,10,5680,129.977881,15.212004,764.6592783,2987.11465,Benign
172.30.6.255,57808,52.213.19.114,443,35,12438,19,6403,16,6035,4042.78192,131.006841,391.0024821,368.5303732,Benign
192.168.43.233,51082,13.107.21.200,443,58,20689,26,3587,32,17102,916.293738,153.093155,187.4414307,893.6781008,Benign
172.30.15.1706,51017,157.240.16.20,443,66,27749,34,4597,32,23152,3613.741923,3.386391,10859.93909,54694.21576,Benign
172.30.15.892,50198,210.176.156.62,80,16,6669,9,5083,7,1586,3438.483759,8.686254,4681.419632,1460.698709,Benign
172.30.15.818,50116,184.29.26.80,80,14,2545,8,686,6,1859,3093.433272,60.196761,91.16769588,247.056482,Benign
172.30.15.1488,50796,151.101.66.2,443,61,28552,25,3719,36,24833,3520.953702,4.000116,7437.784304,49664.55973,Benign
172.30.15.1747,51059,184.29.25.7,443,95,76937,38,18935,57,58002,3637.247944,9.923217,15265.21087,46760.64224,Benign
172.30.15.512,49795,172.25.10.63,7680,3,198,3,198,0,0,2042.802299,9.006573,175.8715551,0,Benign
192.168.43.224,42020,23.251.156.28,443,699,513896,338,34467,361,479429,1288.186077,470.3974984,586.1765867,8153.597783,Benign
192.168.137.97,50652,192.168.121.7,443,227,203803,81,7818,146,195985,2957.17845,38.36064891,1630.420803,40872.09274,Benign
192.168.43.224,41110,172.217.166.195,443,48,12572,23,5853,25,6719,231.7415068,240.6344535,194.585602,223.3761593,Benign
10.0.2.15,40281,119.254.87.201,80,13,1727,8,853,5,874,5145.915891,10.785335,632.7109914,648.2876981,Malicious
192.168.137.97,57492,72.247.219.151,443,48,17802,23,7735,25,10067,348.561098,28.54361733,2167.910229,2821.506436,Benign
172.30.1.136,50357,52.84.103.186,443,13,786,7,414,6,372,640.547934,14.375888,230.3857682,207.0132989,Benign
192.168.215.49,38272,158.85.224.176,443,29,8196,15,3310,14,4886,649.7883239,1.280342337,20681.96859,30529.33491,Benign
172.30.6.255,56816,157.240.16.39,443,17,1825,9,1071,8,754,1277.146193,61.013898,140.4270221,98.86272141,Benign
172.30.6.255,57448,157.240.16.39,443,28,5421,15,3274,13,2147,2863.086107,61.033026,429.144706,281.4214062,Benign
10.0.2.15,36168,119.254.87.201,80,11,1582,6,705,5,877,14875.7825,2.28859,2464.399477,3065.643038,Malicious
172.30.1.136,50540,172.217.161.14,443,17,5681,8,1219,9,4462,1325.188735,14.767077,660.3879698,2417.269172,Benign
10.0.2.15,60080,119.254.87.201,80,11,1579,6,705,5,874,12470.79055,1.490134,3784.894513,4692.195467,Malicious
172.30.6.255,56339,52.109.120.4,443,19,9069,9,2170,10,6899,604.034702,106.880055,162.4250661,516.3919498,Benign
192.168.43.224,53968,14.139.116.17,443,21,4066,11,1855,10,2211,1573.215628,62.06292954,239.1121417,285.0010486,Benign
172.30.6.255,57690,13.67.76.139,443,21,8738,13,1085,8,7653,3662.042487,109.962545,78.93596861,556.7713988,Benign
192.168.43.233,50946,54.83.70.244,443,5,294,3,174,2,120,455.441388,18.30643,76.03885629,52.44059055,Benign
192.168.43.233,51504,13.107.42.254,443,7,414,3,174,4,240,3897.284545,0.668394,2082.603973,2872.557204,Benign
172.30.15.238,49507,23.198.126.238,443,18,6770,9,1412,9,5358,52.607194,0.710581,15896.85061,60322.46852,Benign
172.30.1.136,51539,172.217.161.3,443,2,132,2,132,0,0,695.565312,9.000868,117.3220183,0,Benign
172.30.6.255,57206,172.217.166.210,443,45,7753,22,2584,23,5169,2099.923241,240.368989,86.00111057,172.0355033,Benign
172.30.6.255,56130,103.243.221.87,80,29,22264,9,3202,20,19062,345.852267,23.173812,1105.385683,6580.531507,Benign
172.30.1.136,51778,172.217.160.243,443,9,534,5,294,4,240,2974.171748,40.246983,58.43916301,47.70543919,Benign
192.168.43.233,51323,172.217.194.189,443,18,5381,9,1274,9,4107,3025.830512,48.722302,209.1855184,674.3523736,Benign
192.168.43.224,60188,151.101.153.2,443,392,257918,193,15371,199,242547,926.9110245,605.0852645,203.2242515,3206.781116,Benign
172.30.6.255,56891,122.15.34.17,80,8,480,5,294,3,186,1384.573916,19.794709,118.81963,75.17160267,Benign
192.168.215.28,62297,157.240.16.32,443,2,155,0,0,2,155,590.9667164,6.00E-06,0,0,Benign
172.30.15.2520,51854,23.61.93.124,443,13,5033,7,1033,6,4000,5488.073311,0.246302,33552.30571,129921.8033,Benign
172.30.1.136,51846,172.217.160.227,443,21,2515,12,1671,9,844,3682.802771,148.737676,89.87635386,45.39535766,Benign
172.30.15.2363,51697,14.139.45.128,80,17,8733,7,769,10,7964,5332.881449,0.438803,14019.95884,145194.9964,Benign
172.30.6.255,56152,172.217.166.195,443,34,7898,17,2357,17,5541,395.1762,16.474902,1144.528811,2690.63816,Benign
172.30.15.1785,51097,54.171.197.251,443,15,3073,8,1937,7,1136,3642.337109,4.852273,3193.554856,1872.936663,Benign
172.30.6.255,55691,205.185.216.10,443,65,53142,22,2393,43,50749,45.749007,11.752603,1628.915739,34544.85785,Benign
192.168.43.233,50846,125.56.228.72,443,5,301,3,162,2,139,49.112232,0.370781,3495.324733,2999.074926,Benign
192.168.43.233,51390,162.247.242.20,443,36,6788,17,2505,19,4283,3479.128483,316.486889,63.32015858,108.2635685,Benign
192.168.43.224,53050,117.18.237.29,80,18,2384,9,1006,9,1378,149.7454433,181.2302521,44.40759701,60.82869651,Benign
172.30.15.567,49851,52.11.15.218,443,38,13264,18,3453,20,9811,2254.62621,1.713302,16123.25206,45810.95452,Benign
192.168.215.49,55946,104.197.3.80,80,10,911,5,425,5,486,862.780827,0.774851577,4387.937124,5017.735158,Benign
10.0.2.15,58482,119.254.87.201,80,11,1552,6,705,5,847,4004.838058,1.756258,3211.373272,3858.203066,Malicious
192.168.137.97,43294,108.177.122.94,443,9,618,5,338,4,280,342.5374973,13.48984605,200.4470614,166.0508201,Benign
172.30.6.255,58033,35.230.55.83,80,6,348,4,228,2,120,4808.184668,10.642961,171.3808779,90.20046207,Benign
172.30.15.2243,51560,184.29.25.145,443,126,91288,58,8437,68,82851,4468.145411,9.441622,7148.771684,70200.64985,Benign
192.168.137.97,50116,169.237.6.105,80,12,3563,7,925,5,2638,1954.31306,1.448534354,5108.612012,14569.20917,Benign
192.168.137.97,54408,122.15.34.26,80,18,3975,10,1442,8,2533,84.2352651,94.52731465,122.0387995,214.3718996,Benign
10.0.2.15,54901,119.254.87.201,80,11,1513,6,705,5,808,23225.30593,0.851344,6624.81911,7592.700483,Malicious
172.30.6.255,55687,205.185.216.10,443,36,14368,16,2669,20,11699,43.883986,13.616884,1568.053308,6873.231791,Benign
192.168.137.97,46444,151.101.193.69,443,62,11465,32,4406,30,7059,8.23199771,602.7585449,58.47781055,93.68925663,Benign
10.0.2.15,37231,119.254.87.201,80,11,1582,6,705,5,877,252.767173,1.744197,3233.579693,4022.481405,Malicious
172.30.15.1548,50857,180.179.41.214,443,17,4014,9,2855,8,1159,3547.263253,0.206578,110563.5644,44883.77272,Benign
192.168.137.97,51456,157.240.16.17,443,12,840,8,552,4,288,212.31864,14.10385206,313.1059501,163.3596261,Benign
10.0.2.15,55593,119.254.87.201,80,11,1579,6,705,5,874,21452.97032,1.586107,3555.876117,4408.277626,Malicious
172.30.6.255,57680,103.243.220.231,80,16,5481,9,4245,7,1236,3617.87133,24.157405,1405.780132,409.3154873,Benign
10.0.2.15,53213,119.254.87.201,80,11,1513,6,705,5,808,8446.696405,4.418272,1276.517154,1463.015405,Malicious
192.168.215.49,34564,192.155.228.10,80,13,3112,7,804,6,2308,1298.94936,10.14896798,633.7590197,1819.29828,Benign
10.0.2.15,43117,119.254.87.201,80,13,1730,8,853,5,877,16915.85214,10.411106,655.453897,673.8957417,Malicious
172.30.6.255,55700,210.176.156.41,80,12,4187,7,2728,5,1459,53.272646,5.443243,4009.374559,2144.309927,Benign
172.30.6.255,57791,103.243.221.46,80,25,14008,11,5318,14,8690,4041.849369,23.217245,1832.431023,2994.325985,Benign
192.168.215.49,54176,204.79.197.200,443,40,10993,19,2451,21,8542,478.7607564,121.1958537,161.787713,563.8476722,Benign
192.168.215.49,51286,18.211.245.141,443,48,9975,26,3903,22,6072,1531.817073,118.900342,262.6064776,408.5438207,Benign
172.30.15.219,49468,111.221.29.40,443,3,162,2,108,1,54,20.56142,0.115104,7506.255213,3753.127606,Benign
10.0.2.15,46090,119.254.87.201,80,11,1534,6,705,5,829,24066.30187,2.153803,2618.623895,3079.204551,Malicious
172.30.1.136,50761,172.217.161.3,443,68,14908,32,11182,36,3726,1907.883688,47.306297,1890.995611,630.1063894,Benign
172.30.1.136,50477,157.240.16.39,443,95,59888,54,56623,41,3265,912.873018,54.986216,8238.137354,475.0281416,Benign
192.168.42.240,51014,172.217.166.206,443,32,11396,16,2485,16,8911,417.295889,37.722152,527.0112903,1889.817951,Benign
172.30.6.255,56556,13.107.4.52,80,10,1519,5,436,5,1083,855.949446,0.531355,6564.349634,16305.48315,Benign
172.30.6.255,58156,35.190.43.164,80,10,1629,6,1175,4,454,4957.880473,1.073611,8755.498966,3382.975771,Benign
10.0.2.15,56945,119.254.87.201,80,11,1593,6,705,5,888,5716.518258,1.519931,3710.694762,4673.896381,Malicious
10.0.2.15,58726,119.254.87.201,80,11,1579,6,705,5,874,13737.17032,1.550444,3637.667662,4509.675938,Malicious
172.30.6.255,56198,176.34.37.52,443,6,340,4,228,2,112,466.864519,24.132664,75.58220676,37.12810156,Benign
192.168.43.224,39068,103.37.200.184,443,21,3124,12,2136,9,988,2513.966214,27.98749343,610.5584283,282.4118573,Benign
172.30.6.255,56909,63.251.88.56,80,11,2496,6,1846,5,650,1385.602789,0.801787,18418.85688,6485.512985,Benign
192.168.43.233,51156,52.114.158.91,443,32,11856,17,5035,15,6821,477.730794,12.208348,3299.381702,4469.728419,Benign
192.168.43.233,50966,182.50.136.239,80,12,3100,6,552,6,2548,487.900573,4.449605,992.4476442,4581.080793,Benign
10.0.2.15,38155,119.254.87.201,80,11,1579,6,705,5,874,8181.201505,2.015414,2798.432481,3469.262395,Malicious
192.168.43.233,50925,52.84.103.186,443,6265,4689109,3000,202221,3265,4486888,431.762323,237.41714,6814.032045,151190.0278,Benign
10.0.2.15,38869,119.254.87.201,80,13,1730,8,853,5,877,14968.71249,10.678909,639.0165887,656.9959534,Malicious
192.168.43.224,37192,151.101.194.217,443,21,9592,12,1494,9,8098,346.8513131,17.22650731,693.8144679,3760.715904,Benign
172.30.6.255,58505,173.241.248.220,80,10,2494,6,1300,4,1194,5747.862658,1.319136,7883.948281,7241.103268,Benign
172.30.6.255,57221,103.243.220.231,80,22,13621,10,5275,12,8346,2138.893839,19.171781,2201.151787,3482.618542,Benign
172.30.15.781,50073,34.200.202.18,443,20,9264,9,2269,11,6995,2661.122696,5.320051,3411.997366,10518.69616,Benign
192.168.43.224,42784,172.217.166.197,443,20,5950,11,2014,9,3936,49.9834346,20.42538131,788.8224828,1541.611367,Benign
172.30.6.255,56484,52.114.128.10,443,23,11005,14,4488,9,6517,810.904946,1.996241,17985.80432,26117.08707,Benign
172.30.15.1759,51071,184.29.25.7,443,38,25746,17,6294,21,19452,3638.244763,8.92385,5642.407705,17438.21333,Benign
172.30.15.2479,51813,14.139.45.128,80,36,27541,14,1126,22,26415,5424.375749,0.724797,12428.30751,291557.4982,Benign
172.30.15.2057,51369,144.2.1.5,443,27,6712,14,2431,13,4281,4095.888919,1.703023,11419.6931,20110.12182,Benign
172.30.1.136,50204,23.58.57.98,443,17,1026,9,546,8,480,359.227873,48.06239,90.8818725,79.89615165,Benign
172.30.6.255,58428,157.240.16.39,443,79,54760,31,5271,48,49489,5591.955809,7.073976,5961.004109,55967.39373,Benign
192.168.43.224,45976,54.173.101.22,443,9,610,5,338,4,272,1010.828409,63.2142127,42.77519065,34.42263863,Benign
192.168.215.49,44166,172.217.161.5,443,4119,2713311,1578,208252,2541,2505059,18.77288563,672.4499546,2477.531582,29802.17615,Benign
172.30.6.255,57523,210.176.156.62,80,14,5521,7,3905,7,1616,3122.851095,3.378406,9246.964397,3826.656713,Benign
172.30.15.793,50085,52.84.108.93,443,122,84308,60,6860,62,77448,2676.647022,9.579122,5729.126323,64680.66698,Benign
192.168.215.49,58354,104.113.219.181,443,109,36874,53,15476,56,21398,479.9138771,499.9035942,247.6637524,342.4340252,Benign
192.168.43.233,50967,49.44.170.2,443,270,194427,119,11525,151,182902,489.889576,648.86621,142.0940073,2255.034979,Benign
10.0.2.15,52703,119.254.87.201,80,11,1582,6,705,5,877,7728.633607,2.206906,2555.614059,3179.111389,Malicious
10.0.2.15,39199,119.254.87.201,80,11,1579,6,705,5,874,4903.430343,1.815128,3107.218885,3852.069937,Malicious
172.30.15.1613,50923,161.202.1.35,443,17,5795,9,1626,8,4169,3573.952843,3.225059,4033.414582,10341.51623,Benign
172.30.6.255,58163,35.190.43.164,80,8,469,5,283,3,186,4962.252778,48.457541,46.72131423,30.70729487,Benign
10.0.2.15,56087,119.254.87.201,80,12,1656,7,779,5,877,23045.09899,3.88221,1605.271224,1807.218054,Malicious
192.168.43.224,39008,103.37.200.184,443,437,336921,207,16814,230,320107,2457.975548,58.2689852,2308.466494,43948.86905,Benign
172.30.15.2291,51617,52.175.39.99,443,22,6331,12,1832,10,4499,4834.652281,0.809014,18115.87933,44488.72331,Benign
10.0.2.15,36322,119.254.87.201,80,11,1569,6,705,5,864,7936.240097,2.212131,2549.57776,3124.588914,Malicious
172.30.15.641,49928,192.0.73.2,80,15,3334,8,830,7,2504,2394.301267,1.859728,3570.414598,10771.46766,Benign
172.30.6.255,55778,195.201.82.80,80,234,257764,50,6274,184,251490,63.640135,35.254218,1423.716164,57068.91584,Benign
172.30.6.255,57750,103.243.221.87,80,68,47478,32,19441,36,28037,3845.105855,36.961107,4207.882626,6068.432961,Benign
192.168.137.97,57756,23.111.9.35,443,547,427836,243,15062,304,412774,0.224029803,105.7293894,1139.6642,31232.48909,Benign
172.30.6.255,58396,216.58.196.162,80,17,4023,10,2307,7,1716,5539.974154,9.092491,2029.806793,1509.817277,Benign
192.168.43.233,51352,209.197.3.15,443,46,27225,19,2175,27,25050,3084.617741,17.702958,982.8865888,11320.14209,Benign
10.0.2.15,54333,119.254.87.201,80,11,1513,6,705,5,808,21573.11945,2.510941,2246.169862,2574.333686,Malicious
192.168.43.224,35272,52.84.108.195,443,24,3364,14,2112,10,1252,1900.765373,157.289724,107.4196048,63.67866725,Benign
10.0.2.15,43719,119.254.87.201,80,12,1653,7,779,5,874,11930.33254,4.39486,1418.020142,1590.949427,Malicious
10.0.2.15,44520,119.254.87.201,80,11,1582,6,705,5,877,7425.652887,1.09563,5147.723228,6403.621661,Malicious
192.168.137.97,52232,172.217.161.3,443,38,4145,20,2356,18,1789,9008.869259,240.8648531,78.25135032,59.41921295,Benign
192.168.43.233,51425,52.114.158.91,443,20,7890,10,3142,10,4748,3671.659496,3.234794,7770.510271,11742.32424,Benign
172.30.1.136,50679,52.16.255.206,443,36,18546,22,7875,14,10671,1805.137605,19.657944,3204.811246,4342.671848,Benign
192.168.43.224,57230,139.59.82.147,443,11,774,7,486,4,288,2493.488958,17.19470902,226.1160684,133.9947072,Benign
10.0.2.15,42792,119.254.87.201,80,11,1582,6,705,5,877,20131.57011,1.680886,3355.373297,4173.989194,Malicious
172.30.6.255,56916,35.189.135.205,80,6,348,4,228,2,120,1386.697472,17.803457,102.4520126,53.92211187,Benign
192.168.43.233,51090,182.22.24.124,443,19,7348,9,1267,10,6081,916.663495,1.61002,6295.573968,30215.77372,Benign
192.168.43.224,39050,157.240.16.52,443,4,303,1,66,3,237,5.964519613,0.10003138,5278.343656,18954.05222,Benign
192.168.43.224,37398,52.84.110.227,443,552,314534,272,50985,280,263549,37.33836894,218.5494065,1866.305686,9647.20991,Benign
172.30.15.408,49680,192.168.121.7,443,91,48513,38,8848,53,39665,1542.106825,8.339484,8487.815313,38050.31582,Benign
172.30.6.255,56670,103.243.221.17,80,3,198,3,198,0,0,1132.85599,9.001246,175.9756372,0,Benign
172.30.6.255,57239,103.243.220.231,80,25,13867,11,5329,14,8538,2204.912192,21.118408,2018.712774,3234.334709,Benign
172.30.6.255,56250,23.56.26.27,80,11,3817,7,2458,4,1359,529.951518,6.039647,3255.819421,1800.105205,Benign
192.168.137.97,55068,198.252.206.25,443,504,47332,245,21854,259,25478,3867.131089,8508.340296,20.54830836,23.95578843,Benign
172.30.15.2398,51732,14.139.45.128,80,16,7783,7,738,9,7045,5343.449915,0.037298,158292.6698,1511072.98,Benign
172.30.15.666,49953,104.27.177.100,80,17,8918,9,913,8,8005,2397.039958,9.233053,791.0709491,6935.950655,Benign
172.30.15.1379,50687,210.176.156.55,443,23,9450,13,5766,10,3684,3494.774827,2.331067,19788.36301,12643.13724,Benign
172.30.6.255,57430,103.243.221.17,80,30,18283,17,15168,13,3115,2796.72274,33.351583,3638.328052,747.1909204,Benign
172.30.6.255,55816,151.101.66.49,80,6,348,4,228,2,120,90.876722,11.160809,163.4290131,86.01527004,Benign
172.30.1.136,50222,52.84.103.186,443,27,4968,11,3278,16,1690,385.107261,187.423056,139.9187515,72.13626908,Benign
172.30.6.255,57763,103.243.220.231,80,51,34446,24,13716,27,20730,3910.875217,65.170982,1683.694132,2544.690826,Benign
172.30.15.1264,50572,54.231.114.138,443,25,6640,12,1339,13,5301,3469.53716,8.08718,1324.565547,5243.855089,Benign
192.168.43.233,51078,52.84.110.220,443,71,29245,34,3186,37,26059,916.256396,211.333966,120.6053172,986.4576147,Benign
10.0.2.15,44925,219.234.85.243,80,8,1325,4,1069,4,256,250.656604,0.583007,14668.77756,3512.822316,Malicious
10.0.2.15,60762,119.254.87.201,80,11,1513,6,705,5,808,8631.635266,2.012015,2803.160016,3212.699707,Malicious
10.0.2.15,40890,119.254.87.201,80,11,1582,6,705,5,877,26258.91955,1.287584,4380.296742,5448.964883,Malicious
172.30.15.2135,51447,52.86.72.168,443,19,6781,9,1141,10,5640,4178.564827,9.065126,1006.935811,4977.316366,Benign
172.30.6.255,57760,103.243.221.109,80,116,83227,70,71043,46,12184,3910.874407,65.171795,8720.705023,1495.616317,Benign
192.168.215.49,46392,223.31.160.67,443,13,1606,7,1038,6,568,282.9451909,10.11637791,820.8471522,449.1726228,Benign
172.30.6.255,57436,52.175.23.79,443,27,10548,12,2065,15,8483,2807.372747,128.374602,128.6858907,528.6403926,Benign
192.168.137.97,50866,103.211.218.251,443,292,230333,125,16681,167,213652,592.7920427,10.10632169,13204.4085,169123.4509,Benign
172.30.1.136,50634,172.217.161.3,443,13,1759,8,1236,5,523,1726.225641,13.307207,743.0559997,314.4160905,Benign
10.0.2.15,59851,119.254.87.201,80,12,1656,7,779,5,877,14935.83049,3.930993,1585.350063,1784.790764,Malicious
192.168.43.233,51012,163.53.78.128,443,57,33480,26,8557,31,24923,689.6984,41.188142,1662.031757,4840.810736,Benign
10.0.2.15,40118,119.254.87.201,80,11,1579,6,705,5,874,25625.10557,2.015106,2798.860209,3469.792656,Malicious
172.30.15.2514,51848,54.251.147.241,80,6,348,4,228,2,120,5483.469852,4.687651,389.1074656,204.7934029,Benign
172.30.15.637,49924,52.84.110.188,443,8,480,5,294,3,186,2393.471051,2.666716,881.9836833,557.9896772,Benign
172.30.6.255,57499,173.241.248.220,80,240,122632,123,62121,117,60511,3057.858278,1182.07298,420.4207426,409.5246302,Benign
172.30.6.255,56048,103.243.221.75,443,18,5463,10,3038,8,2425,254.410095,30.434925,798.5562639,637.4255892,Benign
192.168.43.233,51158,182.161.72.84,443,4,240,2,120,2,120,949.407217,10.640096,90.22474985,90.22474985,Benign
172.30.1.136,50625,157.240.16.16,443,99,28867,49,22945,50,5922,1659.800511,243.005203,755.3747728,194.9587886,Benign
10.0.2.15,52906,119.254.87.201,80,11,1585,6,705,5,880,15058.80374,1.486529,3794.073308,4735.864554,Malicious
192.168.137.97,45248,173.194.60.168,443,24,6844,13,1484,11,5360,634.3287477,79.58496659,149.1739019,538.7952252,Benign
172.30.1.136,50199,172.217.161.1,443,14,864,8,492,6,372,358.080285,18.167825,216.6467367,163.8060692,Benign
172.30.6.255,55720,103.229.206.238,80,13,3269,8,2012,5,1257,57.682583,1.033377,15576.11598,9731.201681,Benign
192.168.43.233,51514,131.253.33.254,443,36,11408,20,2481,16,8927,3905.374756,130.997904,151.5138746,545.169028,Benign
10.0.2.15,60923,119.254.87.201,80,11,1582,6,705,5,877,18179.4688,0.95032,5934.843,7382.776328,Malicious
172.30.6.255,57675,157.240.16.39,443,19,1945,10,1137,9,808,3595.097401,61.017903,149.071003,105.9361217,Benign
10.0.2.15,53966,119.254.87.201,80,11,1579,6,705,5,874,7818.698865,2.04675,2755.588128,3416.147551,Malicious
172.30.15.1257,50565,180.149.59.139,80,8,468,5,282,3,186,3469.528217,7.978254,282.7686358,186.5069726,Benign
172.30.1.136,50363,172.217.161.14,443,21,1206,12,684,9,522,651.186039,44.005184,124.3489858,94.89791021,Benign
192.168.137.97,39716,35.171.73.174,443,29,6585,16,2122,13,4463,5674.641951,60.85689109,278.9495108,586.6878732,Benign
192.168.137.97,44892,104.17.41.113,443,16,920,8,452,8,468,26.21939139,15.07321102,239.895799,248.3876857,Benign
172.30.15.1377,50685,104.244.42.72,443,6,348,4,228,2,120,3494.614687,2.539441,718.2683118,378.0359536,Benign
192.168.43.233,51287,23.9.140.60,80,27,12080,15,11120,12,960,2781.992341,125.327639,709.8194836,61.27937988,Benign
