Source,S_Port,Destination,D_Port,Packets,Bytes,Packets A --> B,Bytes A --> B,Packets B--> A,Bytes B --> A,Rel Start,Duration,Bits/S A -->B,Bits/S B --> A,Label
10.0.2.2,53473,10.0.2.15,5555,9,706,5,362,4,344,0,36789.0159,0.078719148,0.074804937,Malicious
10.0.2.15,42409,115.182.31.2,80,10,1663,5,658,5,1005,15.734649,0.825825,6374.231829,9735.718827,Malicious
10.0.2.15,55322,115.182.31.2,80,10,1992,5,554,5,1438,17.253281,0.614013,7218.088216,18735.75967,Malicious
10.0.2.15,35042,219.234.85.240,80,11,1857,6,795,5,1062,17.853297,1.741375,3652.286268,4878.903166,Malicious
10.0.2.15,44296,219.234.85.240,80,11,1631,6,796,5,835,17.884465,3.888854,1637.500405,1717.729696,Malicious
10.0.2.15,56461,219.234.85.222,80,11,1631,6,796,5,835,17.886664,3.886574,1638.46102,1718.737376,Malicious
10.0.2.15,52614,219.234.85.243,80,11,1344,6,792,5,552,17.888686,2.14441,2954.658857,2059.307688,Malicious
10.0.2.15,48881,219.234.85.238,80,11,1344,6,792,5,552,17.889524,3.878653,1633.556804,1138.539591,Malicious
10.0.2.15,38387,118.26.228.168,80,15,2019,8,1011,7,1008,18.789748,166.475978,48.58358604,48.43942109,Malicious
10.0.2.15,37932,124.95.142.227,80,17,6479,9,730,8,5749,19.465569,33.751141,173.0311873,1362.679857,Malicious
10.0.2.15,33412,219.234.85.243,80,11,1340,6,788,5,552,19.815445,1.93769,3253.35838,2279.002317,Malicious
10.0.2.15,45247,219.234.85.236,80,10,1023,5,593,5,430,21.450934,0.86157,5506.227004,3992.710981,Malicious
10.0.2.15,49374,219.234.85.243,80,7,428,4,236,3,192,22.850811,0.743576,2539.081412,2065.693352,Malicious
10.0.2.15,36873,219.234.85.243,80,8,1325,4,1069,4,256,22.895649,0.619351,13808.00225,3306.687161,Malicious
10.0.2.15,39026,219.234.85.243,80,2,138,1,74,1,64,23.51789,0.326816,1811.416822,1566.630765,Malicious
10.0.2.15,49068,219.234.85.216,80,8,1325,4,1069,4,256,23.847623,0.665912,12842.53775,3075.481445,Malicious
10.0.2.15,47662,115.182.31.2,80,10,1992,5,554,5,1438,51.607546,0.730012,6071.133077,15758.64506,Malicious
10.0.2.15,53070,219.234.85.243,80,11,1631,6,796,5,835,51.670526,1.825759,3487.864499,3658.752333,Malicious
10.0.2.15,45657,219.234.85.243,80,11,1344,6,792,5,552,51.675487,1.820714,3479.953469,2425.422115,Malicious
10.0.2.15,56374,124.95.142.227,80,19,6587,10,784,9,5803,52.349606,98.408693,63.7342069,471.7469421,Malicious
10.0.2.15,36862,115.182.31.2,80,8,719,4,463,4,256,53.586832,0.579801,6388.398778,3532.246409,Malicious
10.0.2.15,56254,115.182.31.2,80,8,719,4,463,4,256,54.168283,0.594311,6232.42713,3446.007225,Malicious
10.0.2.15,41079,115.182.31.2,80,9,773,5,517,4,256,54.764442,62.451775,66.22710083,32.79330331,Malicious
10.0.2.15,51378,124.95.142.227,80,44,25147,20,1549,24,23598,59.020414,1.019177,12158.83011,185231.8096,Malicious
10.0.2.15,40194,219.234.85.243,80,2,138,1,74,1,64,61.04635,0.295051,2006.432786,1735.29322,Malicious
10.0.2.15,35061,219.234.85.243,80,8,944,4,688,4,256,61.048489,58.057214,94.80303344,35.27554732,Malicious
10.0.2.15,39173,219.234.85.216,80,8,940,4,684,4,256,61.343034,64.308922,85.08928201,31.84628099,Malicious
10.0.2.15,52714,124.95.142.228,80,6451,7282386,1695,91824,4756,7190562,62.178113,33.130577,22172.62923,1736296.232,Malicious
10.0.2.15,54542,115.182.31.2,80,8,756,4,500,4,256,83.059936,62.161823,64.34817718,32.94626671,Malicious
10.0.2.15,57989,219.234.85.243,80,7,428,4,236,3,192,89.555332,0.405203,4659.392946,3790.692566,Malicious
10.0.2.15,40725,219.234.85.243,80,8,1325,4,1069,4,256,89.612825,0.309896,27596.35491,6608.668715,Malicious
10.0.2.15,40529,219.234.85.243,80,2,138,1,74,1,64,89.924314,0.361669,1636.855799,1415.659069,Malicious
10.0.2.15,40190,219.234.85.216,80,9,1379,5,1123,4,256,90.288267,62.142903,144.5700083,32.95629752,Malicious
10.0.2.15,39365,219.234.85.243,80,11,1631,6,796,5,835,119.108637,31.998601,199.0087004,208.7591267,Malicious
10.0.2.15,42470,219.234.85.243,80,11,1344,6,792,5,552,125.655108,25.45198,248.9393752,173.5032009,Malicious
10.0.2.15,53313,115.182.31.2,80,10,1992,5,554,5,1438,145.224627,0.722476,6134.45983,15923.02028,Malicious
10.0.2.15,36013,124.95.142.227,80,17,6479,9,730,8,5749,145.96048,33.937281,172.0821418,1355.205799,Malicious
10.0.2.15,44723,219.234.85.243,80,9,1379,5,1123,4,256,176.599903,0.602682,14906.70038,3398.143631,Malicious
10.0.2.15,36546,219.234.85.243,80,11,1631,6,796,5,835,176.624111,3.545378,1796.141342,1884.143242,Malicious
10.0.2.15,49036,219.234.85.243,80,8,940,4,684,4,256,176.632917,0.591816,9246.117036,3460.535031,Malicious
10.0.2.15,58415,115.182.31.2,80,10,1992,5,554,5,1438,176.921952,0.662958,6685.18971,17352.53214,Malicious
10.0.2.15,45149,219.234.85.243,80,8,940,4,684,4,256,177.226358,64.318694,85.07635432,31.84144255,Malicious
10.0.2.15,51152,124.95.142.227,80,15,6361,8,676,7,5685,177.596903,6.100382,886.5018617,7455.270834,Malicious
10.0.2.15,52310,124.95.142.227,80,28,15473,15,1279,13,14194,178.514478,0.738428,13856.46265,153775.3173,Malicious
10.0.2.15,38496,115.182.31.2,80,9,773,5,517,4,256,178.761432,0.683102,6054.732675,2998.088133,Malicious
10.0.2.15,40646,115.182.31.2,80,8,719,4,463,4,256,179.446118,0.567709,6524.469402,3607.482002,Malicious
10.0.2.15,42670,115.182.31.2,80,9,773,5,517,4,256,180.01534,55.85667,74.04666265,36.66527203,Malicious
10.0.2.15,36251,219.234.85.243,80,9,994,5,738,4,256,180.203043,1.801442,3277.374459,1136.867021,Malicious
10.0.2.15,43170,219.234.85.243,80,11,1631,6,796,5,835,180.218635,2.697942,2360.317605,2475.961307,Malicious
10.0.2.15,50723,219.234.85.243,80,8,940,4,684,4,256,182.006744,0.59523,9193.085026,3440.686793,Malicious
10.0.2.15,37309,124.95.142.228,80,6724,7297128,1960,106134,4764,7190994,182.239614,46.357489,18315.74614,1240963.504,Malicious
10.0.2.15,36585,219.234.85.243,80,8,943,4,687,4,256,182.564958,64.222145,85.57795757,31.8893117,Malicious
10.0.2.15,49211,219.234.85.243,80,11,1671,6,803,5,868,182.572999,1.038831,6183.873989,6684.436641,Malicious
10.0.2.15,43567,219.234.85.243,80,9,994,5,738,4,256,182.603821,0.656042,8999.423817,3121.751351,Malicious
10.0.2.15,52418,219.234.85.243,80,8,940,4,684,4,256,183.262998,64.291879,85.11183815,31.85472305,Malicious
10.0.2.15,58940,118.26.228.168,80,13,1775,7,906,6,869,185.315453,76.034214,95.32550701,91.43252273,Malicious
10.0.2.15,41830,219.234.85.243,80,8,944,4,688,4,256,185.532714,0.62306,8833.820178,3287.002857,Malicious
10.0.2.15,42132,115.182.31.2,80,8,860,4,604,4,256,185.757271,57.782135,83.62446282,35.44348093,Malicious
10.0.2.15,50853,219.234.85.243,80,11,1344,6,792,5,552,185.771341,5.241598,1208.79167,842.491164,Malicious
10.0.2.15,40929,219.234.85.243,80,8,944,4,688,4,256,186.159177,0.601564,9149.483679,3404.459043,Malicious
10.0.2.15,33311,219.234.85.243,80,8,944,4,688,4,256,186.424277,64.300733,85.59778004,31.85033676,Malicious
10.0.2.15,40570,219.234.85.243,80,11,1631,6,796,5,835,186.789882,4.29405,1482.982266,1555.640945,Malicious
10.0.2.15,51703,219.234.85.243,80,2,138,1,74,1,64,187.673817,2.17522,272.1563796,235.3784905,Malicious
10.0.2.15,43536,219.234.85.216,80,11,1344,6,792,5,552,189.927564,57.625987,109.9503944,76.63209309,Malicious
10.0.2.15,60203,219.234.85.243,80,7,428,4,236,3,192,190.276769,0.657132,2873.090947,2337.429923,Malicious
10.0.2.15,47777,219.234.85.243,80,9,1379,5,1123,4,256,190.333112,82.971185,108.2785548,24.68326805,Malicious
10.0.2.15,52657,219.234.85.243,80,8,940,4,684,4,256,241.548195,0.646976,8457.809872,3165.496093,Malicious
10.0.2.15,42079,219.234.85.243,80,8,940,4,684,4,256,242.198296,62.169671,88.01719411,32.94210774,Malicious
10.0.2.15,39856,115.182.31.2,80,10,1663,5,658,5,1005,243.542,0.868647,6059.999056,9255.773634,Malicious
10.0.2.15,55445,219.234.85.243,80,8,943,4,687,4,256,246.790003,0.620025,8864.158703,3303.092617,Malicious
10.0.2.15,40049,219.234.85.243,80,8,943,4,687,4,256,247.412897,83.070008,66.16106261,24.65390397,Malicious
10.0.2.15,44925,219.234.85.243,80,8,1325,4,1069,4,256,250.656604,0.583007,14668.77756,3512.822316,Malicious
10.0.2.15,55303,219.234.85.243,80,8,944,4,688,4,256,250.727829,0.644352,8541.914978,3178.386969,Malicious
10.0.2.15,57581,219.234.85.243,80,8,944,4,688,4,256,251.40131,77.348537,71.15842411,26.47755316,Malicious
10.0.2.15,35718,219.234.85.243,80,11,1631,6,796,5,835,328.752892,36455.5826,0.174678322,0.183236682,Malicious
10.0.2.15,56358,219.234.85.243,80,11,1857,6,795,5,1062,330.486157,36453.84852,0.174467176,0.233061812,Malicious
10.0.2.15,39500,219.234.85.243,80,11,1340,6,788,5,552,331.229996,36453.10287,0.172934524,0.121141951,Malicious
10.0.2.15,49851,115.182.31.2,80,8,756,4,500,4,256,36784.88899,0.66673,5999.430054,3071.708188,Malicious
10.0.2.15,45094,219.234.85.216,80,11,1631,6,796,5,835,36785.37344,2.628703,2422.48744,2541.177151,Malicious
10.0.2.15,51679,219.234.85.220,80,7,428,4,236,3,192,36785.37692,0.772623,2443.623863,1988.032973,Malicious
10.0.2.15,40002,219.234.85.243,80,6,832,4,704,2,128,36785.40104,3.339432,1686.514353,306.6389733,Malicious
10.0.2.15,40539,219.234.85.216,80,11,1857,6,795,5,1062,36785.40929,1.898667,3349.718513,4474.718316,Malicious
10.0.2.15,59650,115.182.31.2,80,5,574,3,446,2,128,36785.55836,0.527368,6765.674064,1941.718117,Malicious
10.0.2.15,49142,219.234.85.216,80,11,1857,6,795,5,1062,36786.26533,1.660762,3829.567391,5115.723987,Malicious
10.0.2.15,54945,219.234.85.216,80,11,1857,6,795,5,1062,36786.35896,1.643035,3870.885282,5170.918453,Malicious
10.0.2.15,50865,219.234.85.216,80,7,1435,4,695,3,740,36786.92858,0.908039,6123.085022,6519.543764,Malicious
10.0.2.15,58426,219.234.85.216,80,7,1104,4,680,3,424,36786.97186,0.954689,5698.19072,3552.989508,Malicious
10.0.2.2,49202,10.0.2.15,5555,7,574,4,284,3,290,0,0.201344,11284.17038,11522.56834,Malicious
10.0.2.15,53763,216.52.203.13,80,11,1130,6,697,5,433,21.282948,3.482192,1601.290222,994.7757045,Malicious
10.0.2.15,52491,209.141.55.182,80,11,1345,6,530,5,815,24.059667,9.465076,447.9625943,688.8481403,Malicious
10.0.2.15,38318,119.254.87.201,80,11,1586,6,709,5,877,24.141309,1.943787,2918.015194,3609.448978,Malicious
10.0.2.15,47322,119.254.87.201,80,11,1582,6,705,5,877,40.503337,1.679481,3358.180295,4177.481019,Malicious
10.0.2.15,50849,119.254.87.201,80,11,1582,6,705,5,877,42.383889,1.507116,3742.246781,4655.248833,Malicious
10.0.2.15,48852,119.254.87.201,80,11,1582,6,705,5,877,68.253256,1.810415,3115.307816,3875.354546,Malicious
10.0.2.15,45745,119.254.87.201,80,11,1579,6,705,5,874,70.505455,1.835739,3072.332178,3808.820317,Malicious
10.0.2.15,60497,119.254.87.201,80,11,1579,6,705,5,874,72.390246,1.837892,3068.733092,3804.358472,Malicious
10.0.2.15,38389,119.254.87.201,80,11,1579,6,705,5,874,98.164168,2.02058,2791.277752,3460.392561,Malicious
10.0.2.15,38123,119.254.87.201,80,11,1582,6,705,5,877,100.565166,1.820669,3097.762416,3853.528566,Malicious
10.0.2.15,57290,119.254.87.201,80,11,1568,6,705,5,863,102.523465,1.937382,2911.14504,3563.571872,Malicious
10.0.2.15,33974,119.254.87.201,80,11,1552,6,705,5,847,128.218402,1.287094,4381.964332,5264.572751,Malicious
10.0.2.15,32924,119.254.87.201,80,11,1579,6,705,5,874,130.622413,7.444208,757.6360037,939.2537124,Malicious
10.0.2.15,40346,119.254.87.201,80,12,1653,7,779,5,874,132.485588,4.318996,1442.92794,1618.894762,Malicious
10.0.2.15,38853,119.254.87.201,80,11,1582,6,705,5,877,158.278097,1.746015,3230.212799,4018.293085,Malicious
10.0.2.15,46193,119.254.87.201,80,11,1513,6,705,5,808,160.756695,1.733021,3254.432578,3729.902869,Malicious
10.0.2.15,35252,119.254.87.201,80,11,1582,6,705,5,877,162.514334,3.188007,1769.130369,2200.747991,Malicious
10.0.2.15,43281,119.254.87.201,80,11,1544,6,705,5,839,188.31196,1.631967,3455.952234,4112.828262,Malicious
10.0.2.15,53475,119.254.87.201,80,11,1560,6,705,5,855,190.714569,1.74131,3238.940797,3928.077137,Malicious
10.0.2.15,50756,119.254.87.201,80,11,1579,6,705,5,874,192.568809,1.635184,3449.153123,4275.971389,Malicious
10.0.2.15,44006,119.254.87.201,80,11,1513,6,705,5,808,218.445217,1.669368,3378.524088,3872.124061,Malicious
10.0.2.15,35882,119.254.87.201,80,11,1582,6,705,5,877,220.752358,1.841725,3062.346442,3809.472098,Malicious
10.0.2.15,56966,119.254.87.201,80,11,1569,6,705,5,864,222.607598,1.75308,3217.19488,3942.775002,Malicious
10.0.2.15,57243,119.254.87.201,80,11,1582,6,705,5,877,248.367763,4.830513,1167.577854,1452.433727,Malicious
10.0.2.15,40074,119.254.87.201,80,11,1579,6,705,5,874,250.808037,1.816278,3105.251509,3849.630949,Malicious
10.0.2.15,37231,119.254.87.201,80,11,1582,6,705,5,877,252.767173,1.744197,3233.579693,4022.481405,Malicious
10.0.2.15,45031,119.254.87.201,80,11,1579,6,705,5,874,278.392623,1.757279,3209.507426,3978.87871,Malicious
10.0.2.15,50109,119.254.87.201,80,11,1582,6,705,5,877,280.86031,2.523703,2234.811307,2780.041867,Malicious
10.0.2.15,36020,119.254.87.201,80,11,1582,6,705,5,877,282.719777,1.579194,3571.442141,4442.772706,Malicious
10.0.2.15,41527,119.254.87.201,80,11,1585,6,705,5,880,308.428116,1.769553,3187.245593,3978.405846,Malicious
10.0.2.15,60398,119.254.87.201,80,11,1579,6,705,5,874,310.993082,1.714605,3289.387352,4077.907156,Malicious
10.0.2.15,54013,119.254.87.201,80,11,1593,6,705,5,888,312.747566,1.899139,2969.766826,3740.64247,Malicious
10.0.2.15,42409,119.254.87.201,80,11,1534,6,705,5,829,338.455771,1.759587,3205.297607,3769.066264,Malicious
10.0.2.15,57929,119.254.87.201,80,11,1582,6,705,5,877,340.921042,1.757274,3209.516558,3992.547548,Malicious
10.0.2.15,38435,119.254.87.201,80,12,1587,7,779,5,808,342.786149,4.707383,1323.877832,1373.162116,Malicious
10.0.2.15,33220,119.254.87.201,80,11,1579,6,705,5,874,368.583166,1.448804,3892.866116,4826.049624,Malicious
10.0.2.15,50185,119.254.87.201,80,11,1513,6,705,5,808,371.020017,1.614078,3494.254924,4004.763091,Malicious
10.0.2.15,60878,119.254.87.201,80,11,1582,6,705,5,877,372.806974,1.429077,3946.603297,4909.462541,Malicious
10.0.2.15,48493,119.254.87.201,80,11,1560,6,705,5,855,398.511614,2.555123,2207.330136,2676.974846,Malicious
10.0.2.15,49784,119.254.87.201,80,11,1579,6,705,5,874,401.000067,0.819678,6880.750734,8530.178924,Malicious
10.0.2.15,42858,119.254.87.201,80,11,1579,6,705,5,874,402.962201,2.379584,2370.16218,2938.328716,Malicious
10.0.2.15,59478,119.254.87.201,80,11,1582,6,705,5,877,428.549971,1.497438,3766.433068,4685.335887,Malicious
10.0.2.15,56453,119.254.87.201,80,11,1513,6,705,5,808,431.013049,1.62553,3469.637595,3976.549187,Malicious
10.0.2.15,57929,119.254.87.201,80,11,1513,6,705,5,808,432.885336,1.755117,3213.460983,3682.945354,Malicious
10.0.2.15,60761,119.254.87.201,80,11,1579,6,705,5,874,458.54753,1.37562,4099.969468,5082.799029,Malicious
10.0.2.15,37991,119.254.87.201,80,11,1513,6,705,5,808,461.133479,1.182667,4768.882534,5465.61289,Malicious
10.0.2.15,44061,119.254.87.201,80,11,1513,6,705,5,808,462.892191,1.277923,4413.41145,5058.207732,Malicious
10.0.2.15,42696,119.254.87.201,80,11,1582,6,705,5,877,488.57602,4.669763,1207.770073,1502.431708,Malicious
10.0.2.15,33908,119.254.87.201,80,11,1582,6,705,5,877,491.087037,1.778817,3170.646559,3944.194372,Malicious
10.0.2.15,33774,119.254.87.201,80,11,1579,6,705,5,874,492.914688,1.68523,3346.724186,4148.988565,Malicious
10.0.2.15,48997,119.254.87.201,80,11,1582,6,705,5,877,518.708377,1.179114,4783.25251,5950.230427,Malicious
10.0.2.15,40071,119.254.87.201,80,11,1579,6,705,5,874,521.124221,1.217238,4633.440625,5744.151924,Malicious
10.0.2.15,57712,119.254.87.201,80,11,1579,6,705,5,874,522.919175,1.025422,5500.174562,6818.656124,Malicious
10.0.2.15,50072,119.254.87.201,80,11,1579,6,705,5,874,548.62791,1.818198,3101.972392,3845.565774,Malicious
10.0.2.15,34950,119.254.87.201,80,11,1582,6,705,5,877,551.148835,3.554357,1586.784895,1973.915395,Malicious
10.0.2.15,59357,119.254.87.201,80,11,1579,6,705,5,874,552.950134,1.886045,2990.384641,3707.228619,Malicious
10.0.2.15,58851,119.254.87.201,80,11,1579,6,705,5,874,578.63657,1.618227,3485.295944,4320.778234,Malicious
10.0.2.15,48567,119.254.87.201,80,11,1579,6,705,5,874,581.170475,1.758497,3207.284403,3976.122791,Malicious
10.0.2.15,33863,119.254.87.201,80,11,1582,6,705,5,877,582.973459,1.617533,3486.791305,4337.469467,Malicious
10.0.2.15,35186,119.254.87.201,80,11,1579,6,705,5,874,608.657376,1.748301,3225.989117,3999.311331,Malicious
10.0.2.15,33801,119.254.87.201,80,11,1513,6,705,5,808,611.177129,1.755541,3212.684865,3682.055845,Malicious
10.0.2.15,41818,119.254.87.201,80,11,1568,6,705,5,863,612.975176,1.752409,3218.426749,3939.719552,Malicious
10.0.2.15,48530,119.254.87.201,80,11,1582,6,705,5,877,638.818029,0.83723,6736.500125,8380.01505,Malicious
10.0.2.15,33156,119.254.87.201,80,11,1544,6,705,5,839,641.228399,0.883881,6380.949472,7593.782421,Malicious
10.0.2.15,33947,119.254.87.201,80,11,1582,6,705,5,877,643.015737,0.825605,6831.353977,8498.01055,Malicious
10.0.2.15,38613,119.254.87.201,80,11,1585,6,705,5,880,668.707811,1.74606,3230.129549,4031.934756,Malicious
10.0.2.15,44298,119.254.87.201,80,11,1579,6,705,5,874,671.291508,1.6295,3461.184412,4290.886775,Malicious
10.0.2.15,33168,119.254.87.201,80,11,1582,6,705,5,877,673.033242,1.700729,3316.224984,4125.289802,Malicious
10.0.2.15,42441,119.254.87.201,80,11,1582,6,705,5,877,698.744653,1.706988,3304.065406,4110.163633,Malicious
10.0.2.15,59831,119.254.87.201,80,11,1582,6,705,5,877,701.292227,1.760946,3202.823937,3984.222117,Malicious
10.0.2.15,33159,119.254.87.201,80,11,1593,6,705,5,888,703.091497,1.620244,3480.957189,4384.5248,Malicious
10.0.2.15,46628,119.254.87.201,80,11,1579,6,705,5,874,728.778937,1.758342,3207.567129,3976.473291,Malicious
10.0.2.15,50924,119.254.87.201,80,11,1579,6,705,5,874,731.305784,1.755068,3213.5507,3983.891222,Malicious
10.0.2.15,53925,119.254.87.201,80,11,1582,6,705,5,877,733.097401,1.849069,3050.183633,3794.341909,Malicious
10.0.2.15,41612,119.254.87.201,80,12,1661,7,779,5,882,758.830128,315.692335,19.74073903,22.35087526,Malicious
10.0.2.15,45114,119.254.87.201,80,11,1579,6,705,5,874,761.355988,1.553104,3631.437431,4501.95222,Malicious
10.0.2.15,43708,119.254.87.201,80,11,1579,6,705,5,874,763.152253,1.022865,5513.924125,6835.701681,Malicious
10.0.2.15,37597,119.254.87.201,80,11,1582,6,705,5,877,788.85951,0.86327,6533.297809,8127.237133,Malicious
10.0.2.15,45310,119.254.87.201,80,11,1582,6,705,5,877,791.357287,1.153491,4889.50499,6082.405498,Malicious
10.0.2.15,42910,119.254.87.201,80,11,1513,6,705,5,808,793.213316,1.025397,5500.308661,6303.899855,Malicious
10.0.2.15,43138,119.254.87.201,80,11,1579,6,705,5,874,818.895328,1.14899,4908.658909,6085.34452,Malicious
10.0.2.15,52956,119.254.87.201,80,11,1593,6,705,5,888,821.414794,1.221677,4616.60488,5814.957636,Malicious
10.0.2.15,56092,119.254.87.201,80,11,1582,6,705,5,877,823.272893,0.887569,6354.435542,7904.737547,Malicious
10.0.2.15,38085,119.254.87.201,80,11,1582,6,705,5,877,848.974389,0.828726,6805.62695,8466.006859,Malicious
10.0.2.15,51569,119.254.87.201,80,13,1727,8,853,5,874,851.439606,9.84374,693.2324503,710.2991343,Malicious
10.0.2.15,33160,119.254.87.201,80,11,1582,6,705,5,877,853.334765,2.357553,2392.311011,2975.96703,Malicious
10.0.2.15,51488,119.254.87.201,80,11,1579,6,705,5,874,879.011052,1.835678,3072.434272,3808.946885,Malicious
10.0.2.15,57444,119.254.87.201,80,11,1579,6,705,5,874,881.492307,1.668528,3380.224965,4190.520027,Malicious
10.0.2.15,55934,119.254.87.201,80,11,1513,6,705,5,808,883.497615,1.584279,3559.979019,4080.089429,Malicious
10.0.2.15,57722,119.254.87.201,80,11,1582,6,705,5,877,909.036412,1.885098,2991.886894,3721.82242,Malicious
10.0.2.15,39095,119.254.87.201,80,11,1579,6,705,5,874,911.497998,1.815535,3106.52232,3851.206394,Malicious
10.0.2.15,44139,119.254.87.201,80,11,1579,6,705,5,874,913.423929,1.879592,3000.651205,3719.956246,Malicious
10.0.2.15,41533,119.254.87.201,80,11,1579,6,705,5,874,939.060014,0.821123,6868.642091,8515.167642,Malicious
10.0.2.15,57364,119.254.87.201,80,11,1579,6,705,5,874,941.524199,2.531965,2227.518943,2761.491569,Malicious
10.0.2.15,42820,119.254.87.201,80,11,1579,6,705,5,874,943.449749,1.225445,4602.409737,5705.682426,Malicious
10.0.2.15,39419,119.254.87.201,80,11,1579,6,705,5,874,969.071097,0.89181,6324.217042,7840.235028,Malicious
10.0.2.15,52919,119.254.87.201,80,11,1579,6,705,5,874,971.531391,0.820486,6873.974693,8521.778556,Malicious
10.0.2.15,39878,119.254.87.201,80,11,1582,6,705,5,877,973.450688,1.483318,3802.286496,4729.936534,Malicious
10.0.2.15,35240,119.254.87.201,80,11,1582,6,705,5,877,999.085318,0.777233,7256.511239,9026.894123,Malicious
10.0.2.15,52422,119.254.87.201,80,11,1559,6,705,5,854,1001.557854,0.894741,6303.500119,7635.729222,Malicious
10.0.2.15,41853,119.254.87.201,80,11,1579,6,705,5,874,1003.497012,1.238635,4553.399508,5644.923646,Malicious
10.0.2.15,39065,119.254.87.201,80,11,1582,6,705,5,877,1029.129333,1.822946,3093.893072,3848.715212,Malicious
10.0.2.15,56568,119.254.87.201,80,11,1582,6,705,5,877,1031.588257,1.816965,3104.077404,3861.384231,Malicious
10.0.2.15,34850,119.254.87.201,80,11,1593,6,705,5,888,1033.50769,1.888588,2986.358062,3761.540368,Malicious
10.0.2.15,40817,119.254.87.201,80,11,1582,6,705,5,877,1059.145144,1.82282,3094.106933,3848.981249,Malicious
10.0.2.15,33868,119.254.87.201,80,11,1582,6,705,5,877,1061.609765,1.84916,3050.033529,3794.155184,Malicious
10.0.2.15,60052,119.254.87.201,80,11,1513,6,705,5,808,1063.565064,1.687954,3341.323283,3829.488244,Malicious
10.0.2.15,36861,119.254.87.201,80,11,1579,6,705,5,874,1089.180389,1.895182,2975.96748,3689.355429,Malicious
10.0.2.15,50976,119.254.87.201,80,11,1579,6,705,5,874,1091.649122,1.814673,3107.99797,3853.035781,Malicious
10.0.2.15,35341,119.254.87.201,80,11,1579,6,705,5,874,1093.565844,1.921893,2934.606661,3638.079747,Malicious
10.0.2.15,55360,119.254.87.201,80,11,1579,6,705,5,874,1119.23582,2.424545,2326.20966,2883.840061,Malicious
10.0.2.15,45348,119.254.87.201,80,11,1582,6,705,5,877,1121.700855,1.286435,4384.209074,5453.831713,Malicious
10.0.2.15,43529,119.254.87.201,80,11,1582,6,705,5,877,1123.624509,1.021896,5519.152634,6865.669305,Malicious
10.0.2.15,41799,119.254.87.201,80,11,1513,6,705,5,808,1149.239417,1.890527,2983.295134,3419.152437,Malicious
10.0.2.15,55354,119.254.87.201,80,11,1579,6,705,5,874,1151.702977,1.827199,3086.691707,3826.622059,Malicious
10.0.2.15,59745,119.254.87.201,80,11,1582,6,705,5,877,1153.642922,1.901298,2966.394537,3690.110651,Malicious
10.0.2.15,56609,119.254.87.201,80,11,1579,6,705,5,874,1179.289349,1.73635,3248.193049,4026.837907,Malicious
10.0.2.15,56851,119.254.87.201,80,11,1587,6,705,5,882,1181.731215,1.818478,3101.494767,3880.167921,Malicious
10.0.2.15,34845,119.254.87.201,80,11,1582,6,705,5,877,1183.652361,1.621447,3478.374563,4326.999279,Malicious
10.0.2.15,43331,119.254.87.201,80,11,1579,6,705,5,874,1209.350386,1.687939,3341.352975,4142.329788,Malicious
10.0.2.15,54566,119.254.87.201,80,11,1582,6,705,5,877,1211.751377,1.62707,3466.35363,4312.045579,Malicious
10.0.2.15,44976,119.254.87.201,80,11,1579,6,705,5,874,1213.685379,4.696192,1200.973044,1488.865873,Malicious
10.0.2.15,54531,119.254.87.201,80,12,1653,7,779,5,874,1239.502084,5.312213,1173.14573,1316.212283,Malicious
10.0.2.15,45003,119.254.87.201,80,3,222,3,222,0,0,1241.80613,9.059025,196.0475879,0,Malicious
10.0.2.15,33822,119.254.87.201,80,11,1579,6,705,5,874,1243.73823,1.576944,3576.537911,4433.892389,Malicious
10.0.2.15,43009,119.254.87.201,80,11,1579,6,705,5,874,1269.467074,1.42763,3950.603448,4897.627537,Malicious
10.0.2.15,56225,119.254.87.201,80,11,1582,6,705,5,877,1271.892211,1.38354,4076.499415,5071.049626,Malicious
10.0.2.15,57872,119.254.87.201,80,11,1544,6,705,5,839,1273.789595,2.870317,1964.939761,2338.417673,Malicious
10.0.2.15,48999,119.254.87.201,80,11,1513,6,705,5,808,1299.501468,1.624924,3470.931564,3978.032203,Malicious
10.0.2.15,40777,119.254.87.201,80,11,1579,6,705,5,874,1301.839328,1.680155,3356.833149,4161.520812,Malicious
10.0.2.15,53399,119.254.87.201,80,11,1593,6,705,5,888,1303.824522,1.619965,3481.5567,4385.279929,Malicious
10.0.2.15,49442,119.254.87.201,80,11,1593,6,705,5,888,1329.502927,0.914149,6169.672559,7771.162032,Malicious
10.0.2.15,54572,119.254.87.201,80,12,1653,7,779,5,874,1331.868077,3.90321,1596.634565,1791.346097,Malicious
10.0.2.15,44937,119.254.87.201,80,11,1513,6,705,5,808,1333.827156,0.8201,6877.210096,7881.965614,Malicious
10.0.2.15,51716,119.254.87.201,80,13,1727,8,853,5,874,1359.523719,9.802413,696.1551202,713.2937574,Malicious
10.0.2.15,34813,119.254.87.201,80,11,1579,6,705,5,874,1361.893663,0.827263,6817.662581,8451.967512,Malicious
10.0.2.15,38251,119.254.87.201,80,11,1582,6,705,5,877,1363.886291,0.962639,5858.894144,7288.298106,Malicious
10.0.2.15,59698,119.254.87.201,80,11,1513,6,705,5,808,1389.538863,0.979678,5756.993624,6598.08631,Malicious
10.0.2.15,36021,119.254.87.201,80,11,1582,6,705,5,877,1391.896484,0.826132,6826.99617,8492.589562,Malicious
10.0.2.15,41987,119.254.87.201,80,11,1582,6,705,5,877,1393.994414,0.913233,6175.860925,7682.595789,Malicious
10.0.2.15,40704,119.254.87.201,80,13,1730,8,853,5,877,1419.556913,10.247521,665.9171521,684.6533908,Malicious
10.0.2.15,59649,119.254.87.201,80,11,1582,6,705,5,877,1421.93241,4.319929,1305.577013,1624.100766,Malicious
10.0.2.15,56463,119.254.87.201,80,13,1727,8,853,5,874,1423.906993,9.910551,688.5590922,705.5107229,Malicious
10.0.2.15,49817,119.254.87.201,80,11,1593,6,705,5,888,1449.588283,0.82264,6855.975883,8635.612175,Malicious
10.0.2.15,60845,119.254.87.201,80,11,1582,6,705,5,877,1451.98797,1.363969,4134.991338,5143.811919,Malicious
10.0.2.15,35435,119.254.87.201,80,11,1579,6,705,5,874,1453.934503,0.845501,6670.601218,8269.653141,Malicious
10.0.2.15,59570,119.254.87.201,80,11,1513,6,705,5,808,1479.576464,1.68815,3340.935343,3829.043628,Malicious
10.0.2.15,46144,119.254.87.201,80,11,1582,6,705,5,877,1482.039056,1.621653,3477.932702,4326.449617,Malicious
10.0.2.15,54009,119.254.87.201,80,11,1568,6,705,5,863,1483.968837,1.74283,3236.115972,3961.373169,Malicious
10.0.2.15,39241,119.254.87.201,80,11,1579,6,705,5,874,1509.650835,1.679409,3358.324268,4163.369376,Malicious
10.0.2.15,52256,119.254.87.201,80,11,1579,6,705,5,874,1512.042555,1.893898,2977.985087,3691.856689,Malicious
10.0.2.15,55996,119.254.87.201,80,11,1582,6,705,5,877,1513.972043,1.677355,3362.436693,4182.775858,Malicious
10.0.2.15,39089,119.254.87.201,80,12,1656,7,779,5,877,1539.645423,4.91458,1268.063599,1427.588929,Malicious
10.0.2.15,54201,119.254.87.201,80,11,1582,6,705,5,877,1542.081574,2.01449,2799.716057,3482.767351,Malicious
10.0.2.15,60185,119.254.87.201,80,12,1656,7,779,5,877,1544.029453,4.473658,1393.043456,1568.291541,Malicious
10.0.2.15,53246,119.254.87.201,80,11,1558,6,705,5,853,1569.70963,1.223095,4611.252601,5579.288608,Malicious
10.0.2.15,36785,119.254.87.201,80,11,1582,6,705,5,877,1572.195209,1.521574,3706.687943,4611.014647,Malicious
10.0.2.15,34723,119.254.87.201,80,11,1582,6,705,5,877,1574.088705,1.412081,3994.105154,4968.553504,Malicious
10.0.2.15,36535,119.254.87.201,80,11,1579,6,705,5,874,1599.737155,0.893289,6313.746167,7827.254114,Malicious
10.0.2.15,40904,119.254.87.201,80,12,1653,7,779,5,874,1602.134091,3.821456,1630.792033,1829.66911,Malicious
10.0.2.15,45073,119.254.87.201,80,11,1582,6,705,5,877,1604.11136,1.364115,4134.548773,5143.261382,Malicious
10.0.2.15,41821,119.254.87.201,80,11,1587,6,705,5,882,1629.759963,1.74614,3229.981559,4040.9131,Malicious
10.0.2.15,33677,119.254.87.201,80,11,1579,6,705,5,874,1632.154834,1.690229,3336.825957,4136.717569,Malicious
10.0.2.15,50304,119.254.87.201,80,11,1513,6,705,5,808,1634.245054,1.646047,3426.390619,3926.983859,Malicious
10.0.2.15,49554,119.254.87.201,80,11,1579,6,705,5,874,1659.817404,2.546316,2214.964678,2745.927842,Malicious
10.0.2.15,43737,119.254.87.201,80,11,1579,6,705,5,874,1662.165295,2.610571,2160.446891,2678.341252,Malicious
10.0.2.15,55046,119.254.87.201,80,11,1582,6,705,5,877,1664.17199,1.09387,5156.005741,6413.924872,Malicious
10.0.2.15,38036,119.254.87.201,80,11,1587,6,705,5,882,1689.859272,1.820123,3098.691682,3876.661083,Malicious
10.0.2.15,57235,119.254.87.201,80,11,1582,6,705,5,877,1692.191477,1.687013,3343.187041,4158.829837,Malicious
10.0.2.15,56326,119.254.87.201,80,11,1513,6,705,5,808,1694.194463,1.221078,4618.869556,5293.683123,Malicious
10.0.2.15,42633,119.254.87.201,80,12,1653,7,779,5,874,1719.890615,6.757665,922.2120363,1034.676919,Malicious
10.0.2.15,41351,119.254.87.201,80,11,1579,6,705,5,874,1722.191964,5.784263,975.0593982,1208.797041,Malicious
10.0.2.15,59717,119.254.87.201,80,11,1582,6,705,5,877,1724.262339,1.376916,4096.110438,5095.445183,Malicious
10.0.2.15,53503,119.254.87.201,80,11,1579,6,705,5,874,1749.917599,1.019257,5533.442498,6859.898926,Malicious
10.0.2.15,53685,119.254.87.201,80,11,1582,6,705,5,877,1752.33337,1.048439,5379.425985,6691.853317,Malicious
10.0.2.15,45979,119.254.87.201,80,11,1579,6,705,5,874,1754.29115,1.081702,5214.005336,6463.887466,Malicious
10.0.2.15,52665,119.254.87.201,80,11,1579,6,705,5,874,1779.977532,1.648011,3422.307254,4242.690128,Malicious
10.0.2.15,50605,119.254.87.201,80,11,1579,6,705,5,874,1782.275961,1.674659,3367.849813,4175.17835,Malicious
10.0.2.15,47762,119.254.87.201,80,11,1513,6,705,5,808,1784.32169,1.616986,3487.97083,3997.560894,Malicious
10.0.2.15,57571,119.254.87.201,80,11,1582,6,705,5,877,1810.000481,1.679675,3357.79243,4176.998527,Malicious
10.0.2.15,33520,119.254.87.201,80,11,1513,6,705,5,808,1812.328634,1.619687,3482.154268,3990.894537,Malicious
10.0.2.15,45681,119.254.87.201,80,11,1513,6,705,5,808,1814.382666,1.693669,3330.048551,3816.566283,Malicious
10.0.2.15,46222,119.254.87.201,80,11,1582,6,705,5,877,1840.201637,2.869314,1965.626627,2445.183762,Malicious
10.0.2.15,45797,119.254.87.201,80,11,1582,6,705,5,877,1842.334897,1.621115,3479.086925,4327.885437,Malicious
10.0.2.15,53889,119.254.87.201,80,11,1579,6,705,5,874,1844.399462,1.625483,3469.737918,4301.490695,Malicious
10.0.2.15,50270,119.254.87.201,80,11,1579,6,705,5,874,1870.092057,0.886564,6361.638866,7886.627474,Malicious
10.0.2.15,57803,119.254.87.201,80,11,1579,6,705,5,874,1872.356559,1.221038,4619.020866,5726.275513,Malicious
10.0.2.15,37133,119.254.87.201,80,11,1582,6,705,5,877,1874.426626,1.286004,4385.678427,5455.659547,Malicious
10.0.2.15,37040,119.254.87.201,80,11,1579,6,705,5,874,1900.136475,1.251816,4505.454476,5585.485407,Malicious
10.0.2.15,43870,119.254.87.201,80,12,1653,7,779,5,874,1902.366951,4.384472,1421.379815,1594.718817,Malicious
10.0.2.15,56257,119.254.87.201,80,5,340,4,276,1,64,1904.463529,13.748091,160.6041159,37.24153412,Malicious
10.0.2.15,53571,119.254.87.201,80,11,1582,6,705,5,877,1930.148036,0.827928,6812.186567,8474.166836,Malicious
10.0.2.15,36896,119.254.87.201,80,12,1653,7,779,5,874,1932.502456,3.908649,1594.412801,1788.853386,Malicious
10.0.2.15,44050,119.254.87.201,80,11,1513,6,705,5,808,1934.491931,1.224144,4607.301102,5280.424525,Malicious
10.0.2.15,45815,119.254.87.201,80,11,1579,6,705,5,874,1960.203541,1.823127,3093.58591,3835.168916,Malicious
10.0.2.15,50212,119.254.87.201,80,11,1582,6,705,5,877,1962.459663,1.907013,2957.504747,3679.052004,Malicious
10.0.2.15,47220,119.254.87.201,80,11,1582,6,705,5,877,1964.544904,1.821888,3095.689746,3850.950223,Malicious
10.0.2.15,40527,119.254.87.201,80,11,1579,6,705,5,874,1990.230974,1.890343,2983.585519,3698.799636,Malicious
10.0.2.15,59636,119.254.87.201,80,11,1582,6,705,5,877,1992.500684,1.825764,3089.117761,3842.77486,Malicious
10.0.2.15,42161,119.254.87.201,80,11,1582,6,705,5,877,1994.572163,1.907324,2957.022509,3678.452114,Malicious
10.0.2.15,53954,119.254.87.201,80,11,1513,6,705,5,808,2020.285212,1.830794,3080.63059,3530.708534,Malicious
10.0.2.15,43373,119.254.87.201,80,11,1513,6,705,5,808,2022.561037,1.857012,3037.137078,3480.860651,Malicious
10.0.2.15,55344,119.254.87.201,80,11,1582,6,705,5,877,2024.587824,1.826279,3088.246648,3841.69122,Malicious
10.0.2.15,54946,119.254.87.201,80,11,1513,6,705,5,808,2050.29006,2.02064,2791.194869,3198.98646,Malicious
10.0.2.15,43649,119.254.87.201,80,11,1579,6,705,5,874,2052.621222,1.978071,2851.26267,3534.756841,Malicious
10.0.2.15,40819,119.254.87.201,80,11,1582,6,705,5,877,2054.633417,2.093387,2694.198445,3351.506434,Malicious
10.0.2.15,38474,119.254.87.201,80,12,1653,7,779,5,874,2080.317952,4.520488,1378.612221,1546.735662,Malicious
10.0.2.15,42882,119.254.87.201,80,11,1582,6,705,5,877,2082.683421,1.033073,5459.439943,6791.388411,Malicious
10.0.2.15,44971,119.254.87.201,80,11,1582,6,705,5,877,2084.639459,1.023065,5512.846202,6857.824283,Malicious
10.0.2.15,54768,119.254.87.201,80,12,1653,7,779,5,874,2110.380502,6.161645,1011.418217,1134.761902,Malicious
10.0.2.15,56560,119.254.87.201,80,11,1579,6,705,5,874,2112.745407,1.463788,3853.016967,4776.647985,Malicious
10.0.2.15,60008,119.254.87.201,80,11,1513,6,705,5,808,2114.641419,1.701847,3314.046445,3798.22628,Malicious
10.0.2.15,55780,119.254.87.201,80,11,1582,6,705,5,877,2140.433402,1.827368,3086.406241,3839.401806,Malicious
10.0.2.15,42176,119.254.87.201,80,11,1582,6,705,5,877,2142.853483,1.791399,3148.37733,3916.492082,Malicious
10.0.2.15,49526,119.254.87.201,80,11,1513,6,705,5,808,2144.691,1.899868,2968.627294,3402.341636,Malicious
10.0.2.15,54944,119.254.87.201,80,11,1579,6,705,5,874,2170.457207,1.427238,3951.688506,4898.972701,Malicious
10.0.2.15,38860,119.254.87.201,80,11,1558,6,705,5,853,2172.797932,1.289731,4373.004913,5291.025803,Malicious
10.0.2.15,50085,119.254.87.201,80,11,1582,6,705,5,877,2174.723569,2.883095,1956.231064,2433.495948,Malicious
10.0.2.15,36613,119.254.87.201,80,11,1582,6,705,5,877,2200.516985,1.95729,2881.535184,3584.548023,Malicious
10.0.2.15,50453,119.254.87.201,80,11,1579,6,705,5,874,2202.858738,2.02253,2788.586572,3457.056261,Malicious
10.0.2.15,51739,119.254.87.201,80,11,1579,6,705,5,874,2204.748405,2.021914,2789.436148,3458.109494,Malicious
10.0.2.15,41801,119.254.87.201,80,11,1582,6,705,5,877,2230.574974,7.343096,768.0684006,955.4553011,Malicious
10.0.2.15,47458,119.254.87.201,80,11,1593,6,705,5,888,2232.890891,1.821072,3097.076887,3900.998972,Malicious
10.0.2.15,34204,119.254.87.201,80,11,1513,6,705,5,808,2234.752136,1.015779,5552.388856,6363.58893,Malicious
10.0.2.15,56421,119.254.87.201,80,11,1582,6,705,5,877,2260.587602,1.667982,3381.331453,4206.280404,Malicious
10.0.2.15,55298,119.254.87.201,80,11,1513,6,705,5,808,2262.893648,1.714941,3288.742878,3769.22588,Malicious
10.0.2.15,36878,119.254.87.201,80,11,1579,6,705,5,874,2264.786331,1.645351,3427.840017,4249.549184,Malicious
10.0.2.15,37297,119.254.87.201,80,11,1561,6,705,5,856,2290.615997,0.958305,5885.391394,7145.950402,Malicious
10.0.2.15,37958,119.254.87.201,80,11,1582,6,705,5,877,2292.948786,2.196588,2567.618507,3194.044582,Malicious
10.0.2.15,47107,119.254.87.201,80,11,1582,6,705,5,877,2294.808824,1.36156,4142.307353,5152.912835,Malicious
10.0.2.15,34604,119.254.87.201,80,11,1582,6,705,5,877,2320.691115,1.634872,3449.811361,4291.467467,Malicious
10.0.2.15,47105,119.254.87.201,80,11,1582,6,705,5,877,2322.974781,1.641221,3436.465899,4274.866091,Malicious
10.0.2.15,36459,119.254.87.201,80,11,1582,6,705,5,877,2324.867506,1.42248,3964.906361,4932.231033,Malicious
10.0.2.15,57375,119.254.87.201,80,11,1579,6,705,5,874,2350.690222,1.48646,3794.249425,4703.792904,Malicious
10.0.2.15,38641,119.254.87.201,80,11,1582,6,705,5,877,2353.017767,1.486886,3793.162354,4718.586361,Malicious
10.0.2.15,37335,119.254.87.201,80,11,1593,6,705,5,888,2354.87242,1.568343,3596.152117,4529.62139,Malicious
10.0.2.15,39391,119.254.87.201,80,11,1579,6,705,5,874,2380.738161,3.960286,1424.13957,1765.529055,Malicious
10.0.2.15,49854,119.254.87.201,80,11,1579,6,705,5,874,2383.067842,1.770606,3185.3501,3948.930479,Malicious
10.0.2.15,54597,119.254.87.201,80,11,1582,6,705,5,877,2384.874712,1.627806,3464.786344,4310.095921,Malicious
10.0.2.15,60524,119.254.87.201,80,11,1582,6,705,5,877,2410.779947,1.511032,3732.548351,4643.184261,Malicious
10.0.2.15,51324,119.254.87.201,80,11,1582,6,705,5,877,2413.127862,1.444172,3905.351994,4858.147091,Malicious
10.0.2.15,48082,119.254.87.201,80,11,1579,6,705,5,874,2414.889151,1.615927,3490.256676,4326.928135,Malicious
10.0.2.15,49568,119.254.87.201,80,12,1653,7,779,5,874,2440.95468,4.520122,1378.723849,1546.860903,Malicious
10.0.2.15,39040,119.254.87.201,80,10,981,6,725,4,256,2443.184769,180.368156,32.15645227,11.35455418,Malicious
10.0.2.15,42141,119.254.87.201,80,11,1579,6,705,5,874,2444.899346,1.122379,5025.040561,6229.624752,Malicious
10.0.2.15,58480,119.254.87.201,80,11,1579,6,705,5,874,2470.821179,2.02126,2790.3387,3459.228402,Malicious
10.0.2.15,51088,119.254.87.201,80,11,1579,6,705,5,874,2473.21704,1.221437,4617.511996,5724.404943,Malicious
10.0.2.15,53293,119.254.87.201,80,11,1582,6,705,5,877,2475.032741,1.288785,4376.214807,5443.887072,Malicious
10.0.2.15,53567,119.254.87.201,80,12,1587,7,779,5,808,2500.894773,4.394396,1418.169869,1470.964383,Malicious
10.0.2.15,42397,119.254.87.201,80,11,1579,6,705,5,874,2503.26497,1.564272,3605.511062,4469.810877,Malicious
10.0.2.15,40811,119.254.87.201,80,11,1513,6,705,5,808,2504.954127,0.971222,5807.117219,6655.532927,Malicious
10.0.2.15,59546,119.254.87.201,80,11,1579,6,705,5,874,2530.926561,2.73525,2061.968741,2556.256284,Malicious
10.0.2.15,57405,119.254.87.201,80,11,1579,6,705,5,874,2533.323236,0.885608,6368.506156,7895.140965,Malicious
10.0.2.15,36094,119.254.87.201,80,13,1717,8,853,5,864,2534.982337,321.721982,21.21086025,21.48438834,Malicious
10.0.2.15,54519,119.254.87.201,80,11,1582,6,705,5,877,2560.960141,1.085365,5196.408581,6464.184859,Malicious
10.0.2.15,60595,119.254.87.201,80,11,1582,6,705,5,877,2563.354771,0.960767,5870.309867,7302.498941,Malicious
10.0.2.15,33586,119.254.87.201,80,11,1582,6,705,5,877,2565.018881,0.956826,5894.488653,7332.576665,Malicious
10.0.2.15,55496,119.254.87.201,80,11,1582,6,705,5,877,2590.984662,0.832541,6774.441139,8427.212594,Malicious
10.0.2.15,47984,119.254.87.201,80,11,1582,6,705,5,877,2593.38706,0.889196,6342.80856,7890.27391,Malicious
10.0.2.15,55987,119.254.87.201,80,11,1582,6,705,5,877,2595.043115,2.217112,2543.849837,3164.477031,Malicious
10.0.2.15,57438,119.254.87.201,80,12,1656,7,779,5,877,2620.991106,6.774924,919.8627173,1035.583573,Malicious
10.0.2.15,36069,119.254.87.201,80,11,1579,6,705,5,874,2623.420288,1.359656,4148.108051,5142.477215,Malicious
10.0.2.15,40347,119.254.87.201,80,11,1579,6,705,5,874,2625.095745,1.39018,4057.028586,5029.564517,Malicious
10.0.2.15,47381,119.254.87.201,80,11,1513,6,705,5,808,2651.04521,1.430305,3943.214909,4519.31581,Malicious
10.0.2.15,53772,119.254.87.201,80,11,1579,6,705,5,874,2653.53963,1.45201,3884.270769,4815.393833,Malicious
10.0.2.15,60633,119.254.87.201,80,11,1579,6,705,5,874,2655.09769,1.546915,3645.966327,4519.963928,Malicious
10.0.2.15,34569,119.254.87.201,80,11,1579,6,705,5,874,2681.076059,1.417214,3979.638925,4933.623292,Malicious
10.0.2.15,43961,119.254.87.201,80,11,1579,6,705,5,874,2683.471085,1.561264,3612.457598,4478.422611,Malicious
10.0.2.15,60368,119.254.87.201,80,11,1579,6,705,5,874,2685.135899,1.418488,3976.064655,4929.19221,Malicious
10.0.2.15,42640,119.254.87.201,80,12,1587,7,779,5,808,2711.084056,4.480524,1390.908742,1442.6884,Malicious
10.0.2.15,48171,119.254.87.201,80,11,1582,6,705,5,877,2713.513797,0.967102,5831.856412,7254.663934,Malicious
10.0.2.15,49948,119.254.87.201,80,11,1582,6,705,5,877,2715.209099,0.950974,5930.761514,7377.699075,Malicious
10.0.2.15,47000,119.254.87.201,80,11,1582,6,705,5,877,2741.159497,2.356157,2393.728432,2977.730262,Malicious
10.0.2.15,34327,119.254.87.201,80,11,1513,6,705,5,808,2743.661771,1.175854,4796.513853,5497.281125,Malicious
10.0.2.15,36702,119.254.87.201,80,12,1653,7,779,5,874,2745.216608,249.696873,24.95826209,28.00195259,Malicious
10.0.2.15,50438,119.254.87.201,80,11,1579,6,705,5,874,2771.168791,1.619497,3482.562796,4317.389906,Malicious
10.0.2.15,50631,119.254.87.201,80,12,1656,7,779,5,877,2773.622998,4.613509,1350.815616,1520.751341,Malicious
10.0.2.15,59671,119.254.87.201,80,11,1582,6,705,5,877,2775.270154,1.74623,3229.815087,4017.798343,Malicious
10.0.2.15,36115,119.254.87.201,80,11,1513,6,705,5,808,2801.245159,0.942887,5981.628764,6855.540484,Malicious
10.0.2.15,53664,119.254.87.201,80,11,1582,6,705,5,877,2803.622928,0.838149,6729.113797,8370.826667,Malicious
10.0.2.15,34331,119.254.87.201,80,11,1560,6,705,5,855,2805.395232,1.27789,4413.525421,5352.573383,Malicious
10.0.2.15,51454,119.254.87.201,80,11,1579,6,705,5,874,2831.279513,1.576218,3578.185251,4435.934623,Malicious
10.0.2.15,46034,119.254.87.201,80,11,1579,6,705,5,874,2833.626054,1.422669,3964.379627,4914.706091,Malicious
10.0.2.15,53190,119.254.87.201,80,11,1579,6,705,5,874,2835.3573,1.635533,3448.417122,4275.058956,Malicious
10.0.2.15,37290,119.254.87.201,80,11,1579,6,705,5,874,2861.337285,0.827127,6818.783573,8453.357223,Malicious
10.0.2.15,58864,119.254.87.201,80,11,1579,6,705,5,874,2863.671901,0.944579,5970.914026,7402.239516,Malicious
10.0.2.15,35562,119.254.87.201,80,12,1656,7,779,5,877,2865.391095,6.854559,909.1759222,1023.552354,Malicious
10.0.2.15,32913,119.254.87.201,80,11,1582,6,705,5,877,2891.368472,1.884665,2992.574277,3722.677505,Malicious
10.0.2.15,35382,119.254.87.201,80,11,1579,6,705,5,874,2893.68729,1.79688,3138.773875,3891.189172,Malicious
10.0.2.15,41499,119.254.87.201,80,11,1579,6,705,5,874,2895.417506,1.886629,2989.458977,3706.081058,Malicious
10.0.2.15,55031,119.254.87.201,80,11,1579,6,705,5,874,2921.396586,1.620334,3480.763843,4315.159714,Malicious
10.0.2.15,42774,119.254.87.201,80,11,1582,6,705,5,877,2923.713674,1.72418,3271.120185,4069.180712,Malicious
10.0.2.15,33153,119.254.87.201,80,11,1579,6,705,5,874,2925.47948,1.614422,3493.510371,4330.961793,Malicious
10.0.2.15,36813,119.254.87.201,80,11,1582,6,705,5,877,2951.425951,0.886558,6361.68192,7913.751836,Malicious
10.0.2.15,38898,119.254.87.201,80,11,1534,6,705,5,829,2953.743573,0.822985,6853.101818,8058.470081,Malicious
10.0.2.15,41224,119.254.87.201,80,11,1582,6,705,5,877,2955.534201,2.707515,2083.090952,2591.30605,Malicious
10.0.2.15,38511,119.254.87.201,80,11,1582,6,705,5,877,2981.453015,1.829205,3083.306682,3835.546043,Malicious
10.0.2.15,44757,119.254.87.201,80,11,1513,6,705,5,808,2983.791689,1.877562,3003.895477,3442.762476,Malicious
10.0.2.15,60499,119.254.87.201,80,11,1579,6,705,5,874,2985.536068,1.827245,3086.614001,3826.525726,Malicious
10.0.2.15,48014,119.254.87.201,80,11,1593,6,705,5,888,3011.509381,1.678442,3360.259097,4232.496565,Malicious
10.0.2.15,55196,119.254.87.201,80,11,1579,6,705,5,874,3013.824514,1.66246,3392.562829,4205.815478,Malicious
10.0.2.15,49957,119.254.87.201,80,11,1582,6,705,5,877,3015.594297,1.774627,3178.132644,3953.50685,Malicious
10.0.2.15,41324,119.254.87.201,80,11,1579,6,705,5,874,3041.682335,1.718287,3282.338748,4069.168887,Malicious
10.0.2.15,35585,119.254.87.201,80,11,1579,6,705,5,874,3043.845327,1.751302,3220.46112,3992.458183,Malicious
10.0.2.15,45658,119.254.87.201,80,11,1579,6,705,5,874,3045.634616,1.716077,3286.565813,4074.409249,Malicious
10.0.2.15,46061,119.254.87.201,80,11,1579,6,705,5,874,3071.603132,0.897137,6286.665247,7793.681456,Malicious
10.0.2.15,35281,119.254.87.201,80,11,1579,6,705,5,874,3073.875475,0.823834,6846.039372,8487.146682,Malicious
10.0.2.15,45722,119.254.87.201,80,11,1579,6,705,5,874,3075.660908,1.420469,3970.519596,4922.31791,Malicious
10.0.2.15,50163,119.254.87.201,80,11,1579,6,705,5,874,3101.626008,1.764947,3195.56338,3961.592048,Malicious
10.0.2.15,49289,119.254.87.201,80,11,1582,6,705,5,877,3103.889554,1.755466,3212.822122,3996.659576,Malicious
10.0.2.15,55504,119.254.87.201,80,11,1582,6,705,5,877,3105.68526,1.695801,3325.861938,4137.2779,Malicious
10.0.2.15,43414,119.254.87.201,80,11,1579,6,705,5,874,3131.652076,1.357507,4154.674709,5150.618008,Malicious
10.0.2.15,37553,119.254.87.201,80,11,1582,6,705,5,877,3133.910506,1.286187,4385.054428,5454.88331,Malicious
10.0.2.15,40502,119.254.87.201,80,11,1579,6,705,5,874,3135.708131,1.286537,4383.861482,5434.74459,Malicious
10.0.2.15,48909,119.254.87.201,80,12,1653,7,779,5,874,3161.657749,3.891614,1601.392122,1796.683844,Malicious
10.0.2.15,56749,119.254.87.201,80,11,1587,6,705,5,882,3163.961329,128.340946,43.94544513,54.97855688,Malicious
10.0.2.15,38890,119.254.87.201,80,11,1582,6,705,5,877,3165.71929,276.657521,20.38621607,25.35987446,Malicious
10.0.2.15,46417,119.254.87.201,80,11,1579,6,705,5,874,3191.662898,1.467194,3844.072427,4765.559292,Malicious
10.0.2.15,60969,119.254.87.201,80,11,1579,6,705,5,874,3193.967037,1.349045,4180.735261,5182.925699,Malicious
10.0.2.15,44809,119.254.87.201,80,11,1579,6,705,5,874,3195.760708,0.824433,6841.065314,8480.980262,Malicious
10.0.2.15,49764,119.254.87.201,80,12,1653,7,779,5,874,3221.71582,3.849956,1618.719798,1816.124652,Malicious
10.0.2.15,54225,119.254.87.201,80,11,1579,6,705,5,874,3224.023033,1.409741,4000.734887,4959.776299,Malicious
10.0.2.15,55608,119.254.87.201,80,12,1653,7,779,5,874,3225.801601,4.558392,1367.148766,1533.874226,Malicious
10.0.2.15,48047,119.254.87.201,80,11,1593,6,705,5,888,3251.770455,0.825983,6828.2277,8600.661273,Malicious
10.0.2.15,47721,119.254.87.201,80,11,1579,6,705,5,874,3254.122573,2.42783,2323.062158,2879.938052,Malicious
10.0.2.15,59945,119.254.87.201,80,12,1653,7,779,5,874,3255.864636,3.896938,1599.204298,1794.229213,Malicious
10.0.2.15,59705,119.254.87.201,80,11,1582,6,705,5,877,3281.781964,1.628095,3464.171317,4309.330844,Malicious
10.0.2.15,56864,119.254.87.201,80,12,1587,7,779,5,808,3284.050276,4.625889,1347.200506,1397.353028,Malicious
10.0.2.15,40499,119.254.87.201,80,11,1582,6,705,5,877,3285.886865,1.751253,3220.551228,4006.274365,Malicious
10.0.2.15,59321,119.254.87.201,80,11,1579,6,705,5,874,3311.808441,1.767307,3191.296136,3956.301876,Malicious
10.0.2.15,54565,119.254.87.201,80,11,1582,6,705,5,877,3314.08294,1.861991,3029.015715,3768.00962,Malicious
10.0.2.15,58745,119.254.87.201,80,11,1582,6,705,5,877,3315.99544,3.578449,1576.101825,1960.625958,Malicious
10.0.2.15,50830,119.254.87.201,80,11,1582,6,705,5,877,3341.868931,1.354562,4163.707531,5179.534049,Malicious
10.0.2.15,52455,119.254.87.201,80,11,1582,6,705,5,877,3344.122951,0.819615,6881.279625,8560.11664,Malicious
10.0.2.15,40557,119.254.87.201,80,12,1656,7,779,5,877,3345.914342,5.669337,1099.246702,1237.534477,Malicious
10.0.2.15,42093,119.254.87.201,80,11,1513,6,705,5,808,3371.925714,0.830438,6791.596724,7783.844188,Malicious
10.0.2.15,59515,119.254.87.201,80,11,1582,6,705,5,877,3374.197921,1.288265,4377.981238,5446.084462,Malicious
10.0.2.15,34577,119.254.87.201,80,11,1513,6,705,5,808,3375.92061,0.824672,6839.08269,7838.26782,Malicious
10.0.2.15,42814,119.254.87.201,80,11,1582,6,705,5,877,3401.987559,1.689274,3338.71237,4153.263473,Malicious
10.0.2.15,40878,119.254.87.201,80,12,1587,7,779,5,808,3404.198831,4.711174,1322.81253,1372.057156,Malicious
10.0.2.15,43247,119.254.87.201,80,11,1513,6,705,5,808,3405.967981,1.684931,3347.31808,3836.358878,Malicious
10.0.2.15,52545,119.254.87.201,80,11,1579,6,705,5,874,3432.053577,1.622919,3475.219651,4308.286489,Malicious
10.0.2.15,37657,119.254.87.201,80,11,1582,6,705,5,877,3434.258962,1.739086,3243.082861,4034.303076,Malicious
10.0.2.15,41139,119.254.87.201,80,11,1582,6,705,5,877,3435.997359,1.630239,3459.615431,4303.663451,Malicious
10.0.2.15,47935,119.254.87.201,80,11,1554,6,705,5,849,3462.073976,1.755205,3213.299871,3869.633462,Malicious
10.0.2.15,35645,119.254.87.201,80,11,1579,6,705,5,874,3464.262878,1.753416,3216.578382,3987.644689,Malicious
10.0.2.15,49305,119.254.87.201,80,11,1579,6,705,5,874,3466.057925,1.888459,2986.562059,3702.489702,Malicious
10.0.2.15,58188,119.254.87.201,80,11,1579,6,705,5,874,3492.082916,1.679029,3359.084328,4164.311635,Malicious
10.0.2.15,55554,119.254.87.201,80,11,1582,6,705,5,877,3494.266584,1.780395,3167.836351,3940.698553,Malicious
10.0.2.15,49778,119.254.87.201,80,11,1579,6,705,5,874,3496.087518,1.750521,3221.897938,3994.239429,Malicious
10.0.2.15,55571,119.254.87.201,80,11,1534,6,705,5,829,3522.090799,1.746828,3228.709409,3796.595887,Malicious
10.0.2.15,55141,119.254.87.201,80,11,1582,6,705,5,877,3524.284964,1.623747,3473.447526,4320.870185,Malicious
10.0.2.15,44270,119.254.87.201,80,11,1582,6,705,5,877,3526.147222,3.07665,1833.162693,2280.402386,Malicious
10.0.2.15,60266,119.254.87.201,80,11,1579,6,705,5,874,3552.096898,1.305355,4320.663727,5356.397302,Malicious
10.0.2.15,36726,119.254.87.201,80,12,1656,7,779,5,877,3554.311785,3.98169,1565.164541,1762.065856,Malicious
10.0.2.15,44362,119.254.87.201,80,12,1656,7,779,5,877,3556.21064,315.630055,19.74463427,22.22855488,Malicious
10.0.2.15,48685,119.254.87.201,80,11,1579,6,705,5,874,3582.12014,1.876814,3005.092673,3725.462406,Malicious
10.0.2.15,53890,119.254.87.201,80,11,1579,6,705,5,874,3584.372371,1.645627,3427.265109,4248.836462,Malicious
10.0.2.15,41280,119.254.87.201,80,11,1554,6,705,5,849,3586.356369,1.783684,3161.995062,3807.849372,Malicious
10.0.2.15,33152,119.254.87.201,80,11,1582,6,705,5,877,3612.152833,1.881892,2996.983886,3728.162934,Malicious
10.0.2.15,51952,119.254.87.201,80,11,1582,6,705,5,877,3614.409003,1.826794,3087.376026,3840.608191,Malicious
10.0.2.15,54539,119.254.87.201,80,11,1593,6,705,5,888,3616.270088,1.879727,3000.435702,3779.272203,Malicious
10.0.2.15,52605,119.254.87.201,80,11,1582,6,705,5,877,3642.758314,1.803114,3127.922028,3891.046268,Malicious
10.0.2.15,56752,119.254.87.201,80,11,1582,6,705,5,877,3644.428285,1.815172,3107.143565,3865.19845,Malicious
10.0.2.15,41523,119.254.87.201,80,11,1579,6,705,5,874,3646.289655,1.815874,3105.942373,3850.487424,Malicious
10.0.2.15,59796,119.254.87.201,80,11,1560,6,705,5,855,3672.183177,3.183974,1771.371249,2148.258748,Malicious
10.0.2.15,48957,119.254.87.201,80,11,1579,6,705,5,874,3674.433099,1.551058,3636.227659,4507.890743,Malicious
10.0.2.15,42513,119.254.87.201,80,11,1582,6,705,5,877,3676.29393,1.488202,3789.808104,4714.413769,Malicious
10.0.2.15,55102,119.254.87.201,80,11,1559,6,705,5,854,3702.188145,1.775677,3176.253339,3847.546598,Malicious
10.0.2.15,32972,119.254.87.201,80,11,1579,6,705,5,874,3704.464761,1.76503,3195.413109,3961.405755,Malicious
10.0.2.15,36288,119.254.87.201,80,11,1582,6,705,5,877,3706.34336,1.751466,3220.159569,4005.787152,Malicious
10.0.2.15,55070,119.254.87.201,80,11,1582,6,705,5,877,3732.23927,1.745331,3231.478728,4019.867865,Malicious
10.0.2.15,39089,119.254.87.201,80,11,1582,6,705,5,877,3734.489081,1.695476,3326.499461,4138.070961,Malicious
10.0.2.15,53790,119.254.87.201,80,11,1579,6,705,5,874,3736.353513,1.744168,3233.633457,4008.788144,Malicious
10.0.2.15,58011,119.254.87.201,80,11,1582,6,705,5,877,3762.26693,0.827221,6818.00873,8481.409442,Malicious
10.0.2.15,53471,119.254.87.201,80,11,1579,6,705,5,874,3764.523739,1.552603,3632.609238,4503.404927,Malicious
10.0.2.15,53195,119.254.87.201,80,12,1587,7,779,5,808,3766.383393,4.325859,1440.638726,1494.269693,Malicious
10.0.2.15,52338,119.254.87.201,80,12,1653,7,779,5,874,3792.291573,3.83137,1626.572218,1824.934684,Malicious
10.0.2.15,42670,119.254.87.201,80,11,1582,6,705,5,877,3794.542833,1.375112,4101.484097,5102.129863,Malicious
10.0.2.15,41242,119.254.87.201,80,11,1569,6,705,5,864,3796.434065,0.965927,5838.950563,7155.820264,Malicious
10.0.2.15,54242,119.254.87.201,80,11,1582,6,705,5,877,3822.348948,1.224589,4605.626867,5729.269167,Malicious
10.0.2.15,41609,119.254.87.201,80,11,1579,6,705,5,874,3824.637303,1.190283,4738.368943,5874.233271,Malicious
10.0.2.15,50025,119.254.87.201,80,11,1582,6,705,5,877,3826.468722,1.353913,4165.703409,5182.016865,Malicious
10.0.2.15,52895,119.254.87.201,80,11,1513,6,705,5,808,3852.356111,1.29405,4358.409644,4995.170202,Malicious
10.0.2.15,56634,119.254.87.201,80,11,1513,6,705,5,808,3854.550915,1.477399,3817.519844,4375.256786,Malicious
10.0.2.15,60205,119.254.87.201,80,11,1582,6,705,5,877,3856.46929,1.217965,4630.674937,5760.428255,Malicious
10.0.2.15,54501,119.254.87.201,80,11,1579,6,705,5,874,3882.379044,165.315684,34.11654517,42.29483755,Malicious
10.0.2.15,34510,119.254.87.201,80,11,1582,6,705,5,877,3884.604092,4.539001,1242.564168,1545.714575,Malicious
10.0.2.15,46685,119.254.87.201,80,11,1513,6,705,5,808,3886.503571,0.895524,6297.988664,7218.120341,Malicious
10.0.2.15,35532,119.254.87.201,80,11,1544,6,705,5,839,3912.384766,1.431854,3938.949083,4687.628767,Malicious
10.0.2.15,48324,119.254.87.201,80,11,1513,6,705,5,808,3914.660506,1.490269,3784.551648,4337.47196,Malicious
10.0.2.15,57009,119.254.87.201,80,11,1582,6,705,5,877,3916.522332,4.602452,1225.433747,1524.404817,Malicious
10.0.2.15,52926,119.254.87.201,80,11,1582,6,705,5,877,3942.389842,1.754497,3214.596548,3998.866912,Malicious
10.0.2.15,42055,119.254.87.201,80,11,1579,6,705,5,874,3944.717502,4.922875,1145.67199,1420.308255,Malicious
10.0.2.15,51954,119.254.87.201,80,11,1579,6,705,5,874,3946.5639,1.708528,3301.087252,4092.411713,Malicious
10.0.2.15,45279,119.254.87.201,80,11,1582,6,705,5,877,3972.442377,1.09462,5152.473004,6409.530248,Malicious
10.0.2.15,46197,119.254.87.201,80,11,1579,6,705,5,874,3974.778919,1.035146,5448.506781,6754.602732,Malicious
10.0.2.15,60004,119.254.87.201,80,11,1582,6,705,5,877,3976.584684,1.222333,4614.127247,5739.843398,Malicious
10.0.2.15,49824,119.254.87.201,80,11,1579,6,705,5,874,4002.471511,1.794118,3143.605939,3897.179561,Malicious
10.0.2.15,58482,119.254.87.201,80,11,1552,6,705,5,847,4004.838058,1.756258,3211.373272,3858.203066,Malicious
10.0.2.15,49808,119.254.87.201,80,11,1579,6,705,5,874,4006.632411,1.494498,3773.842454,4678.49405,Malicious
10.0.2.15,42936,119.254.87.201,80,11,1579,6,705,5,874,4032.504105,1.4913,3781.935224,4688.526789,Malicious
10.0.2.15,59565,119.254.87.201,80,12,1653,7,779,5,874,4034.901997,4.054518,1537.050767,1724.495982,Malicious
10.0.2.15,43238,119.254.87.201,80,11,1579,6,705,5,874,4036.667731,1.302763,4329.260195,5367.054483,Malicious
10.0.2.15,36246,119.254.87.201,80,11,1579,6,705,5,874,4062.524325,0.831688,6781.389175,8406.998778,Malicious
10.0.2.15,57611,119.254.87.201,80,11,1579,6,705,5,874,4064.92164,0.888493,6347.827164,7869.504881,Malicious
10.0.2.15,49708,119.254.87.201,80,11,1579,6,705,5,874,4066.723991,1.358106,4152.842267,5148.3463,Malicious
10.0.2.15,44683,119.254.87.201,80,11,1582,6,705,5,877,4092.550005,1.888717,2986.154093,3714.690978,Malicious
10.0.2.15,37104,119.254.87.201,80,11,1582,6,705,5,877,4094.950622,1.799659,3133.927038,3898.51633,Malicious
10.0.2.15,44528,119.254.87.201,80,11,1582,6,705,5,877,4096.753091,1.878707,3002.064718,3734.483344,Malicious
10.0.2.15,44764,119.254.87.201,80,11,1579,6,705,5,874,4122.609388,1.699087,3319.429788,4115.151255,Malicious
10.0.2.15,41962,119.254.87.201,80,11,1513,6,705,5,808,4125.013805,1.864718,3024.586023,3466.475896,Malicious
10.0.2.15,52964,119.254.87.201,80,11,1582,6,705,5,877,4126.811711,1.849809,3048.963434,3792.824016,Malicious
10.0.2.15,59552,119.254.87.201,80,11,1579,6,705,5,874,4152.648152,1.906964,2957.580741,3666.561089,Malicious
10.0.2.15,41655,119.254.87.201,80,11,1582,6,705,5,877,4155.054646,1.810469,3115.214897,3875.238957,Malicious
10.0.2.15,36353,119.254.87.201,80,11,1582,6,705,5,877,4156.874533,1.896671,2973.631167,3699.112814,Malicious
10.0.2.15,55842,119.254.87.201,80,11,1582,6,705,5,877,4182.672273,0.82555,6831.809097,8498.576706,Malicious
10.0.2.15,46852,119.254.87.201,80,11,1579,6,705,5,874,4185.06792,1.295987,4351.895505,5395.115846,Malicious
10.0.2.15,50442,119.254.87.201,80,11,1582,6,705,5,877,4186.933975,1.508911,3737.795006,4649.71095,Malicious
10.0.2.15,46527,119.254.87.201,80,11,1558,6,705,5,853,4212.710393,0.888148,6350.292969,7683.404117,Malicious
10.0.2.15,33440,119.254.87.201,80,11,1579,6,705,5,874,4215.107381,0.852223,6617.986137,8204.425368,Malicious
10.0.2.15,54334,119.254.87.201,80,11,1579,6,705,5,874,4216.995741,2.62186,2151.144607,2666.809059,Malicious
10.0.2.15,37956,119.254.87.201,80,11,1582,6,705,5,877,4242.902983,0.855228,6594.732633,8203.66031,Malicious
10.0.2.15,55042,119.254.87.201,80,13,1661,8,853,5,808,4245.131737,10.849768,628.9535408,595.7731078,Malicious
10.0.2.15,54573,119.254.87.201,80,11,1569,6,705,5,864,4247.025799,0.959538,5877.828705,7203.466668,Malicious
10.0.2.15,60504,119.254.87.201,80,11,1582,6,705,5,877,4272.823639,1.958298,2880.051963,3582.702939,Malicious
10.0.2.15,37064,119.254.87.201,80,11,1579,6,705,5,874,4275.161216,1.817692,3102.835904,3846.636284,Malicious
10.0.2.15,40647,119.254.87.201,80,11,1579,6,705,5,874,4277.176716,1.794316,3143.259047,3896.749513,Malicious
10.0.2.15,39554,119.254.87.201,80,11,1579,6,705,5,874,4302.847688,1.21895,4626.933016,5736.084335,Malicious
10.0.2.15,58132,119.254.87.201,80,11,1579,6,705,5,874,4305.164672,1.228108,4592.429982,5693.31036,Malicious
10.0.2.15,50902,119.254.87.201,80,11,1513,6,705,5,808,4307.102117,1.225605,4601.808903,5274.12992,Malicious
10.0.2.15,46397,119.254.87.201,80,11,1582,6,705,5,877,4332.855021,1.018194,5539.219441,6890.631844,Malicious
10.0.2.15,41352,119.254.87.201,80,11,1582,6,705,5,877,4335.184195,1.163169,4848.822484,6031.797615,Malicious
10.0.2.15,55103,119.254.87.201,80,11,1582,6,705,5,877,4337.115785,1.015525,5553.777603,6908.741784,Malicious
10.0.2.15,35094,119.254.87.201,80,11,1579,6,705,5,874,4362.890384,2.080584,2710.777359,3360.59491,Malicious
10.0.2.15,58867,119.254.87.201,80,11,1559,6,705,5,854,4365.216791,1.988332,2836.548424,3436.045892,Malicious
10.0.2.15,39310,119.254.87.201,80,11,1579,6,705,5,874,4367.138533,2.086525,2703.058914,3351.026228,Malicious
10.0.2.15,58720,119.254.87.201,80,11,1582,6,705,5,877,4392.963132,1.223508,4609.696054,5734.33112,Malicious
10.0.2.15,59870,119.254.87.201,80,13,1661,8,853,5,808,4395.221637,9.833303,693.9682424,657.35796,Malicious
10.0.2.15,46607,119.254.87.201,80,11,1582,6,705,5,877,4397.198129,2.480599,2273.64439,2828.349121,Malicious
10.0.2.15,45496,119.254.87.201,80,11,1582,6,705,5,877,4422.969897,1.886422,2989.787015,3719.21023,Malicious
10.0.2.15,43978,119.254.87.201,80,11,1582,6,705,5,877,4425.228003,1.759369,3205.694769,3987.793351,Malicious
10.0.2.15,47749,119.254.87.201,80,11,1582,6,705,5,877,4427.320045,1.781433,3165.990526,3938.402399,Malicious
10.0.2.15,46385,119.254.87.201,80,11,1579,6,705,5,874,4452.975473,1.949634,2892.850658,3586.314149,Malicious
10.0.2.15,38991,119.254.87.201,80,11,1582,6,705,5,877,4455.238475,4.847649,1163.450572,1447.299505,Malicious
10.0.2.15,59308,119.254.87.201,80,11,1582,6,705,5,877,4457.228561,1.884553,2992.752127,3722.898746,Malicious
10.0.2.15,56493,119.254.87.201,80,11,1579,6,705,5,874,4482.990044,0.825718,6830.419102,8467.781979,Malicious
10.0.2.15,53658,119.254.87.201,80,11,1579,6,705,5,874,4485.251051,0.883738,6381.98199,7911.847176,Malicious
10.0.2.15,50211,119.254.87.201,80,11,1513,6,705,5,808,4487.309732,1.543106,3654.966023,4188.953967,Malicious
10.0.2.15,50169,119.254.87.201,80,11,1544,6,705,5,839,4513.048051,0.838374,6727.30786,8005.973468,Malicious
10.0.2.15,39731,119.254.87.201,80,11,1582,6,705,5,877,4515.248885,1.592606,3541.365535,4405.358262,Malicious
10.0.2.15,46098,119.254.87.201,80,11,1579,6,705,5,874,4517.347754,0.840804,6707.865329,8315.850067,Malicious
10.0.2.15,33824,119.254.87.201,80,11,1513,6,705,5,808,4543.111746,0.880414,6406.077141,7342.000468,Malicious
10.0.2.15,57141,119.254.87.201,80,11,1579,6,705,5,874,4545.299394,1.225743,4601.290809,5704.295272,Malicious
10.0.2.15,42761,119.254.87.201,80,11,1582,6,705,5,877,4547.367903,1.089342,5177.437389,6440.585234,Malicious
10.0.2.15,52098,119.254.87.201,80,11,1579,6,705,5,874,4573.133426,1.22143,4617.538459,5724.437749,Malicious
10.0.2.15,45119,119.254.87.201,80,11,1544,6,705,5,839,4575.329365,0.880502,6405.436898,7622.924196,Malicious
10.0.2.15,53192,119.254.87.201,80,11,1582,6,705,5,877,4577.398984,0.817951,6895.278568,8577.530928,Malicious
10.0.2.15,40621,119.254.87.201,80,11,1534,6,705,5,829,4603.171054,1.888404,2986.649043,3511.960364,Malicious
10.0.2.15,40935,119.254.87.201,80,11,1582,6,705,5,877,4605.366312,1.814206,3108.798009,3867.25653,Malicious
10.0.2.15,34955,119.254.87.201,80,11,1579,6,705,5,874,4607.42735,1.948369,2894.728873,3588.642603,Malicious
10.0.2.15,47068,119.254.87.201,80,11,1582,6,705,5,877,4633.231855,2.255399,2500.666179,3110.757786,Malicious
10.0.2.15,41028,119.254.87.201,80,11,1560,6,705,5,855,4635.420843,1.286346,4384.51241,5317.38739,Malicious
10.0.2.15,47200,119.254.87.201,80,11,1579,6,705,5,874,4637.428788,1.486561,3793.991636,4703.473319,Malicious
10.0.2.15,43495,119.254.87.201,80,11,1593,6,705,5,888,4663.255617,1.874253,3009.198865,3790.31006,Malicious
10.0.2.15,38960,119.254.87.201,80,11,1582,6,705,5,877,4665.445347,3.677591,1533.612628,1907.770603,Malicious
10.0.2.15,48438,119.254.87.201,80,11,1585,6,705,5,880,4667.449612,1.872392,3012.189755,3759.896432,Malicious
10.0.2.15,53920,119.254.87.201,80,11,1513,6,705,5,808,4693.259489,1.819069,3100.487117,3553.466086,Malicious
10.0.2.15,42267,119.254.87.201,80,11,1582,6,705,5,877,4695.451364,1.819317,3100.064475,3856.392261,Malicious
10.0.2.15,38279,119.254.87.201,80,11,1579,6,705,5,874,4697.452312,1.62738,3465.693323,4296.476545,Malicious
10.0.2.15,47292,119.254.87.201,80,11,1582,6,705,5,877,4723.260589,0.888715,6346.241483,7894.54437,Malicious
10.0.2.15,36116,119.254.87.201,80,11,1513,6,705,5,808,4725.454475,0.817876,6895.910872,7903.398559,Malicious
10.0.2.15,48122,119.254.87.201,80,11,1582,6,705,5,877,4727.513708,0.881705,6396.697308,7957.309985,Malicious
10.0.2.15,55782,119.254.87.201,80,11,1582,6,705,5,877,4753.31824,0.819747,6880.171565,8558.738245,Malicious
10.0.2.15,54320,119.254.87.201,80,11,1582,6,705,5,877,4755.505063,1.622022,3477.141494,4325.465376,Malicious
10.0.2.15,52197,119.254.87.201,80,11,1582,6,705,5,877,4757.574197,1.283861,4392.998931,5464.766046,Malicious
10.0.2.15,44258,119.254.87.201,80,12,1587,7,779,5,808,4783.343729,3.810019,1635.687381,1696.579466,Malicious
10.0.2.15,56085,119.254.87.201,80,11,1582,6,705,5,877,4785.56907,0.963668,5852.638045,7280.515696,Malicious
10.0.2.15,44528,119.254.87.201,80,11,1593,6,705,5,888,4787.600934,1.346836,4187.592253,5274.584285,Malicious
10.0.2.15,49770,119.254.87.201,80,11,1582,6,705,5,877,4813.346784,0.818592,6889.879207,8570.814276,Malicious
10.0.2.15,34709,119.254.87.201,80,11,1579,6,705,5,874,4815.695395,0.816163,6910.384323,8566.916167,Malicious
10.0.2.15,33471,119.254.87.201,80,11,1579,6,705,5,874,4817.606669,1.313789,4292.926794,5322.011373,Malicious
10.0.2.15,44792,119.254.87.201,80,11,1582,6,705,5,877,4843.516902,1.291158,4368.171827,5433.881833,Malicious
10.0.2.15,36797,119.254.87.201,80,11,1582,6,705,5,877,4845.649319,9.098884,619.8562373,771.0835746,Malicious
10.0.2.15,46019,119.254.87.201,80,11,1582,6,705,5,877,4847.625596,0.821599,6864.662688,8539.445642,Malicious
10.0.2.15,45404,119.254.87.201,80,11,1593,6,705,5,888,4873.401465,1.0924,5162.943977,6503.112413,Malicious
10.0.2.15,37333,119.254.87.201,80,11,1582,6,705,5,877,4875.654857,0.81897,6886.699146,8566.858371,Malicious
10.0.2.15,43338,119.254.87.201,80,11,1579,6,705,5,874,4877.654582,1.55929,3617.030828,4484.092119,Malicious
10.0.2.15,39199,119.254.87.201,80,11,1579,6,705,5,874,4903.430343,1.815128,3107.218885,3852.069937,Malicious
10.0.2.15,51253,119.254.87.201,80,11,1582,6,705,5,877,4905.686109,1.918519,2939.767602,3656.987499,Malicious
10.0.2.15,37398,119.254.87.201,80,11,1579,6,705,5,874,4907.715749,1.746791,3228.777799,4002.768505,Malicious
10.0.2.15,37588,119.254.87.201,80,11,1513,6,705,5,808,4933.460948,1.832111,3078.4161,3528.170509,Malicious
10.0.2.15,36714,119.254.87.201,80,11,1560,6,705,5,855,4935.738431,1.616723,3488.538234,4230.780412,Malicious
10.0.2.15,48652,119.254.87.201,80,11,1513,6,705,5,808,4937.722945,1.832244,3078.192642,3527.914404,Malicious
10.0.2.15,59995,119.254.87.201,80,11,1582,6,705,5,877,4963.490556,1.95425,2886.017654,3590.124089,Malicious
10.0.2.15,43738,119.254.87.201,80,11,1579,6,705,5,874,4965.761543,4.967358,1135.412426,1407.589306,Malicious
10.0.2.15,59277,119.254.87.201,80,11,1582,6,705,5,877,4967.800186,1.752741,3217.817122,4002.873214,Malicious
10.0.2.15,37735,119.254.87.201,80,11,1582,6,705,5,877,4993.52211,0.894435,6305.656644,7844.057981,Malicious
10.0.2.15,57543,119.254.87.201,80,11,1579,6,705,5,874,4995.79038,1.446145,3900.023857,4834.923192,Malicious
10.0.2.15,58873,119.254.87.201,80,13,1727,8,853,5,874,4997.809195,10.824574,630.4174187,645.93766,Malicious
10.0.2.15,51734,119.254.87.201,80,11,1579,6,705,5,874,5023.572497,0.955696,5901.458204,7316.134001,Malicious
10.0.2.15,52668,119.254.87.201,80,11,1569,6,705,5,864,5025.828276,1.286904,4382.61129,5371.030007,Malicious
10.0.2.15,40448,119.254.87.201,80,11,1582,6,705,5,877,5027.830453,1.213831,4646.44584,5780.04681,Malicious
10.0.2.15,40953,119.254.87.201,80,11,1582,6,705,5,877,5053.573058,1.768858,3188.49789,3966.400921,Malicious
10.0.2.15,53119,119.254.87.201,80,11,1579,6,705,5,874,5055.854522,1.220339,4621.666602,5729.555476,Malicious
10.0.2.15,52290,119.254.87.201,80,11,1582,6,705,5,877,5057.839404,1.48059,3809.292242,4738.651484,Malicious
10.0.2.15,50368,119.254.87.201,80,11,1569,6,705,5,864,5083.578667,1.452853,3882.016969,4757.53569,Malicious
10.0.2.15,53336,119.254.87.201,80,11,1582,6,705,5,877,5085.878883,1.477691,3816.765481,4747.947981,Malicious
10.0.2.15,35133,119.254.87.201,80,11,1582,6,705,5,877,5087.86763,1.417982,3977.483494,4947.87663,Malicious
10.0.2.15,37692,119.254.87.201,80,11,1513,6,705,5,808,5113.627065,1.747158,3228.099577,3699.722635,Malicious
10.0.2.15,60688,119.254.87.201,80,11,1579,6,705,5,874,5115.88056,1.837907,3068.708047,3804.327422,Malicious
10.0.2.15,40625,119.254.87.201,80,11,1561,6,705,5,856,5117.892956,1.874451,3008.881,3653.336364,Malicious
10.0.2.15,54191,119.254.87.201,80,11,1579,6,705,5,874,5143.658619,1.816367,3105.099355,3849.442321,Malicious
10.0.2.15,40281,119.254.87.201,80,13,1727,8,853,5,874,5145.915891,10.785335,632.7109914,648.2876981,Malicious
10.0.2.15,38825,119.254.87.201,80,12,1653,7,779,5,874,5147.952107,4.93397,1263.080238,1417.114413,Malicious
10.0.2.15,53178,119.254.87.201,80,11,1569,6,705,5,864,5173.719043,1.222625,4613.025253,5653.409672,Malicious
10.0.2.15,57651,119.254.87.201,80,11,1579,6,705,5,874,5175.992033,1.376693,4096.773936,5078.837475,Malicious
10.0.2.15,50447,119.254.87.201,80,11,1579,6,705,5,874,5178.108624,3.98411,1415.623565,1754.971625,Malicious
10.0.2.15,41414,119.254.87.201,80,11,1559,6,705,5,854,5203.721165,1.493213,3777.090074,4575.368685,Malicious
10.0.2.15,39455,119.254.87.201,80,11,1513,6,705,5,808,5205.996935,1.084409,5200.989663,5960.850565,Malicious
10.0.2.15,54999,119.254.87.201,80,11,1579,6,705,5,874,5208.061091,1.222289,4614.293346,5720.41473,Malicious
10.0.2.15,37378,119.254.87.201,80,12,1656,7,779,5,877,5233.748973,5.410132,1151.912744,1296.826029,Malicious
10.0.2.15,35502,119.254.87.201,80,12,1656,7,779,5,877,5236.051559,3.841589,1622.245378,1826.327595,Malicious
10.0.2.15,56273,119.254.87.201,80,11,1513,6,705,5,808,5238.121332,1.460772,3860.972143,4425.057435,Malicious
10.0.2.15,54792,119.254.87.201,80,11,1579,6,705,5,874,5263.752735,1.955955,2883.501921,3574.724367,Malicious
10.0.2.15,38211,119.254.87.201,80,11,1582,6,705,5,877,5266.085884,1.836957,3070.295059,3819.359952,Malicious
10.0.2.15,58154,119.254.87.201,80,11,1585,6,705,5,880,5268.255095,1.781676,3165.558721,3951.335709,Malicious
10.0.2.15,45251,119.254.87.201,80,11,1579,6,705,5,874,5293.776452,1.760006,3204.53453,3972.713729,Malicious
10.0.2.15,59572,119.254.87.201,80,11,1579,6,705,5,874,5296.111063,1.845452,3056.161851,3788.773699,Malicious
10.0.2.15,39633,119.254.87.201,80,11,1579,6,705,5,874,5298.192121,1.795344,3141.459241,3894.518265,Malicious
10.0.2.15,38834,119.254.87.201,80,11,1582,6,705,5,877,5323.837198,1.827952,3085.420186,3838.175182,Malicious
10.0.2.15,60381,119.254.87.201,80,11,1579,6,705,5,874,5326.171462,1.890645,2983.108939,3698.208812,Malicious
10.0.2.15,59770,119.254.87.201,80,11,1579,6,705,5,874,5328.240081,1.82207,3095.380529,3837.393734,Malicious
10.0.2.15,33510,119.254.87.201,80,11,1582,6,705,5,877,5353.858854,1.811915,3112.728798,3872.14632,Malicious
10.0.2.15,50357,119.254.87.201,80,11,1513,6,705,5,808,5356.174559,1.843327,3059.685015,3506.702826,Malicious
10.0.2.15,57133,119.254.87.201,80,12,1587,7,779,5,808,5358.253123,5.186811,1201.508981,1246.237814,Malicious
10.0.2.15,53807,119.254.87.201,80,11,1579,6,705,5,874,5383.864976,2.464578,2288.424225,2836.996841,Malicious
10.0.2.15,49386,119.254.87.201,80,11,1582,6,705,5,877,5386.196924,0.887611,6354.134863,7904.363511,Malicious
10.0.2.15,59722,119.254.87.201,80,12,1656,7,779,5,877,5388.327177,5.902564,1055.812355,1188.635989,Malicious
10.0.2.15,49041,119.254.87.201,80,11,1579,6,705,5,874,5413.869207,1.911922,2949.911137,3657.052955,Malicious
10.0.2.15,33845,119.254.87.201,80,11,1579,6,705,5,874,5416.228768,1.812408,3111.882093,3857.850992,Malicious
10.0.2.15,42074,119.254.87.201,80,11,1513,6,705,5,808,5418.356901,1.939416,2908.09192,3332.962088,Malicious
10.0.2.15,57900,119.254.87.201,80,11,1582,6,705,5,877,5444.071639,0.823262,6850.79598,8522.19585,Malicious
10.0.2.15,54480,119.254.87.201,80,11,1582,6,705,5,877,5446.261654,1.292281,4364.375859,5429.159757,Malicious
10.0.2.15,38480,119.254.87.201,80,11,1579,6,705,5,874,5448.392143,0.826866,6820.935919,8456.025523,Malicious
10.0.2.15,40179,119.254.87.201,80,11,1582,6,705,5,877,5473.950522,1.883062,2995.121775,3725.84652,Malicious
10.0.2.15,54783,119.254.87.201,80,11,1579,6,705,5,874,5476.283012,1.778637,3170.967432,3931.10005,Malicious
10.0.2.15,39689,119.254.87.201,80,11,1513,6,705,5,808,5478.443743,1.873967,3009.658121,3449.367038,Malicious
10.0.2.15,39975,119.254.87.201,80,11,1579,6,705,5,874,5503.947928,1.818356,3101.702857,3845.231627,Malicious
10.0.2.15,56803,119.254.87.201,80,11,1569,6,705,5,864,5506.345659,1.888672,2986.225242,3659.714339,Malicious
10.0.2.15,34986,119.254.87.201,80,12,1625,7,779,5,846,5508.475877,4.908578,1269.614133,1378.810727,Malicious
10.0.2.15,32945,119.254.87.201,80,11,1579,6,705,5,874,5533.954588,2.091386,2696.776205,3343.237451,Malicious
10.0.2.15,47024,119.254.87.201,80,11,1513,6,705,5,808,5536.350443,1.84451,3057.722647,3504.453757,Malicious
10.0.2.15,55126,119.254.87.201,80,11,1579,6,705,5,874,5538.504208,1.889804,2984.436481,3699.854588,Malicious
10.0.2.15,35046,119.254.87.201,80,11,1513,6,705,5,808,5564.004863,1.810732,3114.762428,3569.827009,Malicious
10.0.2.15,44759,119.254.87.201,80,11,1579,6,705,5,874,5566.381844,1.897879,2971.738451,3684.112633,Malicious
10.0.2.15,34907,119.254.87.201,80,12,1587,7,779,5,808,5568.513848,4.784011,1302.67259,1351.167462,Malicious
10.0.2.15,37356,119.254.87.201,80,11,1579,6,705,5,874,5594.00602,1.282266,4398.463345,5452.846757,Malicious
10.0.2.15,54662,119.254.87.201,80,11,1582,6,705,5,877,5596.398704,1.417607,3978.535659,4949.185494,Malicious
10.0.2.15,44923,119.254.87.201,80,11,1579,6,705,5,874,5598.532271,1.701192,3315.322433,4110.0593,Malicious
10.0.2.15,49473,119.254.87.201,80,11,1579,6,705,5,874,5624.033512,2.660471,2119.925382,2628.106076,Malicious
10.0.2.15,46829,119.254.87.201,80,11,1582,6,705,5,877,5626.429576,1.614441,3493.469257,4345.77665,Malicious
10.0.2.15,40200,119.254.87.201,80,11,1579,6,705,5,874,5628.559164,1.623982,3472.944897,4305.46644,Malicious
10.0.2.15,53898,119.254.87.201,80,11,1579,6,705,5,874,5654.038023,1.3527,4169.4389,5168.921416,Malicious
10.0.2.15,60974,119.254.87.201,80,12,1587,7,779,5,808,5656.432015,3.851841,1617.927635,1678.158574,Malicious
10.0.2.15,59393,119.254.87.201,80,12,1587,7,779,5,808,5658.597551,3.895355,1599.854185,1659.4123,Malicious
10.0.2.15,39091,119.254.87.201,80,11,1593,6,705,5,888,5684.059109,1.62531,3470.107241,4370.858482,Malicious
10.0.2.15,42458,119.254.87.201,80,11,1579,6,705,5,874,5686.456909,4.674568,1206.528603,1495.75319,Malicious
10.0.2.15,38306,119.254.87.201,80,11,1579,6,705,5,874,5688.62785,1.617613,3486.618864,4322.418279,Malicious
10.0.2.15,34416,119.254.87.201,80,11,1579,6,705,5,874,5714.064778,1.676442,3364.267896,4170.737789,Malicious
10.0.2.15,56945,119.254.87.201,80,11,1593,6,705,5,888,5716.518258,1.519931,3710.694762,4673.896381,Malicious
10.0.2.15,55878,119.254.87.201,80,11,1579,6,705,5,874,5718.677019,1.646178,3426.117953,4247.414314,Malicious
10.0.2.15,54409,119.254.87.201,80,11,1582,6,705,5,877,5744.127114,1.619701,3482.12417,4331.663684,Malicious
10.0.2.15,45125,119.254.87.201,80,11,1582,6,705,5,877,5746.520754,1.689121,3339.014789,4153.639674,Malicious
10.0.2.15,58160,119.254.87.201,80,11,1579,6,705,5,874,5748.713674,1.496169,3769.627629,4673.268862,Malicious
10.0.2.15,33463,119.254.87.201,80,11,1582,6,705,5,877,5774.142721,1.819922,3099.033915,3855.110274,Malicious
10.0.2.15,41907,119.254.87.201,80,11,1582,6,705,5,877,5776.527968,1.617599,3486.64904,4337.292493,Malicious
10.0.2.15,58900,119.254.87.201,80,11,1582,6,705,5,877,5778.712489,1.893143,2979.17273,3706.006361,Malicious
10.0.2.15,54046,119.254.87.201,80,11,1582,6,705,5,877,5804.175372,1.625821,3469.016577,4315.35821,Malicious
10.0.2.15,52410,119.254.87.201,80,11,1513,6,705,5,808,5806.573235,1.750976,3221.060711,3691.655397,Malicious
10.0.2.15,47478,119.254.87.201,80,11,1513,6,705,5,808,5808.766528,1.627687,3465.039654,3971.27949,Malicious
10.0.2.15,34390,119.254.87.201,80,11,1579,6,705,5,874,5834.203682,1.547213,3645.264097,4519.093363,Malicious
10.0.2.15,59267,119.254.87.201,80,11,1513,6,705,5,808,5836.588117,1.425844,3955.55194,4533.455273,Malicious
10.0.2.15,52916,119.254.87.201,80,11,1582,6,705,5,877,5838.788492,1.55842,3619.050064,4501.995611,Malicious
10.0.2.15,44236,119.254.87.201,80,11,1579,6,705,5,874,5864.212546,1.631131,3457.723506,4286.596233,Malicious
10.0.2.15,49753,119.254.87.201,80,11,1582,6,705,5,877,5866.609311,1.686368,3344.465739,4160.420501,Malicious
10.0.2.15,52588,119.254.87.201,80,11,1582,6,705,5,877,5868.798588,1.630084,3459.944396,4304.072674,Malicious
10.0.2.15,42448,119.254.87.201,80,11,1579,6,705,5,874,5894.22836,0.886916,6359.114054,7883.497423,Malicious
10.0.2.15,51140,119.254.87.201,80,11,1582,6,705,5,877,5896.617073,3.615223,1560.069738,1940.682497,Malicious
10.0.2.15,41174,119.254.87.201,80,11,1513,6,705,5,808,5898.800706,0.89064,6332.524926,7257.702326,Malicious
10.0.2.15,53881,119.254.87.201,80,11,1579,6,705,5,874,5924.240311,1.642569,3433.64571,4256.746596,Malicious
10.0.2.15,40376,119.254.87.201,80,11,1582,6,705,5,877,5926.657083,1.752872,3217.57664,4002.574061,Malicious
10.0.2.15,39521,119.254.87.201,80,11,1582,6,705,5,877,5928.85073,1.720823,3277.501521,4077.118913,Malicious
10.0.2.15,45978,119.254.87.201,80,11,1579,6,705,5,874,5954.267434,1.955195,2884.622761,3576.113891,Malicious
10.0.2.15,33789,119.254.87.201,80,11,1513,6,705,5,808,5956.665215,1.825502,3089.561118,3540.943806,Malicious
10.0.2.15,44151,119.254.87.201,80,11,1551,6,705,5,846,5958.858249,1.904437,2961.505159,3553.80619,Malicious
10.0.2.15,55937,119.254.87.201,80,11,1513,6,705,5,808,5984.304989,1.22534,4602.80412,5275.270537,Malicious
10.0.2.15,58849,119.254.87.201,80,11,1582,6,705,5,877,5986.699077,234.208835,24.08107277,29.95617138,Malicious
10.0.2.15,57255,119.254.87.201,80,11,1582,6,705,5,877,5988.876014,0.823421,6849.473113,8520.550241,Malicious
10.0.2.15,53763,119.254.87.201,80,11,1579,6,705,5,874,6014.345904,0.886118,6364.8408,7890.596963,Malicious
10.0.2.15,58037,119.254.87.201,80,11,1569,6,705,5,864,6016.74308,1.217037,4634.205862,5679.367184,Malicious
10.0.2.15,55260,119.254.87.201,80,11,1579,6,705,5,874,6018.93664,1.358587,4151.371977,5146.523557,Malicious
10.0.2.15,57925,119.254.87.201,80,11,1582,6,705,5,877,6044.523508,1.825156,3090.146815,3844.054974,Malicious
10.0.2.15,52431,119.254.87.201,80,11,1579,6,705,5,874,6046.78337,1.955351,2884.392623,3575.828585,Malicious
10.0.2.15,48391,119.254.87.201,80,11,1579,6,705,5,874,6048.974205,1.846549,3054.346243,3786.52286,Malicious
10.0.2.15,35365,119.254.87.201,80,11,1582,6,705,5,877,6074.436296,0.878142,6422.651462,7989.596216,Malicious
10.0.2.15,53114,119.254.87.201,80,11,1579,6,705,5,874,6076.815432,0.824041,6844.319639,8485.014702,Malicious
10.0.2.15,50989,119.254.87.201,80,11,1513,6,705,5,808,6079.003432,2.279583,2474.136717,2835.606337,Malicious
10.0.2.15,46550,119.254.87.201,80,11,1582,6,705,5,877,6104.472686,0.840462,6710.594887,8347.789668,Malicious
10.0.2.15,51624,119.254.87.201,80,12,1653,7,779,5,874,6106.81659,3.91081,1593.531775,1787.864918,Malicious
10.0.2.15,40815,119.254.87.201,80,11,1579,6,705,5,874,6109.0508,1.676455,3364.241808,4170.705447,Malicious
10.0.2.15,47064,119.254.87.201,80,11,1582,6,705,5,877,6134.523634,1.38518,4071.672996,5065.045698,Malicious
10.0.2.15,53325,119.254.87.201,80,11,1579,6,705,5,874,6136.890676,2.437202,2314.129071,2868.863557,Malicious
10.0.2.15,54965,119.254.87.201,80,11,1579,6,705,5,874,6139.163732,1.321098,4269.176094,5292.567243,Malicious
10.0.2.15,45079,119.254.87.201,80,11,1513,6,705,5,808,6164.560829,1.68662,3343.966039,3832.517105,Malicious
10.0.2.15,44291,119.254.87.201,80,11,1579,6,705,5,874,6166.891599,1.626,3468.634686,4300.123001,Malicious
10.0.2.15,35283,119.254.87.201,80,11,1587,6,705,5,882,6169.086475,1.68904,3339.174916,4177.520959,Malicious
10.0.2.15,51882,119.254.87.201,80,11,1579,6,705,5,874,6194.584773,1.813427,3110.133466,3855.68319,Malicious
10.0.2.15,57765,119.254.87.201,80,11,1582,6,705,5,877,6196.90142,1.824842,3090.678535,3844.716419,Malicious
10.0.2.15,51442,119.254.87.201,80,11,1582,6,705,5,877,6199.092013,1.817288,3103.525693,3860.697919,Malicious
10.0.2.15,58668,119.254.87.201,80,11,1579,6,705,5,874,6224.609008,0.893885,6309.536462,7822.035273,Malicious
10.0.2.15,46830,119.254.87.201,80,11,1579,6,705,5,874,6226.934491,1.502467,3753.826207,4653.679582,Malicious
10.0.2.15,34679,119.254.87.201,80,11,1582,6,705,5,877,6229.141776,1.35621,4158.647997,5173.240132,Malicious
10.0.2.15,58936,119.254.87.201,80,11,1513,6,705,5,808,6254.620727,1.491814,3780.63217,4332.979849,Malicious
10.0.2.15,51698,119.254.87.201,80,11,1579,6,705,5,874,6256.952434,0.883176,6386.043099,7916.881799,Malicious
10.0.2.15,50319,119.254.87.201,80,11,1579,6,705,5,874,6259.203347,1.220242,4622.03399,5730.010932,Malicious
10.0.2.15,45994,119.254.87.201,80,11,1579,6,705,5,874,6284.623051,4.306269,1309.718459,1623.679338,Malicious
10.0.2.15,53692,119.254.87.201,80,11,1579,6,705,5,874,6286.988185,0.859117,6564.879987,8138.588807,Malicious
10.0.2.15,57731,119.254.87.201,80,11,1579,6,705,5,874,6289.233693,0.881661,6397.01654,7930.485754,Malicious
10.0.2.15,46635,119.254.87.201,80,11,1554,6,705,5,849,6314.647409,1.810529,3115.111661,3751.389787,Malicious
10.0.2.15,41478,119.254.87.201,80,11,1579,6,705,5,874,6317.03645,1.895604,2975.304969,3688.534103,Malicious
10.0.2.15,40218,119.254.87.201,80,11,1582,6,705,5,877,6319.259853,1.815216,3107.06825,3865.104759,Malicious
10.0.2.15,48866,119.254.87.201,80,11,1579,6,705,5,874,6344.671675,2.09499,2692.136955,3337.486098,Malicious
10.0.2.15,49148,119.254.87.201,80,11,1513,6,705,5,808,6347.071026,2.017615,2795.379693,3203.782684,Malicious
10.0.2.15,46213,119.254.87.201,80,11,1513,6,705,5,808,6349.261061,2.085618,2704.234428,3099.32116,Malicious
10.0.2.15,48715,119.254.87.201,80,11,1579,6,705,5,874,6374.678256,2.355106,2394.796667,2968.868493,Malicious
10.0.2.15,60448,119.254.87.201,80,11,1582,6,705,5,877,6377.071649,0.890772,6331.586534,7876.314029,Malicious
10.0.2.15,53784,119.254.87.201,80,11,1579,6,705,5,874,6379.263925,1.227421,4595.000411,5696.496964,Malicious
10.0.2.15,48507,119.254.87.201,80,11,1579,6,705,5,874,6404.708483,2.086469,2703.131463,3351.116168,Malicious
10.0.2.15,46953,119.254.87.201,80,11,1582,6,705,5,877,6407.09973,2.024357,2786.069848,3465.791854,Malicious
10.0.2.15,45503,119.254.87.201,80,11,1579,6,705,5,874,6409.293737,2.142323,2632.656233,3263.746877,Malicious
10.0.2.15,38945,119.254.87.201,80,11,1551,6,705,5,846,6434.781058,2.042601,2761.185371,3313.422445,Malicious
10.0.2.15,49958,119.254.87.201,80,11,1582,6,705,5,877,6437.127679,2.091049,2697.210826,3355.253751,Malicious
10.0.2.15,42674,119.254.87.201,80,11,1582,6,705,5,877,6439.322213,2.013612,2800.936824,3484.28595,Malicious
10.0.2.15,52262,119.254.87.201,80,12,1653,7,779,5,874,6464.811148,4.229249,1473.547668,1653.248603,Malicious
10.0.2.15,38951,119.254.87.201,80,11,1582,6,705,5,877,6467.18617,0.965266,5842.94899,7268.462786,Malicious
10.0.2.15,55417,119.254.87.201,80,11,1582,6,705,5,877,6469.345718,1.348781,4181.553566,5201.73401,Malicious
10.0.2.15,47548,119.254.87.201,80,11,1534,6,705,5,829,6494.82135,2.020774,2791.009781,3281.910793,Malicious
10.0.2.15,56309,119.254.87.201,80,11,1513,6,705,5,808,6497.306697,2.054456,2745.252271,3146.331681,Malicious
10.0.2.15,38990,119.254.87.201,80,11,1582,6,705,5,877,6499.403695,2.087438,2701.876655,3361.057909,Malicious
10.0.2.15,56861,119.254.87.201,80,11,1582,6,705,5,877,6524.85312,2.017677,2795.293796,3477.266183,Malicious
10.0.2.15,44657,119.254.87.201,80,11,1582,6,705,5,877,6527.247244,2.153603,2618.86708,3257.796353,Malicious
10.0.2.15,36737,119.254.87.201,80,11,1513,6,705,5,808,6529.438165,2.112747,2669.510358,3059.523928,Malicious
10.0.2.15,50549,119.254.87.201,80,11,1513,6,705,5,808,6554.926065,1.942348,2903.702117,3327.930937,Malicious
10.0.2.15,59817,119.254.87.201,80,11,1579,6,705,5,874,6557.30504,1.952491,2888.617668,3581.066443,Malicious
10.0.2.15,52210,119.254.87.201,80,11,1587,6,705,5,882,6559.49682,2.111789,2670.721365,3341.242899,Malicious
10.0.2.15,56743,119.254.87.201,80,11,1513,6,705,5,808,6584.942113,4.211023,1339.342008,1535.018925,Malicious
10.0.2.15,59243,119.254.87.201,80,11,1579,6,705,5,874,6587.338523,1.019682,5531.136178,6857.039744,Malicious
10.0.2.15,41529,119.254.87.201,80,11,1579,6,705,5,874,6589.52468,1.427601,3950.683699,4897.727026,Malicious
10.0.2.15,33761,119.254.87.201,80,11,1585,6,705,5,880,6614.9523,1.148529,4910.629161,6129.579662,Malicious
10.0.2.15,36221,119.254.87.201,80,11,1582,6,705,5,877,6617.334779,1.34965,4178.861186,5198.384766,Malicious
10.0.2.15,50671,119.254.87.201,80,11,1513,6,705,5,808,6619.583841,1.359142,4149.676781,4755.941616,Malicious
10.0.2.15,57215,119.254.87.201,80,11,1582,6,705,5,877,6645.032769,1.951726,2889.749893,3594.766888,Malicious
10.0.2.15,57481,119.254.87.201,80,11,1513,6,705,5,808,6647.359447,1.962181,2874.35257,3294.293442,Malicious
10.0.2.15,48387,119.254.87.201,80,11,1582,6,705,5,877,6649.636454,1.945129,2899.550621,3606.958716,Malicious
10.0.2.15,43797,119.254.87.201,80,11,1582,6,705,5,877,6674.984864,2.155321,2616.779589,3255.199574,Malicious
10.0.2.15,35041,119.254.87.201,80,11,1587,6,705,5,882,6677.383829,2.021421,2790.116458,3490.613781,Malicious
10.0.2.15,34433,119.254.87.201,80,11,1579,6,705,5,874,6679.641779,2.082583,2708.175376,3357.36919,Malicious
10.0.2.15,52260,119.254.87.201,80,11,1513,6,705,5,808,6705.044644,0.831283,6784.693059,7775.931903,Malicious
10.0.2.15,59657,119.254.87.201,80,11,1579,6,705,5,874,6707.447101,0.90089,6260.475752,7761.213911,Malicious
10.0.2.15,54124,119.254.87.201,80,11,1579,6,705,5,874,6709.644921,1.228118,4592.392588,5693.264002,Malicious
10.0.2.15,56951,119.254.87.201,80,11,1579,6,705,5,874,6735.072312,1.295302,4354.196936,5397.968968,Malicious
10.0.2.15,51285,119.254.87.201,80,13,1727,8,853,5,874,6737.474871,9.882024,690.5467949,707.5473607,Malicious
10.0.2.15,52491,119.254.87.201,80,11,1579,6,705,5,874,6739.699334,1.054326,5349.389088,6631.724912,Malicious
10.0.2.15,50417,119.254.87.201,80,11,1579,6,705,5,874,6765.108804,2.142584,2632.335535,3263.349302,Malicious
10.0.2.15,35834,119.254.87.201,80,11,1582,6,705,5,877,6767.498092,3.565333,1581.899924,1967.838628,Malicious
10.0.2.15,38750,119.254.87.201,80,11,1513,6,705,5,808,6769.765776,1.364587,4133.118665,4736.964371,Malicious
10.0.2.15,34183,119.254.87.201,80,11,1582,6,705,5,877,6795.131014,1.351911,4171.872261,5189.690741,Malicious
10.0.2.15,49204,119.254.87.201,80,11,1582,6,705,5,877,6797.527952,0.826101,6827.252358,8492.908252,Malicious
10.0.2.15,50728,119.254.87.201,80,13,1727,8,853,5,874,6799.786126,10.403187,655.9528345,672.1017319,Malicious
10.0.2.15,43418,119.254.87.201,80,11,1587,6,705,5,882,6825.191611,0.857056,6580.666841,8232.834261,Malicious
10.0.2.15,49976,119.254.87.201,80,11,1582,6,705,5,877,6827.558315,1.294353,4357.389368,5420.468759,Malicious
10.0.2.15,35497,119.254.87.201,80,11,1579,6,705,5,874,6829.820062,0.817738,6897.074613,8550.415903,Malicious
10.0.2.15,49318,119.254.87.201,80,11,1513,6,705,5,808,6855.245356,0.885009,6372.816548,7303.880526,Malicious
10.0.2.15,48327,119.254.87.201,80,11,1579,6,705,5,874,6857.567549,2.146873,2627.076683,3256.829817,Malicious
10.0.2.15,50096,119.254.87.201,80,11,1579,6,705,5,874,6859.817137,1.353365,4167.390172,5166.381575,Malicious
10.0.2.15,57872,119.254.87.201,80,11,1582,6,705,5,877,6885.287818,2.087217,2702.162736,3361.413787,Malicious
10.0.2.15,41796,119.254.87.201,80,11,1579,6,705,5,874,6887.617747,2.160347,2610.691708,3236.517097,Malicious
10.0.2.15,57926,119.254.87.201,80,11,1582,6,705,5,877,6889.886095,2.153105,2619.472808,3258.549862,Malicious
10.0.2.15,48166,119.254.87.201,80,12,1659,7,779,5,880,6915.304546,4.220217,1476.701317,1668.160666,Malicious
10.0.2.15,54770,119.254.87.201,80,11,1513,6,705,5,808,6917.675259,1.368564,4121.107964,4723.198915,Malicious
10.0.2.15,39950,119.254.87.201,80,11,1513,6,705,5,808,6919.899068,1.352815,4169.084465,4778.184748,Malicious
10.0.2.15,59589,119.254.87.201,80,13,1730,8,853,5,877,6945.31571,9.871937,691.2523854,710.7014561,Malicious
10.0.2.15,39083,119.254.87.201,80,12,1653,7,779,5,874,6947.686465,3.863086,1613.218033,1809.95194,Malicious
10.0.2.15,41953,119.254.87.201,80,12,1634,7,779,5,855,6949.926758,4.50479,1383.416319,1518.383765,Malicious
10.0.2.15,39417,119.254.87.201,80,11,1582,6,705,5,877,6975.331938,1.42722,3951.738344,4915.850394,Malicious
10.0.2.15,58461,119.254.87.201,80,11,1513,6,705,5,808,6977.73333,1.82592,3088.853838,3540.133193,Malicious
10.0.2.15,33837,119.254.87.201,80,12,1653,7,779,5,874,6979.933187,13.479223,462.3411898,518.7242618,Malicious
10.0.2.15,42464,119.254.87.201,80,11,1582,6,705,5,877,7005.365681,2.148193,2625.462424,3266.000774,Malicious
10.0.2.15,36710,119.254.87.201,80,11,1582,6,705,5,877,7007.765445,5.027536,1121.821902,1395.514622,Malicious
10.0.2.15,41972,119.254.87.201,80,11,1579,6,705,5,874,7009.952752,2.150187,2623.027672,3251.810191,Malicious
10.0.2.15,58304,119.254.87.201,80,11,1582,6,705,5,877,7035.391107,0.842403,6695.132852,8328.555335,Malicious
10.0.2.15,35802,119.254.87.201,80,11,1513,6,705,5,808,7037.807239,0.876382,6435.549794,7375.779055,Malicious
10.0.2.15,43300,119.254.87.201,80,11,1579,6,705,5,874,7039.983502,1.289048,4375.321943,5424.157983,Malicious
10.0.2.15,60252,119.254.87.201,80,11,1582,6,705,5,877,7065.421911,0.827317,6817.217584,8480.425278,Malicious
10.0.2.15,35861,119.254.87.201,80,11,1579,6,705,5,874,7067.826399,1.476893,3818.827769,4734.263078,Malicious
10.0.2.15,43447,119.254.87.201,80,11,1582,6,705,5,877,7070.018776,1.422474,3964.923085,4932.251837,Malicious
10.0.2.15,56069,119.254.87.201,80,11,1582,6,705,5,877,7095.429395,0.891524,6326.245844,7869.670362,Malicious
10.0.2.15,35797,119.254.87.201,80,11,1579,6,705,5,874,7097.886181,0.827888,6812.515703,8445.586843,Malicious
10.0.2.15,35019,119.254.87.201,80,11,1579,6,705,5,874,7100.078514,1.0895,5176.686553,6417.622763,Malicious
10.0.2.15,54919,119.254.87.201,80,11,1513,6,705,5,808,7125.451585,2.155091,2617.058862,2999.409306,Malicious
10.0.2.15,49577,119.254.87.201,80,11,1579,6,705,5,874,7127.912631,2.027097,2782.303955,3449.267598,Malicious
10.0.2.15,34488,119.254.87.201,80,11,1582,6,705,5,877,7130.112844,1.975814,2854.519707,3550.941536,Malicious
10.0.2.15,40012,119.254.87.201,80,11,1582,6,705,5,877,7155.451294,1.877984,3003.220475,3735.921073,Malicious
10.0.2.15,59993,119.254.87.201,80,11,1582,6,705,5,877,7157.971672,1.821626,3096.134991,3851.504096,Malicious
10.0.2.15,45563,119.254.87.201,80,11,1558,6,705,5,853,7160.163526,1.955825,2883.693582,3489.064717,Malicious
10.0.2.15,51454,119.254.87.201,80,11,1513,6,705,5,808,7185.458166,0.81884,6887.792487,7894.094084,Malicious
10.0.2.15,41573,119.254.87.201,80,11,1582,6,705,5,877,7187.976998,1.025991,5497.124244,6838.266612,Malicious
10.0.2.15,42903,119.254.87.201,80,11,1582,6,705,5,877,7190.167876,1.430201,3943.501648,4905.604177,Malicious
10.0.2.15,35126,119.254.87.201,80,11,1579,6,705,5,874,7215.462943,2.078669,2713.274696,3363.6909,Malicious
10.0.2.15,59218,119.254.87.201,80,11,1582,6,705,5,877,7218.052433,1.960263,2877.164952,3579.111578,Malicious
10.0.2.15,37762,119.254.87.201,80,11,1513,6,705,5,808,7220.187472,2.080269,2711.187832,3107.290451,Malicious
10.0.2.15,56177,119.254.87.201,80,13,1661,8,853,5,808,7248.820461,10.20413,668.7488301,633.4689974,Malicious
10.0.2.15,34763,119.254.87.201,80,11,1579,6,705,5,874,7248.823386,0.834051,6762.176414,8383.180405,Malicious
10.0.2.15,33963,119.254.87.201,80,12,1625,7,779,5,846,7250.224118,4.156412,1499.37013,1628.327509,Malicious
10.0.2.15,55375,119.254.87.201,80,11,1579,6,705,5,874,7275.542507,1.413559,3989.928967,4946.380024,Malicious
10.0.2.15,41301,119.254.87.201,80,11,1579,6,705,5,874,7278.123044,0.825099,6835.543371,8474.134619,Malicious
10.0.2.15,47913,119.254.87.201,80,11,1568,6,705,5,863,7280.352697,2.317604,2433.54775,2978.938593,Malicious
10.0.2.15,49073,119.254.87.201,80,11,1593,6,705,5,888,7305.547611,1.819088,3100.454733,3905.253622,Malicious
10.0.2.15,38062,119.254.87.201,80,11,1579,6,705,5,874,7308.143884,1.820987,3097.221452,3839.675956,Malicious
10.0.2.15,59518,119.254.87.201,80,11,1579,6,705,5,874,7310.275343,2.093458,2694.107071,3339.928482,Malicious
10.0.2.15,55237,119.254.87.201,80,11,1579,6,705,5,874,7335.568875,1.441501,3912.588337,4850.499583,Malicious
10.0.2.15,50666,119.254.87.201,80,11,1582,6,705,5,877,7338.175402,2.664051,2117.076587,2633.583216,Malicious
10.0.2.15,46826,119.254.87.201,80,12,1656,7,779,5,877,7340.304295,8.367362,744.7986594,838.4960517,Malicious
10.0.2.15,33023,119.254.87.201,80,11,1582,6,705,5,877,7365.627137,1.740066,3241.256366,4032.030969,Malicious
10.0.2.15,40708,119.254.87.201,80,11,1579,6,705,5,874,7368.207205,2.935049,1921.603353,2382.243022,Malicious
10.0.2.15,60986,119.254.87.201,80,11,1582,6,705,5,877,7370.336967,1.898278,2971.11382,3695.981305,Malicious
10.0.2.15,58535,119.254.87.201,80,11,1579,6,705,5,874,7395.629759,1.62101,3479.312281,4313.360189,Malicious
10.0.2.15,36305,119.254.87.201,80,11,1569,6,705,5,864,7398.228268,1.676651,3363.848529,4122.503729,Malicious
10.0.2.15,47415,119.254.87.201,80,11,1513,6,705,5,808,7400.34049,1.647383,3423.611874,3923.799141,Malicious
10.0.2.15,44520,119.254.87.201,80,11,1582,6,705,5,877,7425.652887,1.09563,5147.723228,6403.621661,Malicious
10.0.2.15,35641,119.254.87.201,80,11,1582,6,705,5,877,7428.256026,1.015463,5554.116694,6909.163603,Malicious
10.0.2.15,53707,119.254.87.201,80,11,1568,6,705,5,863,7430.3857,1.524986,3698.394608,4527.254676,Malicious
10.0.2.15,41179,119.254.87.201,80,11,1582,6,705,5,877,7455.708996,2.21529,2545.942066,3167.079705,Malicious
10.0.2.15,52192,119.254.87.201,80,11,1579,6,705,5,874,7458.295528,3.749817,1504.073399,1864.624327,Malicious
10.0.2.15,60514,119.254.87.201,80,11,1579,6,705,5,874,7460.421996,2.021239,2790.36769,3459.264342,Malicious
10.0.2.15,51671,119.254.87.201,80,11,1579,6,705,5,874,7485.715597,0.888324,6349.034812,7871.002022,Malicious
10.0.2.15,54531,119.254.87.201,80,13,1727,8,853,5,874,7488.297658,11.103457,614.583368,629.7137909,Malicious
10.0.2.15,37477,119.254.87.201,80,11,1560,6,705,5,855,7490.460684,1.472394,3830.496457,4645.495703,Malicious
10.0.2.15,49621,119.254.87.201,80,11,1582,6,705,5,877,7515.767223,2.095327,2691.703968,3348.403376,Malicious
10.0.2.15,34659,119.254.87.201,80,11,1582,6,705,5,877,7518.372069,2.197592,2566.445455,3192.585339,Malicious
10.0.2.15,44015,119.254.87.201,80,11,1582,6,705,5,877,7520.502694,2.026025,2783.776113,3462.938513,Malicious
10.0.2.15,40467,119.254.87.201,80,11,1582,6,705,5,877,7545.797699,1.749709,3223.393147,4009.809631,Malicious
10.0.2.15,44749,119.254.87.201,80,12,1587,7,779,5,808,7548.381918,4.77446,1305.278503,1353.870385,Malicious
10.0.2.15,48046,119.254.87.201,80,11,1579,6,705,5,874,7550.543858,1.595546,3534.840111,4382.198946,Malicious
10.0.2.15,38666,119.254.87.201,80,11,1559,6,705,5,854,7575.828778,0.859216,6564.123573,7951.434796,Malicious
10.0.2.15,55719,119.254.87.201,80,12,1653,7,779,5,874,7578.442631,4.386472,1420.731741,1593.991709,Malicious
10.0.2.15,33688,119.254.87.201,80,12,1661,7,779,5,882,7580.541554,4.246698,1467.493097,1661.526202,Malicious
10.0.2.15,60350,119.254.87.201,80,11,1582,6,705,5,877,7605.879672,2.154027,2618.351581,3257.155087,Malicious
10.0.2.15,55616,119.254.87.201,80,11,1579,6,705,5,874,7608.473257,2.012423,2802.591702,3474.418649,Malicious
10.0.2.15,57168,119.254.87.201,80,11,1579,6,705,5,874,7610.687926,2.096804,2689.807917,3334.598751,Malicious
10.0.2.15,32814,119.254.87.201,80,11,1582,6,705,5,877,7635.919308,2.087006,2702.43593,3361.753632,Malicious
10.0.2.15,57626,119.254.87.201,80,11,1582,6,705,5,877,7638.521779,2.194656,2569.878833,3196.856364,Malicious
10.0.2.15,37642,119.254.87.201,80,11,1579,6,705,5,874,7640.649515,2.096904,2689.679642,3334.439726,Malicious
10.0.2.15,49613,119.254.87.201,80,11,1582,6,705,5,877,7665.949297,2.158703,2612.679929,3250.099713,Malicious
10.0.2.15,57735,119.254.87.201,80,11,1513,6,705,5,808,7668.550323,2.024826,2785.424525,3192.373073,Malicious
10.0.2.15,54303,119.254.87.201,80,11,1579,6,705,5,874,7670.68442,2.084743,2705.369439,3353.890623,Malicious
10.0.2.15,57966,119.254.87.201,80,11,1579,6,705,5,874,7695.973296,2.801408,2013.273325,2495.887782,Malicious
10.0.2.15,43475,119.254.87.201,80,11,1582,6,705,5,877,7698.576264,1.221458,4617.432609,5743.955175,Malicious
10.0.2.15,59720,119.254.87.201,80,11,1579,6,705,5,874,7700.709241,1.482539,3804.284407,4716.233435,Malicious
10.0.2.15,44191,119.254.87.201,80,11,1582,6,705,5,877,7726.030156,2.02122,2790.393921,3471.170877,Malicious
10.0.2.15,52703,119.254.87.201,80,11,1582,6,705,5,877,7728.633607,2.206906,2555.614059,3179.111389,Malicious
10.0.2.15,45512,119.254.87.201,80,11,1513,6,705,5,808,7730.707569,2.025936,2783.898405,3190.623988,Malicious
10.0.2.15,42437,119.254.87.201,80,11,1582,6,705,5,877,7756.036152,2.221991,2538.264106,3157.528541,Malicious
10.0.2.15,35297,119.254.87.201,80,11,1582,6,705,5,877,7758.636769,2.193418,2571.329313,3198.66072,Malicious
10.0.2.15,41032,119.254.87.201,80,11,1582,6,705,5,877,7760.762513,2.178754,2588.635523,3220.189154,Malicious
10.0.2.15,53968,119.254.87.201,80,11,1582,6,705,5,877,7786.092232,0.829666,6797.91627,8456.414991,Malicious
10.0.2.15,33523,119.254.87.201,80,12,1656,7,779,5,877,7788.681229,7.407704,841.2863149,947.1220772,Malicious
10.0.2.15,34002,119.254.87.201,80,12,1667,7,779,5,888,7790.779998,3.82996,1627.171041,1854.849659,Malicious
10.0.2.15,57404,119.254.87.201,80,11,1579,6,705,5,874,7816.114419,2.078042,2714.093363,3364.705814,Malicious
10.0.2.15,53966,119.254.87.201,80,11,1579,6,705,5,874,7818.698865,2.04675,2755.588128,3416.147551,Malicious
10.0.2.15,45754,119.254.87.201,80,11,1582,6,705,5,877,7820.874032,2.051618,2749.049774,3419.739932,Malicious
10.0.2.15,35525,119.254.87.201,80,11,1579,6,705,5,874,7846.115836,2.158322,2613.141135,3239.55369,Malicious
10.0.2.15,32913,119.254.87.201,80,11,1587,6,705,5,882,7848.707183,2.080063,2711.456336,3392.204948,Malicious
10.0.2.15,58165,119.254.87.201,80,11,1582,6,705,5,877,7850.972095,2.095338,2691.689837,3348.385797,Malicious
10.0.2.15,51161,119.254.87.201,80,12,1587,7,779,5,808,7876.144655,3.886305,1603.57975,1663.276557,Malicious
10.0.2.15,43781,119.254.87.201,80,11,1587,6,705,5,882,7878.721409,1.449539,3890.892208,4867.754507,Malicious
10.0.2.15,36769,119.254.87.201,80,11,1582,6,705,5,877,7880.880446,0.844551,6678.104697,8307.372793,Malicious
10.0.2.15,34368,119.254.87.201,80,11,1579,6,705,5,874,7906.205257,2.056269,2742.831799,3400.333322,Malicious
10.0.2.15,49858,119.254.87.201,80,11,1582,6,705,5,877,7908.765469,2.081158,2710.029705,3371.200072,Malicious
10.0.2.15,38380,119.254.87.201,80,11,1582,6,705,5,877,7910.887325,2.013318,2801.345838,3484.794752,Malicious
10.0.2.15,36322,119.254.87.201,80,11,1569,6,705,5,864,7936.240097,2.212131,2549.57776,3124.588914,Malicious
10.0.2.15,54186,119.254.87.201,80,11,1579,6,705,5,874,7938.822207,2.191133,2574.010797,3191.043173,Malicious
10.0.2.15,33970,119.254.87.201,80,11,1593,6,705,5,888,7940.946931,2.306514,2445.248544,3079.972634,Malicious
10.0.2.15,35010,119.254.87.201,80,11,1579,6,705,5,874,7966.268428,2.088593,2700.382506,3347.708242,Malicious
10.0.2.15,38058,119.254.87.201,80,11,1513,6,705,5,808,7968.848567,2.326591,2424.147605,2778.313851,Malicious
10.0.2.15,48381,119.254.87.201,80,11,1582,6,705,5,877,7970.968966,2.226272,2533.383163,3151.456785,Malicious
10.0.2.15,55683,119.254.87.201,80,11,1513,6,705,5,808,7996.269335,1.024886,5503.051071,6307.04293,Malicious
10.0.2.15,47729,119.254.87.201,80,13,1730,8,853,5,877,7998.931425,13.058555,522.5693042,537.2723092,Malicious
10.0.2.15,49964,119.254.87.201,80,11,1579,6,705,5,874,8000.969635,0.929142,6070.116301,7525.222194,Malicious
10.0.2.15,35499,119.254.87.201,80,11,1579,6,705,5,874,8026.31821,0.959232,5879.703763,7289.164665,Malicious
10.0.2.15,53760,119.254.87.201,80,12,1642,7,779,5,863,8028.967464,4.427012,1407.721506,1559.516893,Malicious
10.0.2.15,45328,119.254.87.201,80,11,1582,6,705,5,877,8031.005246,1.554127,3629.047047,4514.431575,Malicious
10.0.2.15,57512,119.254.87.201,80,11,1579,6,705,5,874,8056.351428,1.831621,3079.239646,3817.383618,Malicious
10.0.2.15,52489,119.254.87.201,80,12,1656,7,779,5,877,8059.022102,252.707735,24.66089928,27.76329739,Malicious
10.0.2.15,35519,119.254.87.201,80,11,1579,6,705,5,874,8061.061694,1.490449,3784.094592,4691.203792,Malicious
10.0.2.15,46939,119.254.87.201,80,11,1579,6,705,5,874,8086.385588,1.506044,3744.910507,4642.626643,Malicious
10.0.2.15,49222,119.254.87.201,80,11,1582,6,705,5,877,8089.057361,1.049426,5374.366558,6685.559534,Malicious
10.0.2.15,60860,119.254.87.201,80,11,1582,6,705,5,877,8091.067633,4.150182,1358.976546,1690.528271,Malicious
10.0.2.15,61000,119.254.87.201,80,11,1582,6,705,5,877,8116.436476,1.490963,3782.790049,4705.683508,Malicious
10.0.2.15,48184,119.254.87.201,80,11,1582,6,705,5,877,8119.103099,1.6244,3472.051219,4319.133218,Malicious
10.0.2.15,37148,119.254.87.201,80,11,1582,6,705,5,877,8121.094551,1.439,3919.388464,4875.608061,Malicious
10.0.2.15,39196,119.254.87.201,80,11,1579,6,705,5,874,8146.498899,2.08416,2706.126209,3354.828804,Malicious
10.0.2.15,55536,119.254.87.201,80,11,1579,6,705,5,874,8149.160727,2.05945,2738.595256,3395.081211,Malicious
10.0.2.15,33084,119.254.87.201,80,11,1558,6,705,5,853,8151.15325,2.168052,2601.413619,3147.525982,Malicious
10.0.2.15,54577,119.254.87.201,80,11,1579,6,705,5,874,8176.536679,2.01714,2796.037955,3466.293862,Malicious
10.0.2.15,57383,119.254.87.201,80,11,1552,6,705,5,847,8179.194006,2.073882,2719.537563,3267.302576,Malicious
10.0.2.15,38155,119.254.87.201,80,11,1579,6,705,5,874,8181.201505,2.015414,2798.432481,3469.262395,Malicious
10.0.2.15,37168,119.254.87.201,80,11,1579,6,705,5,874,8206.586913,1.355617,4160.467153,5157.798995,Malicious
10.0.2.15,59513,119.254.87.201,80,11,1513,6,705,5,808,8209.250312,1.491234,3782.102608,4334.665116,Malicious
10.0.2.15,58216,119.254.87.201,80,11,1579,6,705,5,874,8211.240745,1.695897,3325.67367,4122.891897,Malicious
10.0.2.15,52703,119.254.87.201,80,11,1582,6,705,5,877,8236.612428,2.023788,2786.853168,3466.766282,Malicious
10.0.2.15,46608,119.254.87.201,80,11,1579,6,705,5,874,8239.279105,2.191079,2574.074235,3191.121817,Malicious
10.0.2.15,56782,119.254.87.201,80,11,1579,6,705,5,874,8241.271232,2.023005,2787.931814,3456.244547,Malicious
10.0.2.15,47837,119.254.87.201,80,11,1579,6,705,5,874,8266.639769,2.083082,2707.526636,3356.564936,Malicious
10.0.2.15,52706,119.254.87.201,80,11,1579,6,705,5,874,8269.288919,1.894027,2977.78226,3691.605241,Malicious
10.0.2.15,41203,119.254.87.201,80,11,1579,6,705,5,874,8271.291714,1.951286,2890.40151,3583.2779,Malicious
10.0.2.15,45449,119.254.87.201,80,11,1579,6,705,5,874,8296.666614,2.016984,2796.254209,3466.561956,Malicious
10.0.2.15,54091,119.254.87.201,80,11,1582,6,705,5,877,8299.316462,2.070192,2724.384985,3389.057633,Malicious
10.0.2.15,56210,119.254.87.201,80,11,1579,6,705,5,874,8301.319375,2.016273,2797.240255,3467.784372,Malicious
10.0.2.15,38138,119.254.87.201,80,11,1579,6,705,5,874,8326.674198,1.025081,5502.004232,6820.924395,Malicious
10.0.2.15,59042,119.254.87.201,80,11,1579,6,705,5,874,8329.337467,0.823844,6845.956273,8487.043664,Malicious
10.0.2.15,54955,119.254.87.201,80,11,1534,6,705,5,829,8331.359955,1.223423,4610.016323,5420.856073,Malicious
10.0.2.15,40584,119.254.87.201,80,11,1513,6,705,5,808,8356.67456,1.425343,3956.942294,4535.048757,Malicious
10.0.2.15,54409,119.254.87.201,80,11,1582,6,705,5,877,8359.338698,1.483243,3802.478758,4730.175703,Malicious
10.0.2.15,36452,119.254.87.201,80,3,222,3,222,0,0,8361.38771,9.103366,195.0926723,0,Malicious
10.0.2.15,59163,119.254.87.201,80,11,1579,6,705,5,874,8386.67533,1.421265,3968.295849,4919.561095,Malicious
10.0.2.15,59243,119.254.87.201,80,11,1582,6,705,5,877,8389.396533,1.157162,4873.993443,6063.109573,Malicious
10.0.2.15,47224,119.254.87.201,80,11,1560,6,705,5,855,8391.38999,1.49275,3778.261598,4582.147044,Malicious
10.0.2.15,60304,119.254.87.201,80,11,1582,6,705,5,877,8416.776528,1.722298,3274.694623,4073.627212,Malicious
10.0.2.15,50274,119.254.87.201,80,11,1582,6,705,5,877,8419.40082,1.287586,4380.289938,5448.956419,Malicious
10.0.2.15,56602,119.254.87.201,80,11,1513,6,705,5,808,8421.462792,1.086629,5190.36396,5948.672454,Malicious
10.0.2.15,53213,119.254.87.201,80,11,1513,6,705,5,808,8446.696405,4.418272,1276.517154,1463.015405,Malicious
10.0.2.15,53966,119.254.87.201,80,11,1513,6,705,5,808,8449.430295,1.017797,5541.380059,6350.971756,Malicious
10.0.2.15,41375,119.254.87.201,80,13,1661,8,853,5,808,8451.632911,10.909393,625.5160118,592.5169256,Malicious
10.0.2.15,40607,119.254.87.201,80,11,1579,6,705,5,874,8476.699606,1.969122,2864.220703,3550.821127,Malicious
10.0.2.15,42334,119.254.87.201,80,11,1569,6,705,5,864,8479.431479,2.015355,2798.514406,3429.668718,Malicious
10.0.2.15,59160,119.254.87.201,80,11,1579,6,705,5,874,8481.495561,1.822234,3095.101946,3837.04837,Malicious
10.0.2.15,41232,119.254.87.201,80,11,1579,6,705,5,874,8506.720042,2.151375,2621.579223,3250.014526,Malicious
10.0.2.15,40546,119.254.87.201,80,11,1582,6,705,5,877,8509.440457,1.885962,2990.516246,3720.117372,Malicious
10.0.2.15,34407,119.254.87.201,80,11,1582,6,705,5,877,8511.500944,1.946562,2897.41606,3604.303382,Malicious
10.0.2.15,53477,119.254.87.201,80,11,1513,6,705,5,808,8536.722841,1.429261,3946.09522,4522.616933,Malicious
10.0.2.15,44304,119.254.87.201,80,11,1582,6,705,5,877,8539.454578,1.685533,3346.122562,4162.481541,Malicious
10.0.2.15,41359,119.254.87.201,80,11,1582,6,705,5,877,8541.518883,1.622344,3476.451357,4324.606865,Malicious
10.0.2.15,45301,119.254.87.201,80,11,1582,6,705,5,877,8566.776305,1.08546,5195.953789,6463.619111,Malicious
10.0.2.15,44339,119.254.87.201,80,11,1568,6,705,5,863,8569.484847,2.470059,2283.346268,2795.074935,Malicious
10.0.2.15,39852,119.254.87.201,80,12,1656,7,779,5,877,8571.55814,3.936812,1583.006758,1782.152666,Malicious
10.0.2.15,59451,119.254.87.201,80,11,1579,6,705,5,874,8596.779114,1.969391,2863.829478,3550.336119,Malicious
10.0.2.15,55501,119.254.87.201,80,11,1582,6,705,5,877,8599.514659,2.044365,2758.802856,3431.872489,Malicious
10.0.2.15,45703,119.254.87.201,80,11,1582,6,705,5,877,8601.579979,2.017569,2795.443427,3477.45232,Malicious
10.0.2.15,39600,119.254.87.201,80,11,1582,6,705,5,877,8626.807025,2.049111,2752.41312,3423.923838,Malicious
10.0.2.15,60850,119.254.87.201,80,11,1579,6,705,5,874,8629.569547,2.018731,2793.834344,3463.56201,Malicious
10.0.2.15,60762,119.254.87.201,80,11,1513,6,705,5,808,8631.635266,2.012015,2803.160016,3212.699707,Malicious
10.0.2.15,38358,119.254.87.201,80,12,1667,7,779,5,888,8656.843485,5.061472,1231.262368,1403.544265,Malicious
10.0.2.15,58030,119.254.87.201,80,11,1582,6,705,5,877,8659.624784,2.007631,2809.281188,3494.666101,Malicious
10.0.2.15,46486,119.254.87.201,80,11,1579,6,705,5,874,8661.640255,2.052843,2747.409325,3406.008156,Malicious
10.0.2.15,38469,119.254.87.201,80,11,1513,6,705,5,808,8686.864935,2.062671,2734.318755,3133.800785,Malicious
10.0.2.15,41440,119.254.87.201,80,11,1579,6,705,5,874,8689.632353,2.043763,2759.615474,3421.140318,Malicious
10.0.2.15,44498,119.254.87.201,80,11,1582,6,705,5,877,8691.695288,2.026396,2783.266449,3462.304505,Malicious
10.0.2.15,46552,119.254.87.201,80,11,1582,6,705,5,877,8716.923753,2.100522,2685.04686,3340.122122,Malicious
10.0.2.15,51861,119.254.87.201,80,11,1582,6,705,5,877,8719.659678,2.019693,2792.503613,3473.795275,Malicious
10.0.2.15,55904,119.254.87.201,80,11,1579,6,705,5,874,8721.723834,2.084476,2705.715969,3354.320222,Malicious
10.0.2.15,45635,119.254.87.201,80,11,1582,6,705,5,877,8746.96191,2.489168,2265.817333,2818.612484,Malicious
10.0.2.15,41033,119.254.87.201,80,11,1582,6,705,5,877,8749.688734,1.093181,5159.255421,6417.967381,Malicious
10.0.2.15,55688,119.254.87.201,80,11,1582,6,705,5,877,8751.756079,1.015873,5551.875087,6906.375108,Malicious
10.0.2.15,34296,119.254.87.201,80,11,1579,6,705,5,874,8776.966426,1.966259,2868.391194,3555.991352,Malicious
10.0.2.15,38886,119.254.87.201,80,11,1552,6,705,5,847,8779.713824,1.879903,3000.154795,3604.441293,Malicious
10.0.2.15,35737,119.254.87.201,80,11,1582,6,705,5,877,8781.76293,2.019831,2792.312822,3473.557936,Malicious
10.0.2.15,54345,119.254.87.201,80,11,1579,6,705,5,874,8806.991283,1.852061,3045.256069,3775.253623,Malicious
10.0.2.15,54936,119.254.87.201,80,11,1587,6,705,5,882,8809.748963,1.915443,2944.48856,3683.743134,Malicious
10.0.2.15,57925,119.254.87.201,80,11,1513,6,705,5,808,8811.77831,1.821237,3096.796298,3549.236041,Malicious
10.0.2.15,58429,119.254.87.201,80,11,1585,6,705,5,880,8837.05343,1.951623,2889.902404,3607.254065,Malicious
10.0.2.15,55912,119.254.87.201,80,11,1579,6,705,5,874,8839.781043,1.856065,3038.686684,3767.109449,Malicious
10.0.2.15,43289,119.254.87.201,80,11,1552,6,705,5,847,8841.81329,1.873771,3009.972937,3616.236989,Malicious
10.0.2.15,46235,119.254.87.201,80,11,1582,6,705,5,877,8867.10876,1.817983,3102.339241,3859.222006,Malicious
10.0.2.15,45294,119.254.87.201,80,11,1582,6,705,5,877,8869.835276,1.823512,3092.932758,3847.520609,Malicious
10.0.2.15,57802,119.254.87.201,80,11,1593,6,705,5,888,8871.837814,1.836007,3071.883713,3869.266294,Malicious
10.0.2.15,54857,119.254.87.201,80,11,1579,6,705,5,874,8897.141043,2.080344,2711.090089,3360.982607,Malicious
10.0.2.15,53981,119.254.87.201,80,11,1579,6,705,5,874,8899.86753,2.064984,2731.256029,3385.982652,Malicious
10.0.2.15,47790,119.254.87.201,80,11,1579,6,705,5,874,8901.865737,2.118724,2661.979569,3300.099494,Malicious
10.0.2.15,46521,119.254.87.201,80,11,1593,6,705,5,888,8927.187276,1.028815,5482.035157,6905.031517,Malicious
10.0.2.15,36143,119.254.87.201,80,11,1579,6,705,5,874,8929.922047,1.851135,3046.779408,3777.142132,Malicious
10.0.2.15,55976,119.254.87.201,80,11,1582,6,705,5,877,8931.87711,0.957074,5892.961255,7330.676625,Malicious
10.0.2.15,46739,119.254.87.201,80,11,1585,6,705,5,880,8957.192141,4.49569,1254.534899,1565.944271,Malicious
10.0.2.15,58064,119.254.87.201,80,11,1582,6,705,5,877,8959.97374,1.515115,3722.489712,4630.671599,Malicious
10.0.2.15,56550,119.254.87.201,80,11,1582,6,705,5,877,8961.928756,1.286054,4385.507918,5455.447438,Malicious
10.0.2.15,47888,119.254.87.201,80,11,1582,6,705,5,877,8987.220618,1.547855,3643.75216,4532.724318,Malicious
10.0.2.15,56762,119.254.87.201,80,11,1579,6,705,5,874,8990.009263,1.699287,3319.039103,4114.666916,Malicious
10.0.2.15,44372,119.254.87.201,80,11,1513,6,705,5,808,8991.954344,1.816245,3105.307929,3558.991215,Malicious
10.0.2.15,41445,119.254.87.201,80,11,1582,6,705,5,877,9017.242856,2.092427,2695.434536,3353.044097,Malicious
10.0.2.15,34138,119.254.87.201,80,12,1587,7,779,5,808,9020.03793,5.126372,1215.674555,1260.930732,Malicious
10.0.2.15,38482,119.254.87.201,80,11,1582,6,705,5,877,9022.015753,2.062574,2734.447346,3401.574925,Malicious
10.0.2.15,50398,119.254.87.201,80,11,1579,6,705,5,874,9047.281538,1.816349,3105.130126,3849.480469,Malicious
10.0.2.15,51666,119.254.87.201,80,11,1593,6,705,5,888,9050.068783,1.962129,2874.428746,3620.557058,Malicious
10.0.2.15,45657,119.254.87.201,80,11,1579,6,705,5,874,9052.212553,1.957367,2881.421828,3572.145643,Malicious
10.0.2.15,41636,119.254.87.201,80,11,1587,6,705,5,882,9077.305155,1.889347,2985.158364,3734.623656,Malicious
10.0.2.15,52273,119.254.87.201,80,11,1513,6,705,5,808,9080.096422,1.835234,3073.177589,3522.166656,Malicious
10.0.2.15,49997,119.254.87.201,80,11,1579,6,705,5,874,9082.105576,1.95,2892.307692,3585.641026,Malicious
10.0.2.15,47502,119.254.87.201,80,11,1513,6,705,5,808,9107.315654,1.813549,3109.924242,3564.281969,Malicious
10.0.2.15,47256,119.254.87.201,80,11,1579,6,705,5,874,9110.098609,1.95765,2881.005287,3571.629249,Malicious
10.0.2.15,57109,119.254.87.201,80,11,1579,6,705,5,874,9112.165643,1.883644,2994.196356,3711.954064,Malicious
10.0.2.15,47296,119.254.87.201,80,11,1582,6,705,5,877,9137.388992,4.107906,1372.962283,1707.926131,Malicious
10.0.2.15,39907,119.254.87.201,80,11,1513,6,705,5,808,9140.155664,1.076317,5240.091906,6005.665617,Malicious
10.0.2.15,42151,119.254.87.201,80,11,1582,6,705,5,877,9142.199258,1.218696,4627.897359,5756.973027,Malicious
10.0.2.15,36758,119.254.87.201,80,11,1579,6,705,5,874,9167.448843,0.959857,5875.875261,7284.418408,Malicious
10.0.2.15,52482,119.254.87.201,80,11,1593,6,705,5,888,9170.179066,1.667567,3382.17295,4260.098695,Malicious
10.0.2.15,34231,119.254.87.201,80,11,1579,6,705,5,874,9172.224422,3.076369,1833.330137,2272.809276,Malicious
10.0.2.15,58280,119.254.87.201,80,11,1582,6,705,5,877,9197.454981,1.955356,2884.385247,3588.093421,Malicious
10.0.2.15,32979,119.254.87.201,80,12,1587,7,779,5,808,9200.180076,5.066329,1230.081978,1275.874504,Malicious
10.0.2.15,38685,119.254.87.201,80,11,1579,6,705,5,874,9202.225336,2.006045,2811.502234,3485.465181,Malicious
10.0.2.15,52843,119.254.87.201,80,12,1653,7,779,5,874,9227.458667,4.429306,1406.992427,1578.57687,Malicious
10.0.2.15,58691,119.254.87.201,80,11,1582,6,705,5,877,9230.212693,1.410368,3998.956301,4974.588193,Malicious
10.0.2.15,45040,119.254.87.201,80,11,1582,6,705,5,877,9232.256247,1.424859,3958.286399,4923.995988,Malicious
10.0.2.15,37351,119.254.87.201,80,11,1579,6,705,5,874,9257.480711,1.857933,3035.631532,3763.321928,Malicious
10.0.2.15,36805,119.254.87.201,80,11,1582,6,705,5,877,9260.243195,1.890513,2983.317227,3711.161997,Malicious
10.0.2.15,60797,119.254.87.201,80,12,1656,7,779,5,877,9262.309121,4.854774,1283.684884,1445.175409,Malicious
10.0.2.15,55756,119.254.87.201,80,11,1513,6,705,5,808,9287.533798,2.02971,2778.722083,3184.691409,Malicious
10.0.2.15,38888,119.254.87.201,80,11,1579,6,705,5,874,9290.268055,1.814357,3108.539279,3853.70685,Malicious
10.0.2.15,49154,119.254.87.201,80,11,1579,6,705,5,874,9292.318171,1.954352,2885.867029,3577.65643,Malicious
10.0.2.15,53440,119.254.87.201,80,11,1579,6,705,5,874,9317.540094,1.82095,3097.284385,3839.753975,Malicious
10.0.2.15,52032,119.254.87.201,80,11,1513,6,705,5,808,9320.327662,1.904444,2961.494273,3394.166486,Malicious
10.0.2.15,46522,119.254.87.201,80,11,1582,6,705,5,877,9322.339032,1.820095,3098.739352,3854.743846,Malicious
10.0.2.15,34856,119.254.87.201,80,11,1579,6,705,5,874,9347.547529,1.883204,2994.895933,3712.821341,Malicious
10.0.2.15,38014,119.254.87.201,80,11,1582,6,705,5,877,9350.332779,1.888993,2985.717787,3714.148226,Malicious
10.0.2.15,51343,119.254.87.201,80,11,1582,6,705,5,877,9352.397432,2.012394,2802.632089,3486.394811,Malicious
10.0.2.15,42258,119.254.87.201,80,11,1582,6,705,5,877,9377.620482,1.055969,5341.065884,6644.13444,Malicious
10.0.2.15,40271,119.254.87.201,80,11,1582,6,705,5,877,9380.382927,1.22452,4605.886388,5729.592003,Malicious
10.0.2.15,50592,119.254.87.201,80,11,1582,6,705,5,877,9382.453592,1.226965,4596.708138,5718.17452,Malicious
10.0.2.15,47236,119.254.87.201,80,11,1579,6,705,5,874,9407.623168,1.165005,4841.180939,6001.69098,Malicious
10.0.2.15,57630,119.254.87.201,80,11,1582,6,705,5,877,9410.418678,1.149409,4906.86953,6104.006494,Malicious
10.0.2.15,56151,119.254.87.201,80,11,1559,6,705,5,854,9412.480367,1.160781,4858.797654,5885.692478,Malicious
10.0.2.15,56339,119.254.87.201,80,11,1579,6,705,5,874,9437.637615,5.680309,992.9037311,1230.918952,Malicious
10.0.2.15,36924,119.254.87.201,80,11,1513,6,705,5,808,9440.47404,1.087856,5184.509715,5941.962907,Malicious
10.0.2.15,40635,119.254.87.201,80,11,1579,6,705,5,874,9442.543425,1.044483,5399.800667,6694.220969,Malicious
10.0.2.15,55816,119.254.87.201,80,11,1579,6,705,5,874,9467.68941,0.882111,6393.753167,7926.440097,Malicious
10.0.2.15,35804,119.254.87.201,80,11,1579,6,705,5,874,9470.536542,2.667636,2114.231477,2621.047249,Malicious
10.0.2.15,51786,119.254.87.201,80,11,1582,6,705,5,877,9472.571845,0.969701,5816.225826,7235.219929,Malicious
10.0.2.15,44333,119.254.87.201,80,11,1579,6,705,5,874,9497.740497,1.489733,3785.913315,4693.458492,Malicious
10.0.2.15,38969,119.254.87.201,80,11,1513,6,705,5,808,9500.595952,1.420264,3971.092698,4551.266525,Malicious
10.0.2.15,48876,119.254.87.201,80,11,1513,6,705,5,808,9502.581725,1.504552,3748.624175,4296.295509,Malicious
10.0.2.15,37202,119.254.87.201,80,11,1582,6,705,5,877,9527.801534,2.044404,2758.750227,3431.807021,Malicious
10.0.2.15,60434,119.254.87.201,80,11,1579,6,705,5,874,9530.620958,2.081035,2710.189881,3359.866605,Malicious
10.0.2.15,56670,119.254.87.201,80,11,1579,6,705,5,874,9532.634808,2.02525,2784.841378,3452.413282,Malicious
10.0.2.15,51917,119.254.87.201,80,12,1653,7,779,5,874,9557.802004,5.663614,1100.357475,1234.547411,Malicious
10.0.2.15,33011,119.254.87.201,80,11,1579,6,705,5,874,9560.631186,0.963494,5853.694989,7256.921164,Malicious
10.0.2.15,46087,119.254.87.201,80,11,1579,6,705,5,874,9562.656798,1.422909,3963.710961,4913.877135,Malicious
10.0.2.15,40835,119.254.87.201,80,11,1593,6,705,5,888,9587.852092,2.02015,2791.871891,3516.570552,Malicious
10.0.2.15,39137,119.254.87.201,80,11,1582,6,705,5,877,9590.738901,1.795422,3141.322764,3907.716403,Malicious
10.0.2.15,54650,119.254.87.201,80,11,1582,6,705,5,877,9592.714001,1.944357,2900.701877,3608.390846,Malicious
10.0.2.15,44868,119.254.87.201,80,11,1579,6,705,5,874,9617.856841,1.818163,3102.032106,3845.639802,Malicious
10.0.2.15,42225,119.254.87.201,80,11,1513,6,705,5,808,9620.649638,1.955432,2884.273143,3305.663403,Malicious
10.0.2.15,51289,119.254.87.201,80,11,1579,6,705,5,874,9622.716831,1.834295,3074.75079,3811.81871,Malicious
10.0.2.15,58242,119.254.87.201,80,11,1579,6,705,5,874,9647.865378,2.018324,2794.397728,3464.260446,Malicious
10.0.2.15,50558,119.254.87.201,80,11,1582,6,705,5,877,9650.653248,1.880452,2999.278897,3731.017862,Malicious
10.0.2.15,54746,119.254.87.201,80,11,1582,6,705,5,877,9652.912471,2.020358,2791.584462,3472.651877,Malicious
10.0.2.15,52441,119.254.87.201,80,11,1582,6,705,5,877,9677.924275,1.487051,3792.741473,4718.062797,Malicious
10.0.2.15,33906,119.254.87.201,80,11,1582,6,705,5,877,9680.709202,0.959247,5879.611821,7314.070307,Malicious
10.0.2.15,37708,119.254.87.201,80,11,1579,6,705,5,874,9682.839377,0.826124,6827.062281,8463.620473,Malicious
10.0.2.15,41180,119.254.87.201,80,11,1582,6,705,5,877,9707.949619,2.478464,2275.602954,2830.785519,Malicious
10.0.2.15,56276,119.254.87.201,80,12,1656,7,779,5,877,9710.734283,4.42891,1407.11823,1584.136955,Malicious
10.0.2.15,42714,119.254.87.201,80,11,1579,6,705,5,874,9712.89901,5.030277,1121.210621,1389.983096,Malicious
10.0.2.15,40654,119.254.87.201,80,11,1582,6,705,5,877,9738.009272,1.81751,3103.146613,3860.226354,Malicious
10.0.2.15,38794,119.254.87.201,80,11,1582,6,705,5,877,9740.736055,1.88278,2995.57038,3726.404572,Malicious
10.0.2.15,40922,119.254.87.201,80,11,1579,6,705,5,874,9742.928493,1.893315,2978.902084,3692.993506,Malicious
10.0.2.15,37742,119.254.87.201,80,11,1579,6,705,5,874,9768.069346,1.962193,2874.334992,3563.359975,Malicious
10.0.2.15,39588,119.254.87.201,80,11,1579,6,705,5,874,9770.737205,1.99828,2822.427287,3499.009148,Malicious
10.0.2.15,37042,119.254.87.201,80,11,1582,6,705,5,877,9772.981941,1.882619,2995.826559,3726.723251,Malicious
10.0.2.15,43479,119.254.87.201,80,11,1582,6,705,5,877,9798.130645,2.012438,2802.570812,3486.318585,Malicious
10.0.2.15,50943,119.254.87.201,80,11,1579,6,705,5,874,9800.785612,1.82854,3084.428014,3823.815722,Malicious
10.0.2.15,44480,119.254.87.201,80,11,1513,6,705,5,808,9802.987999,2.078255,2713.815196,3110.301671,Malicious
10.0.2.15,55800,119.254.87.201,80,3,222,3,222,0,0,9828.176518,9.049331,196.2576018,0,Malicious
10.0.2.15,53182,119.254.87.201,80,3,222,3,222,0,0,9830.800108,9.087798,195.426879,0,Malicious
10.0.2.15,55617,119.254.87.201,80,3,222,3,222,0,0,9833.036323,9.047638,196.2943257,0,Malicious
10.0.2.15,39991,119.254.87.201,80,11,1561,6,705,5,856,9858.211805,1.893681,2978.326339,3616.23737,Malicious
10.0.2.15,42046,119.254.87.201,80,11,1582,6,705,5,877,9860.814575,1.822024,3095.458677,3850.662779,Malicious
10.0.2.15,44197,119.254.87.201,80,11,1582,6,705,5,877,9863.076673,1.970084,2862.822093,3561.269469,Malicious
10.0.2.15,41534,119.254.87.201,80,11,1582,6,705,5,877,9888.243301,1.955952,2883.506344,3587.00009,Malicious
10.0.2.15,41668,119.254.87.201,80,11,1582,6,705,5,877,9890.923523,1.917778,2940.903483,3658.400503,Malicious
10.0.2.15,41100,119.254.87.201,80,11,1582,6,705,5,877,9893.092789,2.237493,2520.678277,3135.652268,Malicious
10.0.2.15,40576,119.254.87.201,80,11,1582,6,705,5,877,9918.273549,1.821338,3096.624569,3852.113117,Malicious
10.0.2.15,37910,119.254.87.201,80,11,1554,6,705,5,849,9920.873317,1.978689,2850.37214,3432.575812,Malicious
10.0.2.15,57542,119.254.87.201,80,11,1582,6,705,5,877,9923.095878,1.817172,3103.723808,3860.944369,Malicious
10.0.2.15,48169,119.254.87.201,80,11,1582,6,705,5,877,9948.424618,0.85303,6611.725262,8224.798659,Malicious
10.0.2.15,34240,119.254.87.201,80,12,1653,7,779,5,874,9950.911457,4.963279,1255.621536,1408.746113,Malicious
10.0.2.15,43071,119.254.87.201,80,11,1579,6,705,5,874,9953.149973,1.731838,3256.655646,4037.329127,Malicious
10.0.2.15,39285,119.254.87.201,80,11,1579,6,705,5,874,9978.353591,1.959714,2877.970969,3567.867556,Malicious
10.0.2.15,60396,119.254.87.201,80,11,1582,6,705,5,877,9980.959898,1.813465,3110.068295,3868.83673,Malicious
10.0.2.15,58381,119.254.87.201,80,11,1582,6,705,5,877,9983.154085,1.947259,2896.378961,3603.013261,Malicious
10.0.2.15,54721,119.254.87.201,80,11,1513,6,705,5,808,10008.35728,2.045663,2757.052359,3159.855753,Malicious
10.0.2.15,49152,119.254.87.201,80,11,1513,6,705,5,808,10010.96969,2.155365,2616.726169,2999.028007,Malicious
10.0.2.15,36003,119.254.87.201,80,11,1552,6,705,5,847,10013.16088,1.830138,3081.73482,3702.453039,Malicious
10.0.2.15,48643,119.254.87.201,80,11,1561,6,705,5,856,10038.38677,1.688875,3339.501147,4054.770187,Malicious
10.0.2.15,39437,119.254.87.201,80,11,1582,6,705,5,877,10040.98825,1.621507,3478.245854,4326.839169,Malicious
10.0.2.15,54433,119.254.87.201,80,11,1582,6,705,5,877,10043.18527,1.743562,3234.757353,4023.946381,Malicious
10.0.2.15,44555,119.254.87.201,80,11,1579,6,705,5,874,10068.4143,1.221984,4615.445047,5721.842512,Malicious
10.0.2.15,39746,119.254.87.201,80,11,1582,6,705,5,877,10071.002,1.086456,5191.190439,6457.693639,Malicious
10.0.2.15,38989,119.254.87.201,80,11,1582,6,705,5,877,10073.18711,1.052376,5359.301238,6666.818704,Malicious
10.0.2.15,60167,119.254.87.201,80,11,1587,6,705,5,882,10098.4446,1.481493,3806.970401,4762.76297,Malicious
10.0.2.15,56169,119.254.87.201,80,11,1582,6,705,5,877,10101.02661,1.415516,3984.412751,4956.49643,Malicious
10.0.2.15,51282,119.254.87.201,80,11,1582,6,705,5,877,10103.2166,1.085487,5195.824547,6463.458337,Malicious
10.0.2.15,48061,119.254.87.201,80,11,1582,6,705,5,877,10128.50381,1.816879,3104.224332,3861.567006,Malicious
10.0.2.15,41146,119.254.87.201,80,11,1513,6,705,5,808,10131.051,2.93976,1918.523961,2198.818951,Malicious
10.0.2.15,42140,119.254.87.201,80,11,1582,6,705,5,877,10133.2459,1.624947,3470.882435,4317.679284,Malicious
10.0.2.15,50523,119.254.87.201,80,11,1582,6,705,5,877,10158.56395,1.29949,4340.164218,5399.041162,Malicious
10.0.2.15,49958,119.254.87.201,80,13,1730,8,853,5,877,10161.1051,10.172623,670.8201022,689.6942903,Malicious
10.0.2.15,34719,119.254.87.201,80,11,1551,6,705,5,846,10163.27124,0.990245,5695.56019,6834.672228,Malicious
10.0.2.15,40430,119.254.87.201,80,11,1579,6,705,5,874,10188.5907,1.827563,3086.076923,3825.859902,Malicious
10.0.2.15,57135,119.254.87.201,80,11,1579,6,705,5,874,10191.11479,1.819416,3099.895791,3842.991377,Malicious
10.0.2.15,50970,119.254.87.201,80,11,1513,6,705,5,808,10193.30261,1.826567,3087.759715,3538.87922,Malicious
10.0.2.15,60075,119.254.87.201,80,11,1513,6,705,5,808,10218.59195,0.895871,6295.549248,7215.324528,Malicious
10.0.2.15,33942,119.254.87.201,80,12,1667,7,779,5,888,10221.11816,4.017791,1551.10109,1768.135774,Malicious
10.0.2.15,57742,119.254.87.201,80,11,1561,6,705,5,856,10223.35142,1.025417,5500.201381,6678.258699,Malicious
10.0.2.15,44280,119.254.87.201,80,11,1579,6,705,5,874,10248.60903,1.02947,5478.547214,6791.844347,Malicious
10.0.2.15,46833,119.254.87.201,80,12,1656,7,779,5,877,10251.13509,3.813607,1634.148458,1839.72811,Malicious
10.0.2.15,45102,119.254.87.201,80,11,1579,6,705,5,874,10253.5003,1.381307,4083.089422,5061.87256,Malicious
10.0.2.15,39162,119.254.87.201,80,11,1513,6,705,5,808,10278.61658,1.154541,4885.058218,5598.761759,Malicious
10.0.2.15,48926,119.254.87.201,80,11,1582,6,705,5,877,10281.13852,1.220748,4620.118157,5747.29592,Malicious
10.0.2.15,42914,119.254.87.201,80,12,1656,7,779,5,877,10283.49238,3.851043,1618.262897,1821.844108,Malicious
10.0.2.15,47415,119.254.87.201,80,11,1513,6,705,5,808,10308.67372,1.294202,4357.897762,4994.583535,Malicious
10.0.2.15,32866,119.254.87.201,80,11,1579,6,705,5,874,10311.2004,1.223498,4609.733731,5714.7621,Malicious
10.0.2.15,51850,119.254.87.201,80,11,1582,6,705,5,877,10313.45091,1.317182,4281.868413,5326.522834,Malicious
10.0.2.15,40510,119.254.87.201,80,11,1534,6,705,5,829,10338.70038,0.886218,6364.122597,7483.486005,Malicious
10.0.2.15,39073,119.254.87.201,80,11,1582,6,705,5,877,10341.22694,1.441797,3911.785085,4866.149673,Malicious
10.0.2.15,38592,119.254.87.201,80,11,1579,6,705,5,874,10343.50398,2.290679,2462.152052,3052.370061,Malicious
10.0.2.15,38593,119.254.87.201,80,11,1513,6,705,5,808,10368.72703,1.294298,4357.574531,4994.213079,Malicious
10.0.2.15,43038,119.254.87.201,80,10,981,6,725,4,256,10371.25426,180.37717,32.15484532,11.35398676,Malicious
10.0.2.15,42514,119.254.87.201,80,11,1579,6,705,5,874,10373.56042,0.848903,6643.868616,8236.512299,Malicious
10.0.2.15,60035,119.254.87.201,80,11,1513,6,705,5,808,10398.75872,0.820257,6875.893775,7880.456979,Malicious
10.0.2.15,50269,119.254.87.201,80,11,1585,6,705,5,880,10401.28168,1.285342,4387.937218,5477.141492,Malicious
10.0.2.15,36502,119.254.87.201,80,12,1653,7,779,5,874,10403.61478,4.261371,1462.44014,1640.786498,Malicious
10.0.2.15,55044,119.254.87.201,80,11,1568,6,705,5,863,10428.81852,1.412101,3994.048584,4889.168693,Malicious
10.0.2.15,53699,119.254.87.201,80,11,1582,6,705,5,877,10431.34009,0.956663,5895.492979,7333.826018,Malicious
10.0.2.15,47377,119.254.87.201,80,3,222,3,222,0,0,10433.65572,9.080082,195.5929473,0,Malicious
10.0.2.15,46514,119.254.87.201,80,11,1579,6,705,5,874,10458.87268,1.58469,3559.055714,4412.219425,Malicious
10.0.2.15,37318,119.254.87.201,80,11,1579,6,705,5,874,10461.36986,0.846527,6662.516376,8259.63023,Malicious
10.0.2.15,53785,119.254.87.201,80,11,1513,6,705,5,808,10463.81275,0.790727,7132.676638,8174.755636,Malicious
10.0.2.15,39110,119.254.87.201,80,11,1582,6,705,5,877,10488.88445,1.350599,4175.924904,5194.732115,Malicious
10.0.2.15,46653,119.254.87.201,80,11,1582,6,705,5,877,10491.40161,0.824501,6840.501103,8509.389315,Malicious
10.0.2.15,59700,119.254.87.201,80,11,1579,6,705,5,874,10493.73664,2.484475,2270.097304,2814.276658,Malicious
10.0.2.15,47988,119.254.87.201,80,11,1582,6,705,5,877,10518.90481,0.95394,5912.32153,7354.760257,Malicious
10.0.2.15,34034,119.254.87.201,80,11,1551,6,705,5,846,10521.42835,0.89446,6305.480402,7566.576482,Malicious
10.0.2.15,54589,119.254.87.201,80,11,1582,6,705,5,877,10523.76297,1.224898,4604.465025,5727.823868,Malicious
10.0.2.15,42595,119.254.87.201,80,11,1582,6,705,5,877,10548.90506,1.355368,4161.231488,5176.453922,Malicious
10.0.2.15,37428,119.254.87.201,80,11,1551,6,705,5,846,10551.43139,0.924076,6103.394093,7324.072912,Malicious
10.0.2.15,41854,119.254.87.201,80,11,1569,6,705,5,864,10553.79316,1.412315,3993.443389,4894.092324,Malicious
10.0.2.15,42491,119.254.87.201,80,13,1727,8,853,5,874,10578.93777,11.398526,598.6738987,613.4126465,Malicious
10.0.2.15,46106,119.254.87.201,80,11,1559,6,705,5,854,10581.431,1.221164,4618.544274,5594.662142,Malicious
10.0.2.15,54522,119.254.87.201,80,12,1656,7,779,5,877,10583.82507,3.946223,1579.231584,1777.902567,Malicious
10.0.2.15,38472,119.254.87.201,80,11,1582,6,705,5,877,10608.99339,0.948556,5945.879843,7396.505847,Malicious
10.0.2.15,56408,119.254.87.201,80,11,1579,6,705,5,874,10611.50851,0.831847,6780.092974,8405.391857,Malicious
10.0.2.15,50027,119.254.87.201,80,11,1579,6,705,5,874,10613.9334,1.24653,4524.560179,5609.171059,Malicious
10.0.2.15,55214,119.254.87.201,80,11,1559,6,705,5,854,10638.99371,2.655813,2123.643494,2572.470276,Malicious
10.0.2.15,54150,119.254.87.201,80,12,1656,7,779,5,877,10641.51701,6.926717,899.704723,1012.889656,Malicious
10.0.2.15,53448,119.254.87.201,80,11,1513,6,705,5,808,10643.88615,6.083408,927.1119083,1062.562301,Malicious
10.0.2.15,45449,119.254.87.201,80,11,1582,6,705,5,877,10668.9948,0.834372,6759.574866,8408.719372,Malicious
10.0.2.15,60593,119.254.87.201,80,11,1582,6,705,5,877,10671.53517,2.961139,1904.672493,2369.358548,Malicious
10.0.2.15,53841,119.254.87.201,80,11,1579,6,705,5,874,10673.94865,4.817683,1170.687237,1451.320064,Malicious
10.0.2.15,32803,119.254.87.201,80,11,1593,6,705,5,888,10699.05138,1.223424,4610.012555,5806.654112,Malicious
10.0.2.15,36955,119.254.87.201,80,11,1579,6,705,5,874,10701.57458,0.857367,6578.27978,8155.200748,Malicious
10.0.2.15,48670,119.254.87.201,80,11,1579,6,705,5,874,10704.0072,1.216813,4635.058961,5746.158202,Malicious
10.0.2.15,36280,119.254.87.201,80,11,1587,6,705,5,882,10729.08567,1.035893,5444.57777,6811.514317,Malicious
10.0.2.15,57849,119.254.87.201,80,11,1579,6,705,5,874,10731.57622,1.557396,3621.429617,4489.545369,Malicious
10.0.2.15,57201,119.254.87.201,80,11,1579,6,705,5,874,10734.03744,249.665887,22.59019071,28.00542791,Malicious
10.0.2.15,39193,119.254.87.201,80,11,1585,6,705,5,880,10759.11211,1.020085,5528.951019,6901.385669,Malicious
10.0.2.15,47142,119.254.87.201,80,11,1513,6,705,5,808,10761.63298,1.425371,3956.864564,4534.95967,Malicious
10.0.2.15,57688,119.254.87.201,80,11,1513,6,705,5,808,10764.09341,0.887963,6351.616002,7279.582595,Malicious
10.0.2.15,34496,119.254.87.201,80,11,1579,6,705,5,874,10789.17358,0.830414,6791.793009,8419.896582,Malicious
10.0.2.15,40068,119.254.87.201,80,13,1727,8,853,5,874,10791.6378,9.782406,697.5788983,714.7525875,Malicious
10.0.2.15,33517,119.254.87.201,80,11,1513,6,705,5,808,10794.14192,0.964147,5849.730383,6704.371844,Malicious
10.0.2.15,44872,119.254.87.201,80,11,1513,6,705,5,808,10819.20714,1.216524,4636.160076,5313.499775,Malicious
10.0.2.15,42597,119.254.87.201,80,11,1579,6,705,5,874,10821.65981,1.147806,4913.722354,6091.621755,Malicious
10.0.2.15,47507,119.254.87.201,80,11,1582,6,705,5,877,10824.27463,1.145177,4925.00286,6126.563841,Malicious
10.0.2.15,50922,119.254.87.201,80,11,1579,6,705,5,874,10849.22431,2.025971,2783.850312,3451.184642,Malicious
10.0.2.15,57830,119.254.87.201,80,12,1656,7,779,5,877,10851.68801,7.695498,809.8241335,911.7018808,Malicious
10.0.2.15,58187,119.254.87.201,80,11,1582,6,705,5,877,10854.32359,123.779692,45.56482496,56.68134964,Malicious
10.0.2.15,45331,119.254.87.201,80,11,1582,6,705,5,877,10879.26094,2.011119,2804.408889,3488.6051,Malicious
10.0.2.15,54394,119.254.87.201,80,11,1579,6,705,5,874,10881.71599,2.088119,2700.995489,3348.468167,Malicious
10.0.2.15,42877,119.254.87.201,80,11,1582,6,705,5,877,10884.24177,3.384377,1666.48101,2073.0551,Malicious
10.0.2.15,37714,119.254.87.201,80,11,1579,6,705,5,874,10909.29345,1.89121,2982.217734,3697.10397,Malicious
10.0.2.15,42906,119.254.87.201,80,12,1587,7,779,5,808,10911.76736,4.929514,1264.22199,1311.285453,Malicious
10.0.2.15,39047,119.254.87.201,80,11,1582,6,705,5,877,10914.26424,1.792594,3146.278522,3913.881225,Malicious
10.0.2.15,45388,119.254.87.201,80,11,1579,6,705,5,874,10939.30793,1.222502,4613.489385,5719.418046,Malicious
10.0.2.15,44733,119.254.87.201,80,11,1579,6,705,5,874,10941.76892,2.388505,2361.30969,2927.35414,Malicious
10.0.2.15,57957,119.254.87.201,80,12,1659,7,779,5,880,10944.26606,3.841563,1622.256358,1832.587413,Malicious
10.0.2.15,38239,119.254.87.201,80,11,1582,6,705,5,877,10969.33563,1.833449,3076.169558,3826.667663,Malicious
10.0.2.15,49704,119.254.87.201,80,11,1579,6,705,5,874,10971.80355,4.932645,1143.402779,1417.495076,Malicious
10.0.2.15,46439,119.254.87.201,80,11,1579,6,705,5,874,10974.31944,4.666808,1208.534827,1498.240339,Malicious
10.0.2.15,58054,119.254.87.201,80,11,1582,6,705,5,877,10999.37096,4.541943,1241.759309,1544.713353,Malicious
10.0.2.15,49687,119.254.87.201,80,11,1579,6,705,5,874,11001.807,1.352881,4168.881077,5168.229874,Malicious
10.0.2.15,51863,119.254.87.201,80,11,1582,6,705,5,877,11004.35084,1.31499,4289.006,5335.40179,Malicious
10.0.2.15,36284,119.254.87.201,80,11,1582,6,705,5,877,11029.37302,1.836591,3070.906914,3820.121083,Malicious
10.0.2.15,34740,119.254.87.201,80,11,1579,6,705,5,874,11031.8524,1.888076,2987.167889,3703.240759,Malicious
10.0.2.15,49490,119.254.87.201,80,11,1513,6,705,5,808,11034.38209,1.820466,3098.107847,3550.739206,Malicious
10.0.2.15,48664,119.254.87.201,80,11,1534,6,705,5,829,11059.40237,1.912854,2948.473851,3467.07067,Malicious
10.0.2.15,56274,119.254.87.201,80,11,1513,6,705,5,808,11061.88731,1.816955,3104.094488,3557.600491,Malicious
10.0.2.15,54736,119.254.87.201,80,11,1579,6,705,5,874,11064.41064,1.891594,2981.612333,3696.353446,Malicious
10.0.2.15,33019,119.254.87.201,80,11,1569,6,705,5,864,11089.46202,1.225769,4601.19321,5638.909126,Malicious
10.0.2.15,56470,119.254.87.201,80,11,1582,6,705,5,877,11091.922,1.282949,4396.121748,5468.650741,Malicious
10.0.2.15,49552,119.254.87.201,80,11,1579,6,705,5,874,11094.44453,0.954423,5909.329511,7325.892188,Malicious
10.0.2.15,50251,119.254.87.201,80,11,1552,6,705,5,847,11119.46243,3.75017,1503.931822,1806.851423,Malicious
10.0.2.15,40255,119.254.87.201,80,11,1579,6,705,5,874,11121.97238,1.71022,3297.821333,4088.362901,Malicious
10.0.2.15,60243,119.254.87.201,80,12,1656,7,779,5,877,11124.44697,4.601952,1354.207953,1524.570443,Malicious
10.0.2.15,54139,119.254.87.201,80,12,1656,7,779,5,877,11149.49075,3.955765,1575.4222,1773.613953,Malicious
10.0.2.15,59247,119.254.87.201,80,11,1569,6,705,5,864,11152.00276,1.443597,3906.907537,4788.039875,Malicious
10.0.2.15,36221,119.254.87.201,80,11,1582,6,705,5,877,11154.47807,1.587223,3553.375928,4420.298849,Malicious
10.0.2.15,36704,119.254.87.201,80,11,1579,6,705,5,874,11179.53801,1.326927,4250.422216,5269.317754,Malicious
10.0.2.15,48279,119.254.87.201,80,11,1513,6,705,5,808,11182.03813,1.479988,3810.84171,4367.602981,Malicious
10.0.2.15,60023,119.254.87.201,80,11,1587,6,705,5,882,11184.49357,1.489476,3786.566551,4737.236451,Malicious
10.0.2.15,49387,119.254.87.201,80,11,1513,6,705,5,808,11209.5726,2.487097,2267.704074,2599.014031,Malicious
10.0.2.15,46438,119.254.87.201,80,11,1569,6,705,5,864,11212.0974,1.424392,3959.584159,4852.596757,Malicious
10.0.2.15,43638,119.254.87.201,80,11,1579,6,705,5,874,11214.49409,1.539602,3663.284407,4541.433435,Malicious
10.0.2.15,49611,119.254.87.201,80,11,1513,6,705,5,808,11239.57373,1.612633,3497.385952,4008.351559,Malicious
10.0.2.15,44254,119.254.87.201,80,11,1579,6,705,5,874,11242.15767,2.656666,2122.961637,2631.870171,Malicious
10.0.2.15,36969,119.254.87.201,80,11,1582,6,705,5,877,11244.55005,0.989406,5700.389931,7091.123361,Malicious
10.0.2.15,37588,119.254.87.201,80,11,1582,6,705,5,877,11269.63156,1.909474,2953.693007,3674.310307,Malicious
10.0.2.15,60732,119.254.87.201,80,11,1582,6,705,5,877,11272.19061,1.749502,3223.774537,4010.284069,Malicious
10.0.2.15,32957,119.254.87.201,80,11,1582,6,705,5,877,11274.57918,1.713901,3290.738497,4093.585335,Malicious
10.0.2.15,43812,119.254.87.201,80,11,1513,6,705,5,808,11299.6897,0.828017,6811.454354,7806.603005,Malicious
10.0.2.15,55386,119.254.87.201,80,11,1513,6,705,5,808,11302.23462,0.879136,6415.389655,7352.673534,Malicious
10.0.2.15,58427,119.254.87.201,80,11,1579,6,705,5,874,11304.61511,1.222622,4613.036572,5718.856687,Malicious
10.0.2.15,53796,119.254.87.201,80,12,1653,7,779,5,874,11329.71607,6.91748,900.9061103,1010.772709,Malicious
10.0.2.15,60349,119.254.87.201,80,11,1582,6,705,5,877,11332.25023,1.227249,4595.644405,5716.851267,Malicious
10.0.2.15,53489,119.254.87.201,80,11,1582,6,705,5,877,11334.64437,1.154051,4887.132371,6079.454028,Malicious
10.0.2.15,59586,119.254.87.201,80,11,1579,6,705,5,874,11359.77367,0.826403,6824.757413,8460.76309,Malicious
10.0.2.15,53745,119.254.87.201,80,11,1513,6,705,5,808,11362.38774,1.384337,4074.152464,4669.38325,Malicious
10.0.2.15,42376,119.254.87.201,80,11,1585,6,705,5,880,11364.67491,1.441388,3912.895071,4884.181081,Malicious
10.0.2.15,45938,119.254.87.201,80,11,1582,6,705,5,877,11389.78803,1.622703,3475.682241,4323.650107,Malicious
10.0.2.15,43938,119.254.87.201,80,11,1551,6,705,5,846,11392.32183,1.701948,3313.849777,3976.619732,Malicious
10.0.2.15,55707,119.254.87.201,80,11,1579,6,705,5,874,11394.72719,1.650729,3416.67227,4235.704346,Malicious
10.0.2.15,58336,119.254.87.201,80,11,1579,6,705,5,874,11419.83894,1.7615,3201.816634,3969.344309,Malicious
10.0.2.15,42093,119.254.87.201,80,11,1579,6,705,5,874,11422.38041,1.616126,3489.826907,4326.395343,Malicious
10.0.2.15,57857,119.254.87.201,80,11,1582,6,705,5,877,11424.77964,1.54996,3638.803582,4526.568428,Malicious
10.0.2.15,39547,119.254.87.201,80,11,1558,6,705,5,853,11449.86742,1.427763,3950.235438,4779.504722,Malicious
10.0.2.15,55273,119.254.87.201,80,11,1568,6,705,5,863,11452.3893,1.49386,3775.454192,4621.584352,Malicious
10.0.2.15,55310,119.254.87.201,80,11,1513,6,705,5,808,11455.32811,1.41211,3994.023129,4577.547075,Malicious
10.0.2.15,50674,119.254.87.201,80,11,1534,6,705,5,829,11479.88669,1.955102,2884.759977,3392.150384,Malicious
10.0.2.15,57125,119.254.87.201,80,11,1558,6,705,5,853,11482.41642,4.297599,1312.360693,1587.863363,Malicious
10.0.2.15,46198,119.254.87.201,80,11,1582,6,705,5,877,11484.81259,1.101418,5120.671716,6369.970347,Malicious
10.0.2.15,50933,119.254.87.201,80,11,1582,6,705,5,877,11509.90384,1.639654,3439.750094,4278.951535,Malicious
10.0.2.15,38667,119.254.87.201,80,11,1579,6,705,5,874,11512.44664,1.702916,3311.966063,4105.898353,Malicious
10.0.2.15,48239,119.254.87.201,80,11,1579,6,705,5,874,11514.84893,1.623744,3473.453943,4306.097513,Malicious
10.0.2.15,57100,119.254.87.201,80,11,1579,6,705,5,874,11539.94574,4.52655,1245.982039,1544.664259,Malicious
10.0.2.15,34850,119.254.87.201,80,11,1579,6,705,5,874,11542.45224,1.440982,3913.997538,4852.246593,Malicious
10.0.2.15,46826,119.254.87.201,80,11,1513,6,705,5,808,11544.90727,1.553196,3631.222331,4161.741339,Malicious
10.0.2.15,56589,119.254.87.201,80,11,1579,6,705,5,874,11570.00874,1.627214,3466.046875,4296.91485,Malicious
10.0.2.15,56532,119.254.87.201,80,11,1579,6,705,5,874,11572.47084,1.652117,3413.801807,4232.145786,Malicious
10.0.2.15,37241,119.254.87.201,80,11,1579,6,705,5,874,11574.96243,1.419593,3972.969717,4925.355366,Malicious
10.0.2.15,44532,119.254.87.201,80,11,1582,6,705,5,877,11600.04414,1.506413,3743.993181,4657.421305,Malicious
10.0.2.15,54031,119.254.87.201,80,11,1582,6,705,5,877,11602.52682,1.487914,3790.541658,4715.326289,Malicious
10.0.2.15,49603,119.254.87.201,80,11,1513,6,705,5,808,11604.99117,1.614589,3493.14903,4003.495626,Malicious
10.0.2.15,44342,119.254.87.201,80,12,1653,7,779,5,874,11630.10021,13.481312,462.2695477,518.6438827,Malicious
10.0.2.15,51651,119.254.87.201,80,11,1582,6,705,5,877,11632.53045,8.381104,672.9423713,837.1212194,Malicious
10.0.2.15,48546,119.254.87.201,80,12,1656,7,779,5,877,11634.99591,4.382572,1421.996033,1600.88642,Malicious
10.0.2.15,55876,119.254.87.201,80,11,1582,6,705,5,877,11660.10403,1.530003,3686.267282,4585.611924,Malicious
10.0.2.15,57703,119.254.87.201,80,11,1582,6,705,5,877,11662.53457,3.891568,1449.28728,1802.872261,Malicious
10.0.2.15,38458,119.254.87.201,80,12,1587,7,779,5,808,11664.99671,6.972567,893.7884713,927.0617263,Malicious
10.0.2.15,56608,119.254.87.201,80,11,1582,6,705,5,877,11690.1202,2.595514,2172.979995,2703.12547,Malicious
10.0.2.15,44824,119.254.87.201,80,11,1579,6,705,5,874,11692.58335,0.975403,5782.225398,7168.319146,Malicious
10.0.2.15,46839,119.254.87.201,80,11,1582,6,705,5,877,11695.01191,1.447838,3895.463443,4845.846013,Malicious
10.0.2.15,33422,119.254.87.201,80,13,1741,8,853,5,888,11720.12902,10.577525,645.1414674,671.6126882,Malicious
10.0.2.15,52516,119.254.87.201,80,11,1579,6,705,5,874,11722.623,1.155457,4881.18554,6051.285336,Malicious
10.0.2.15,59422,119.254.87.201,80,11,1582,6,705,5,877,11725.01899,1.747644,3227.201879,4014.547585,Malicious
10.0.2.15,34847,119.254.87.201,80,11,1582,6,705,5,877,11750.15462,2.548875,2212.740915,2752.586926,Malicious
10.0.2.15,35304,119.254.87.201,80,11,1569,6,705,5,864,11752.72515,1.596935,3531.765538,4328.291383,Malicious
10.0.2.15,49907,119.254.87.201,80,11,1579,6,705,5,874,11755.0196,1.032617,5461.850812,6771.145546,Malicious
10.0.2.15,53528,119.254.87.201,80,11,1582,6,705,5,877,11780.18138,1.428407,3948.454467,4911.765344,Malicious
10.0.2.15,42148,119.254.87.201,80,11,1579,6,705,5,874,11782.64978,1.34397,4196.522244,5202.49708,Malicious
10.0.2.15,41325,119.254.87.201,80,11,1582,6,705,5,877,11785.03922,1.223585,4609.405967,5733.97026,Malicious
10.0.2.15,49633,119.254.87.201,80,11,1513,6,705,5,808,11810.1898,1.500682,3758.29123,4307.374914,Malicious
10.0.2.15,60771,119.254.87.201,80,11,1513,6,705,5,808,11812.65308,1.419368,3973.599518,4554.139589,Malicious
10.0.2.15,54544,119.254.87.201,80,11,1579,6,705,5,874,11815.04912,1.479382,3812.402747,4726.297873,Malicious
10.0.2.15,44061,119.254.87.201,80,11,1582,6,705,5,877,11840.25176,1.161316,4856.559283,6041.421973,Malicious
10.0.2.15,46751,119.254.87.201,80,12,1653,7,779,5,874,11842.71063,4.474621,1392.743654,1562.590441,Malicious
10.0.2.15,40046,119.254.87.201,80,11,1513,6,705,5,808,11845.07551,1.42368,3961.564396,4540.346145,Malicious
10.0.2.15,52785,119.254.87.201,80,11,1569,6,705,5,864,11870.27241,9.172649,614.871451,753.5445867,Malicious
10.0.2.15,58297,119.254.87.201,80,11,1579,6,705,5,874,11872.73471,1.447118,3897.401594,4831.672331,Malicious
10.0.2.15,53324,119.254.87.201,80,11,1582,6,705,5,877,11875.18619,9.020967,625.2101355,777.743672,Malicious
10.0.2.15,47690,119.254.87.201,80,11,1582,6,705,5,877,11900.32662,1.518931,3713.137726,4619.037994,Malicious
10.0.2.15,58197,119.254.87.201,80,11,1582,6,705,5,877,11902.75674,2.528856,2230.257476,2774.377031,Malicious
10.0.2.15,57356,119.254.87.201,80,11,1582,6,705,5,877,11905.15305,1.49653,3768.718302,4688.178653,Malicious
10.0.2.15,43719,119.254.87.201,80,12,1653,7,779,5,874,11930.33254,4.39486,1418.020142,1590.949427,Malicious
10.0.2.15,45111,119.254.87.201,80,11,1579,6,705,5,874,11932.81398,1.228364,4591.472886,5692.123833,Malicious
10.0.2.15,53961,119.254.87.201,80,12,1653,7,779,5,874,11935.16692,4.275388,1457.645482,1635.407126,Malicious
10.0.2.15,54979,119.254.87.201,80,11,1579,6,705,5,874,11960.35279,1.489071,3787.596428,4695.545075,Malicious
10.0.2.15,59223,119.254.87.201,80,11,1513,6,705,5,808,11962.81625,1.446742,3898.414507,4467.970101,Malicious
10.0.2.15,34651,119.254.87.201,80,11,1582,6,705,5,877,11965.16465,4.50539,1251.833914,1557.245877,Malicious
10.0.2.15,58869,119.254.87.201,80,11,1593,6,705,5,888,11990.36662,1.223105,4611.2149,5808.168555,Malicious
10.0.2.15,39490,119.254.87.201,80,11,1579,6,705,5,874,11992.82499,1.414604,3986.981516,4942.726021,Malicious
10.0.2.15,50979,119.254.87.201,80,11,1582,6,705,5,877,11995.21118,0.833574,6766.045966,8416.769237,Malicious
10.0.2.15,54507,119.254.87.201,80,11,1579,6,705,5,874,12020.3811,1.360223,4146.378939,5140.333607,Malicious
10.0.2.15,51181,119.254.87.201,80,11,1579,6,705,5,874,12022.84837,1.240916,4545.029639,5634.547383,Malicious
10.0.2.15,48826,119.254.87.201,80,11,1579,6,705,5,874,12025.26888,1.35154,4173.017447,5173.357799,Malicious
10.0.2.15,59144,119.254.87.201,80,11,1554,6,705,5,849,12050.41527,2.555755,2206.784297,2657.531727,Malicious
10.0.2.15,46942,119.254.87.201,80,11,1579,6,705,5,874,12052.90449,1.483497,3801.827708,4713.187826,Malicious
10.0.2.15,38837,119.254.87.201,80,12,1653,7,779,5,874,12055.29994,4.457239,1398.174969,1568.684111,Malicious
10.0.2.15,41507,119.254.87.201,80,11,1513,6,705,5,808,12080.61159,1.483101,3802.842827,4358.435467,Malicious
10.0.2.15,40908,119.254.87.201,80,11,1582,6,705,5,877,12082.93625,1.422505,3964.836679,4932.144351,Malicious
10.0.2.15,34701,119.254.87.201,80,11,1568,6,705,5,863,12085.33284,1.504974,3747.573048,4587.454667,Malicious
10.0.2.15,45867,119.254.87.201,80,11,1582,6,705,5,877,12110.52699,1.245323,4528.945502,5633.879724,Malicious
10.0.2.15,52592,119.254.87.201,80,11,1552,6,705,5,847,12112.94292,0.890501,6333.513382,7609.199765,Malicious
10.0.2.15,57487,119.254.87.201,80,12,1653,7,779,5,874,12115.39415,3.798425,1640.680019,1840.762948,Malicious
10.0.2.15,60693,119.254.87.201,80,12,1587,7,779,5,808,12140.57082,4.274342,1458.002191,1512.279551,Malicious
10.0.2.15,45231,119.254.87.201,80,11,1582,6,705,5,877,12143.00262,1.352423,4170.292874,5187.72603,Malicious
10.0.2.15,59072,119.254.87.201,80,11,1534,6,705,5,829,12145.41826,1.423945,3960.827139,4657.48326,Malicious
10.0.2.15,52609,119.254.87.201,80,11,1582,6,705,5,877,12170.57054,1.423299,3962.62486,4929.39291,Malicious
10.0.2.15,40925,119.254.87.201,80,11,1579,6,705,5,874,12173.12201,1.386728,4067.1278,5042.084677,Malicious
10.0.2.15,54486,119.254.87.201,80,11,1582,6,705,5,877,12175.40156,1.497322,3766.724859,4685.698868,Malicious
10.0.2.15,43723,119.254.87.201,80,12,1656,7,779,5,877,12200.58274,7.345914,848.3627769,955.0887745,Malicious
10.0.2.15,42045,119.254.87.201,80,11,1582,6,705,5,877,12203.07647,1.243046,4537.241582,5644.199812,Malicious
10.0.2.15,37857,119.254.87.201,80,12,1653,7,779,5,874,12205.42313,3.801443,1639.377468,1839.301549,Malicious
10.0.2.15,34423,119.254.87.201,80,11,1579,6,705,5,874,12230.59768,0.961463,5866.060368,7272.250726,Malicious
10.0.2.15,38689,119.254.87.201,80,11,1513,6,705,5,808,12233.13261,1.421515,3967.59795,4547.261197,Malicious
10.0.2.15,39082,119.254.87.201,80,11,1582,6,705,5,877,12235.45222,1.632079,3455.715073,4298.811516,Malicious
10.0.2.15,55622,119.254.87.201,80,11,1582,6,705,5,877,12260.61955,0.820276,6875.734509,8553.218673,Malicious
10.0.2.15,42169,119.254.87.201,80,13,1727,8,853,5,874,12263.14213,10.399901,656.1600923,672.3140922,Malicious
10.0.2.15,58877,119.254.87.201,80,10,981,6,725,4,256,12265.50957,180.504435,32.13217448,11.34598161,Malicious
10.0.2.15,46841,119.254.87.201,80,11,1593,6,705,5,888,12290.6226,1.544934,3650.641387,4598.254683,Malicious
10.0.2.15,34003,119.254.87.201,80,11,1579,6,705,5,874,12293.19855,1.42397,3960.7576,4910.215805,Malicious
10.0.2.15,34176,119.254.87.201,80,11,1582,6,705,5,877,12295.63189,1.457703,3869.100907,4813.051767,Malicious
10.0.2.15,40617,119.254.87.201,80,12,1653,7,779,5,874,12320.62644,3.801864,1639.195931,1839.097874,Malicious
10.0.2.15,58803,119.254.87.201,80,11,1582,6,705,5,877,12323.25521,1.661223,3395.08904,4223.394451,Malicious
10.0.2.15,42212,119.254.87.201,80,13,1661,8,853,5,808,12325.55879,10.01777,681.1895262,645.2533847,Malicious
10.0.2.15,35640,119.254.87.201,80,11,1582,6,705,5,877,12350.66839,1.620457,3480.499637,4329.642811,Malicious
10.0.2.15,57447,119.254.87.201,80,11,1579,6,705,5,874,12353.258,1.548897,3641.300874,4514.180091,Malicious
10.0.2.15,41925,119.254.87.201,80,11,1513,6,705,5,808,12355.57053,1.442515,3909.838026,4481.062589,Malicious
10.0.2.15,57215,119.254.87.201,80,11,1582,6,705,5,877,12380.68804,1.556514,3623.481703,4507.508445,Malicious
10.0.2.15,55976,119.254.87.201,80,11,1579,6,705,5,874,12383.28345,1.558319,3619.284627,4486.88619,Malicious
10.0.2.15,44847,119.254.87.201,80,12,1653,7,779,5,874,12385.6157,4.713033,1322.290763,1483.545734,Malicious
10.0.2.15,36404,119.254.87.201,80,11,1582,6,705,5,877,12410.72681,1.61742,3487.034907,4337.772502,Malicious
10.0.2.15,47804,119.254.87.201,80,11,1513,6,705,5,808,12413.31132,1.624089,3472.716089,3980.077446,Malicious
10.0.2.15,34661,119.254.87.201,80,11,1582,6,705,5,877,12415.63244,1.647911,3422.51493,4257.51148,Malicious
10.0.2.15,53982,119.254.87.201,80,11,1579,6,705,5,874,12440.76305,0.921921,6117.660841,7584.163936,Malicious
10.0.2.15,40571,119.254.87.201,80,13,1741,8,853,5,888,12443.31558,10.536611,647.6465725,674.2205819,Malicious
10.0.2.15,36735,119.254.87.201,80,12,1653,7,779,5,874,12445.68332,4.213759,1478.964507,1659.326032,Malicious
10.0.2.15,60080,119.254.87.201,80,11,1579,6,705,5,874,12470.79055,1.490134,3784.894513,4692.195467,Malicious
10.0.2.15,48952,119.254.87.201,80,11,1579,6,705,5,874,12473.31556,1.689123,3339.010836,4139.426199,Malicious
10.0.2.15,60602,119.254.87.201,80,11,1579,6,705,5,874,12475.71132,1.623507,3473.960999,4306.726118,Malicious
10.0.2.15,32933,119.254.87.201,80,11,1513,6,705,5,808,12500.8141,1.683296,3350.569359,3840.085166,Malicious
10.0.2.15,39487,119.254.87.201,80,11,1582,6,705,5,877,12503.33886,1.41452,3987.218279,4959.986426,Malicious
10.0.2.15,35344,119.254.87.201,80,11,1579,6,705,5,874,12505.73532,1.682108,3352.935721,4156.689107,Malicious
10.0.2.15,40163,119.254.87.201,80,11,1582,6,705,5,877,12530.81759,1.618404,3484.914768,4335.135108,Malicious
10.0.2.15,43427,119.254.87.201,80,11,1579,6,705,5,874,12533.40018,1.891883,2981.156869,3695.788799,Malicious
10.0.2.15,47965,119.254.87.201,80,11,1579,6,705,5,874,12535.7363,1.839814,3065.527276,3800.384169,Malicious
10.0.2.15,53001,119.254.87.201,80,11,1579,6,705,5,874,12560.85588,2.341837,2408.36574,2985.690294,Malicious
10.0.2.15,45564,119.254.87.201,80,11,1582,6,705,5,877,12563.43285,2.246913,2510.110538,3122.506301,Malicious
10.0.2.15,33643,119.254.87.201,80,11,1579,6,705,5,874,12565.79189,2.29101,2461.796326,3051.929062,Malicious
10.0.2.15,39618,119.254.87.201,80,11,1587,6,705,5,882,12590.87674,1.894821,2976.534459,3723.8346,Malicious
10.0.2.15,40428,119.254.87.201,80,11,1582,6,705,5,877,12593.47963,2.014821,2799.256113,3482.195193,Malicious
10.0.2.15,39650,119.254.87.201,80,11,1534,6,705,5,829,12595.80195,2.016586,2796.806087,3288.72659,Malicious
10.0.2.15,47594,119.254.87.201,80,11,1582,6,705,5,877,12620.90197,2.091121,2697.117957,3355.138225,Malicious
10.0.2.15,40846,119.254.87.201,80,11,1582,6,705,5,877,12623.49175,2.151382,2621.570693,3261.159571,Malicious
10.0.2.15,34149,119.254.87.201,80,11,1582,6,705,5,877,12625.82367,2.311541,2439.930765,3035.204654,Malicious
10.0.2.15,51060,119.254.87.201,80,11,1513,6,705,5,808,12650.96105,1.822722,3094.27329,3546.344423,Malicious
10.0.2.15,34444,119.254.87.201,80,11,1582,6,705,5,877,12653.54967,1.892156,2980.726748,3707.939515,Malicious
10.0.2.15,45591,119.254.87.201,80,11,1582,6,705,5,877,12655.88586,1.845195,3056.587515,3802.308157,Malicious
10.0.2.15,47687,119.254.87.201,80,11,1513,6,705,5,808,12681.13639,11.226366,502.3887516,575.7873919,Malicious
10.0.2.15,50751,119.254.87.201,80,11,1579,6,705,5,874,12683.57555,2.08698,2702.469597,3350.295643,Malicious
10.0.2.15,45275,119.254.87.201,80,11,1568,6,705,5,863,12685.90765,2.150994,2622.043576,3209.678874,Malicious
10.0.2.15,56988,119.254.87.201,80,11,1582,6,705,5,877,12711.02716,2.229074,2530.198639,3147.495328,Malicious
10.0.2.15,50806,119.254.87.201,80,11,1582,6,705,5,877,12713.63321,2.26107,2494.394247,3102.95568,Malicious
10.0.2.15,37442,119.254.87.201,80,11,1579,6,705,5,874,12715.93884,2.284444,2468.872076,3060.700985,Malicious
10.0.2.15,45340,119.254.87.201,80,11,1579,6,705,5,874,12741.02661,2.096275,2690.486697,3335.440245,Malicious
10.0.2.15,39315,119.254.87.201,80,11,1582,6,705,5,877,12743.6919,2.162122,2608.548454,3244.960275,Malicious
10.0.2.15,46202,119.254.87.201,80,11,1579,6,705,5,874,12745.96642,2.216549,2544.495971,3154.453161,Malicious
10.0.2.15,33965,119.254.87.201,80,11,1582,6,705,5,877,12771.05703,2.018579,2794.044722,3475.71237,Malicious
10.0.2.15,47972,119.254.87.201,80,11,1579,6,705,5,874,12773.71893,2.018745,2793.814969,3463.53799,Malicious
10.0.2.15,50576,119.254.87.201,80,11,1560,6,705,5,855,12775.97464,2.135089,2641.576065,3203.613526,Malicious
10.0.2.15,49410,119.254.87.201,80,11,1579,6,705,5,874,12801.13193,0.819389,6883.177587,8533.187534,Malicious
10.0.2.15,57521,119.254.87.201,80,11,1579,6,705,5,874,12803.7237,1.369671,4117.777189,5104.87555,Malicious
10.0.2.15,53473,119.254.87.201,80,11,1582,6,705,5,877,12805.9976,1.221778,4616.223242,5742.450756,Malicious
10.0.2.15,55834,119.254.87.201,80,11,1579,6,705,5,874,12831.14384,0.894123,6307.856973,7819.953183,Malicious
10.0.2.15,43969,119.254.87.201,80,11,1582,6,705,5,877,12833.74805,2.411051,2339.228826,2909.934298,Malicious
10.0.2.15,59903,119.254.87.201,80,12,1653,7,779,5,874,12836.02594,3.915296,1591.705966,1785.816449,Malicious
10.0.2.15,40652,119.254.87.201,80,11,1579,6,705,5,874,12861.16577,2.226894,2532.675556,3139.7992,Malicious
10.0.2.15,41250,119.254.87.201,80,11,1582,6,705,5,877,12863.77072,2.230538,2528.537958,3145.429488,Malicious
10.0.2.15,35798,119.254.87.201,80,11,1582,6,705,5,877,12866.03157,2.177171,2590.517695,3222.530522,Malicious
10.0.2.15,56184,119.254.87.201,80,11,1513,6,705,5,808,12891.2217,2.189628,2575.779996,2952.099626,Malicious
10.0.2.15,34901,119.254.87.201,80,11,1579,6,705,5,874,12893.78299,4.160583,1355.579254,1680.533714,Malicious
10.0.2.15,50962,119.254.87.201,80,11,1579,6,705,5,874,12896.05843,2.154967,2617.209451,3244.597249,Malicious
10.0.2.15,60345,119.254.87.201,80,11,1579,6,705,5,874,12921.22277,2.219235,2541.416299,3150.635241,Malicious
10.0.2.15,46609,119.254.87.201,80,11,1513,6,705,5,808,12923.81455,2.206559,2556.015951,2929.448068,Malicious
10.0.2.15,38811,119.254.87.201,80,11,1579,6,705,5,874,12926.05878,2.023346,2787.461957,3455.662057,Malicious
10.0.2.15,51174,119.254.87.201,80,11,1579,6,705,5,874,12951.28037,6.758592,834.4933383,1034.535004,Malicious
10.0.2.15,59773,119.254.87.201,80,11,1582,6,705,5,877,12953.87382,1.433907,3933.309482,4892.925413,Malicious
10.0.2.15,49609,119.254.87.201,80,11,1582,6,705,5,877,12956.08319,1.955619,2883.997343,3587.610879,Malicious
10.0.2.15,52576,119.254.87.201,80,11,1558,6,705,5,853,12981.31738,3.167619,1780.517164,2154.299491,Malicious
10.0.2.15,59564,119.254.87.201,80,11,1579,6,705,5,874,12983.91613,1.510466,3733.947007,4629.035013,Malicious
10.0.2.15,60369,119.254.87.201,80,11,1579,6,705,5,874,12986.13633,1.419135,3974.251921,4926.944935,Malicious
10.0.2.15,45965,119.254.87.201,80,11,1582,6,705,5,877,13011.37078,2.309308,2442.290071,3038.139564,Malicious
10.0.2.15,54076,119.254.87.201,80,11,1513,6,705,5,808,13013.9237,2.219525,2541.084241,2912.334846,Malicious
10.0.2.15,48803,119.254.87.201,80,11,1513,6,705,5,808,13016.17825,2.303022,2448.956198,2806.746961,Malicious
10.0.2.15,52554,119.254.87.201,80,11,1579,6,705,5,874,13041.42706,1.223686,4609.025518,5713.884117,Malicious
10.0.2.15,60220,119.254.87.201,80,11,1582,6,705,5,877,13043.9542,0.92767,6079.748186,7563.034269,Malicious
10.0.2.15,34220,119.254.87.201,80,11,1554,6,705,5,849,13046.24141,1.025527,5499.611419,6622.936305,Malicious
10.0.2.15,57954,119.254.87.201,80,11,1582,6,705,5,877,13071.42864,2.235866,2522.51253,3137.934026,Malicious
10.0.2.15,42582,119.254.87.201,80,11,1593,6,705,5,888,13073.97518,2.08335,2707.178343,3409.892721,Malicious
10.0.2.15,41307,119.254.87.201,80,11,1579,6,705,5,874,13076.29526,2.109328,2673.837355,3314.799785,Malicious
10.0.2.15,49868,119.254.87.201,80,11,1582,6,705,5,877,13101.48654,2.212713,2548.907156,3170.768193,Malicious
10.0.2.15,49327,119.254.87.201,80,11,1582,6,705,5,877,13104.00765,2.22156,2538.756549,3158.141126,Malicious
10.0.2.15,35555,119.254.87.201,80,11,1579,6,705,5,874,13106.34333,3.819995,1476.441723,1830.368888,Malicious
10.0.2.15,33601,119.254.87.201,80,11,1579,6,705,5,874,13131.51638,1.740459,3240.524482,4017.33106,Malicious
10.0.2.15,53397,119.254.87.201,80,11,1593,6,705,5,888,13134.03513,1.911875,2949.983655,3715.724093,Malicious
10.0.2.15,56054,119.254.87.201,80,11,1561,6,705,5,856,13136.34479,2.078143,2713.961455,3295.249653,Malicious
10.0.2.15,60658,119.254.87.201,80,11,1582,6,705,5,877,13161.55878,1.224802,4604.825923,5728.272815,Malicious
10.0.2.15,47275,119.254.87.201,80,11,1579,6,705,5,874,13164.09059,1.025945,5497.370717,6815.180151,Malicious
10.0.2.15,42642,119.254.87.201,80,11,1513,6,705,5,808,13166.3476,1.690112,3337.056952,3824.598606,Malicious
10.0.2.15,36960,119.254.87.201,80,11,1579,6,705,5,874,13191.61202,1.889279,2985.265808,3700.882718,Malicious
10.0.2.15,56225,119.254.87.201,80,11,1513,6,705,5,808,13194.09875,1.852641,3044.302701,3489.073166,Malicious
10.0.2.15,38302,119.254.87.201,80,11,1582,6,705,5,877,13196.38252,1.914807,2945.466567,3664.07685,Malicious
10.0.2.15,33292,119.254.87.201,80,11,1513,6,705,5,808,13221.63018,1.834724,3074.031843,3523.145716,Malicious
10.0.2.15,57282,119.254.87.201,80,11,1579,6,705,5,874,13224.09815,2.024822,2785.430028,3453.143042,Malicious
10.0.2.15,56777,119.254.87.201,80,11,1579,6,705,5,874,13226.43181,1.784205,3161.071738,3918.832197,Malicious
10.0.2.15,53874,119.254.87.201,80,11,1579,6,705,5,874,13251.68963,1.672972,3371.245903,4179.388537,Malicious
10.0.2.15,54231,119.254.87.201,80,11,1579,6,705,5,874,13254.13372,1.648,3422.330097,4242.718447,Malicious
10.0.2.15,32983,119.254.87.201,80,11,1582,6,705,5,877,13256.49148,1.679313,3358.51625,4177.898938,Malicious
10.0.2.15,47591,119.254.87.201,80,11,1579,6,705,5,874,13281.86015,1.724197,3271.087933,4055.221068,Malicious
10.0.2.15,45332,119.254.87.201,80,11,1579,6,705,5,874,13284.15718,1.687163,3342.88981,4144.235026,Malicious
10.0.2.15,52942,119.254.87.201,80,11,1582,6,705,5,877,13286.55011,2.352377,2397.574879,2982.515133,Malicious
10.0.2.15,38341,119.254.87.201,80,11,1579,6,705,5,874,13311.74657,1.896481,2973.929082,3686.828394,Malicious
10.0.2.15,44901,119.254.87.201,80,11,1582,6,705,5,877,13314.21662,3.695641,1526.122261,1898.452799,Malicious
10.0.2.15,40766,119.254.87.201,80,11,1579,6,705,5,874,13316.60825,1.922854,2933.14001,3636.261515,Malicious
10.0.2.15,51540,119.254.87.201,80,11,1579,6,705,5,874,13341.80307,4.434728,1271.780366,1576.646865,Malicious
10.0.2.15,52431,119.254.87.201,80,11,1579,6,705,5,874,13344.26332,1.631477,3456.9902,4285.687141,Malicious
10.0.2.15,48140,119.254.87.201,80,11,1582,6,705,5,877,13346.61007,6.134824,919.3417774,1143.63509,Malicious
10.0.2.15,34724,119.254.87.201,80,11,1579,6,705,5,874,13371.84112,4.580377,1231.339691,1526.511901,Malicious
10.0.2.15,49201,119.254.87.201,80,11,1582,6,705,5,877,13374.27292,1.482738,3803.773829,4731.786735,Malicious
10.0.2.15,50702,119.254.87.201,80,11,1582,6,705,5,877,13376.66515,4.526416,1246.018925,1550.012195,Malicious
10.0.2.15,33050,119.254.87.201,80,12,1653,7,779,5,874,13401.84191,4.879652,1277.140255,1432.889067,Malicious
10.0.2.15,41187,119.254.87.201,80,11,1534,6,705,5,829,13404.27831,2.10188,2683.312083,3155.27052,Malicious
10.0.2.15,50523,119.254.87.201,80,11,1513,6,705,5,808,13406.69692,4.308419,1309.06488,1500.31833,Malicious
10.0.2.15,59260,119.254.87.201,80,11,1582,6,705,5,877,13431.90185,1.024957,5502.669868,6845.165212,Malicious
10.0.2.15,41675,119.254.87.201,80,11,1513,6,705,5,808,13434.29616,1.280694,4403.862281,5047.263437,Malicious
10.0.2.15,37872,119.254.87.201,80,11,1579,6,705,5,874,13436.75624,2.506648,2250.016755,2789.382474,Malicious
10.0.2.15,34893,119.254.87.201,80,11,1579,6,705,5,874,13461.93436,2.109085,2674.145423,3315.181702,Malicious
10.0.2.15,59525,119.254.87.201,80,11,1579,6,705,5,874,13464.35308,2.115479,2666.062863,3305.161621,Malicious
10.0.2.15,55504,119.254.87.201,80,11,1582,6,705,5,877,13466.78325,2.152459,2620.258969,3259.527824,Malicious
10.0.2.15,49763,119.254.87.201,80,11,1582,6,705,5,877,13491.99668,1.887638,2987.86102,3716.814347,Malicious
10.0.2.15,49903,119.254.87.201,80,11,1582,6,705,5,877,13494.38623,1.919965,2937.553549,3654.23328,Malicious
10.0.2.15,51262,119.254.87.201,80,11,1579,6,705,5,874,13496.84243,2.018818,2793.713945,3463.412749,Malicious
10.0.2.15,34982,119.254.87.201,80,11,1579,6,705,5,874,13522.00957,0.889322,6341.909904,7862.169158,Malicious
10.0.2.15,38008,119.254.87.201,80,11,1513,6,705,5,808,13524.41215,1.440787,3914.527269,4486.436926,Malicious
10.0.2.15,36439,119.254.87.201,80,11,1582,6,705,5,877,13526.89765,0.955433,5903.082686,7343.267398,Malicious
10.0.2.15,33145,119.254.87.201,80,11,1579,6,705,5,874,13552.02442,3.127225,1803.515897,2235.848076,Malicious
10.0.2.15,56324,119.254.87.201,80,12,1634,7,779,5,855,13554.47203,12.832879,485.6275821,533.0058828,Malicious
10.0.2.15,33852,119.254.87.201,80,11,1582,6,705,5,877,13556.91655,1.164129,4844.823898,6026.823488,Malicious
10.0.2.15,54064,119.254.87.201,80,13,1727,8,853,5,874,13582.098,10.368394,658.1540015,674.3570894,Malicious
10.0.2.15,33681,119.254.87.201,80,12,1653,7,779,5,874,13584.56536,4.314032,1444.588265,1620.757565,Malicious
10.0.2.15,37978,119.254.87.201,80,11,1579,6,705,5,874,13586.97287,1.226513,4598.402137,5700.714138,Malicious
10.0.2.15,60418,119.254.87.201,80,11,1582,6,705,5,877,13612.11213,6.000109,939.9829236,1169.312091,Malicious
10.0.2.15,48808,119.254.87.201,80,11,1579,6,705,5,874,13614.49975,1.386269,4068.474445,5043.754134,Malicious
10.0.2.15,49528,119.254.87.201,80,11,1582,6,705,5,877,13616.99152,1.120558,5033.20667,6261.166312,Malicious
10.0.2.15,35510,119.254.87.201,80,11,1582,6,705,5,877,13642.18593,2.027769,2781.381903,3459.960183,Malicious
10.0.2.15,44713,119.254.87.201,80,11,1579,6,705,5,874,13644.52942,2.214239,2547.150511,3157.744038,Malicious
10.0.2.15,39312,119.254.87.201,80,11,1569,6,705,5,864,13647.05015,2.192738,2572.12672,3152.223385,Malicious
10.0.2.15,55586,119.254.87.201,80,11,1513,6,705,5,808,13672.22141,1.356929,4156.444442,4763.698027,Malicious
10.0.2.15,56631,119.254.87.201,80,11,1579,6,705,5,874,13674.55559,1.41486,3986.260125,4941.831701,Malicious
10.0.2.15,56703,119.254.87.201,80,12,1667,7,779,5,888,13677.08025,4.383287,1421.764078,1620.701542,Malicious
10.0.2.15,52116,119.254.87.201,80,11,1582,6,705,5,877,13702.27302,1.821962,3095.564013,3850.793815,Malicious
10.0.2.15,56633,119.254.87.201,80,11,1582,6,705,5,877,13704.59844,1.954671,2885.396059,3589.350842,Malicious
10.0.2.15,45517,119.254.87.201,80,11,1513,6,705,5,808,13707.13387,1.81635,3105.128417,3558.785476,Malicious
10.0.2.15,43252,119.254.87.201,80,11,1587,6,705,5,882,13732.27528,1.711481,3295.391535,4122.745155,Malicious
10.0.2.15,56700,119.254.87.201,80,11,1582,6,705,5,877,13734.62022,1.586592,3554.789133,4422.056836,Malicious
10.0.2.15,58726,119.254.87.201,80,11,1579,6,705,5,874,13737.17032,1.550444,3637.667662,4509.675938,Malicious
10.0.2.15,55760,119.254.87.201,80,11,1582,6,705,5,877,13762.3292,1.896241,2974.305481,3699.951641,Malicious
10.0.2.15,54887,119.254.87.201,80,11,1579,6,705,5,874,13764.66895,2.089464,2699.256843,3346.312739,Malicious
10.0.2.15,37678,119.254.87.201,80,11,1582,6,705,5,877,13767.20062,1.994063,2828.396094,3518.444503,Malicious
10.0.2.15,43418,119.254.87.201,80,11,1513,6,705,5,808,13792.37363,13.357697,422.2284725,483.9157528,Malicious
10.0.2.15,46362,119.254.87.201,80,12,1653,7,779,5,874,13794.67961,12.862821,484.497141,543.5821582,Malicious
10.0.2.15,51501,119.254.87.201,80,11,1582,6,705,5,877,13797.25785,1.318369,4278.013212,5321.727073,Malicious
10.0.2.15,51633,119.254.87.201,80,11,1582,6,705,5,877,13822.39748,1.822272,3095.037404,3850.138728,Malicious
10.0.2.15,52763,119.254.87.201,80,11,1582,6,705,5,877,13824.72979,1.884065,2993.527293,3723.86303,Malicious
10.0.2.15,44980,119.254.87.201,80,11,1582,6,705,5,877,13827.31845,1.881501,2997.606698,3728.937694,Malicious
10.0.2.15,56451,119.254.87.201,80,12,1656,7,779,5,877,13852.45384,4.614731,1350.457914,1520.34864,Malicious
10.0.2.15,40309,119.254.87.201,80,11,1579,6,705,5,874,13854.75731,0.827235,6817.893343,8452.253592,Malicious
10.0.2.15,37285,119.254.87.201,80,11,1579,6,705,5,874,13857.37418,1.41834,3976.479547,4929.706558,Malicious
10.0.2.15,47075,119.254.87.201,80,11,1513,6,705,5,808,13882.59889,1.89934,2969.452547,3403.287458,Malicious
10.0.2.15,46475,119.254.87.201,80,11,1582,6,705,5,877,13884.79829,1.823881,3092.307009,3846.742194,Malicious
10.0.2.15,53046,119.254.87.201,80,11,1513,6,705,5,808,13887.39961,1.935719,2913.646041,3339.327661,Malicious
10.0.2.15,53278,119.254.87.201,80,11,1579,6,705,5,874,13912.51858,1.628246,3463.850057,4294.191418,Malicious
10.0.2.15,49267,119.254.87.201,80,11,1579,6,705,5,874,13914.85189,1.640049,3438.921642,4263.287255,Malicious
10.0.2.15,40357,119.254.87.201,80,11,1582,6,705,5,877,13917.40022,1.35378,4166.112662,5182.525964,Malicious
10.0.2.15,53867,119.254.87.201,80,11,1582,6,705,5,877,13942.54639,1.689147,3338.963394,4153.57574,Malicious
10.0.2.15,59094,119.254.87.201,80,11,1587,6,705,5,882,13944.87811,1.63344,3452.835733,4319.717896,Malicious
10.0.2.15,58392,119.254.87.201,80,11,1513,6,705,5,808,13947.42361,1.478095,3815.722264,4373.196581,Malicious
10.0.2.15,36077,119.254.87.201,80,11,1582,6,705,5,877,13972.60496,1.7143,3289.972584,4092.632561,Malicious
10.0.2.15,39019,119.254.87.201,80,12,1656,7,779,5,877,13974.8874,15.939188,390.9860402,440.1729875,Malicious
10.0.2.15,50854,119.254.87.201,80,12,1653,7,779,5,874,13977.45529,3.813154,1634.342594,1833.652667,Malicious
10.0.2.15,35579,119.254.87.201,80,11,1579,6,705,5,874,14002.62444,1.116508,5051.464029,6262.382356,Malicious
10.0.2.15,50571,119.254.87.201,80,11,1582,6,705,5,877,14004.91354,1.223475,4609.820389,5734.485788,Malicious
10.0.2.15,37781,119.254.87.201,80,11,1579,6,705,5,874,14007.61212,1.327412,4248.869228,5267.39249,Malicious
10.0.2.15,34642,119.254.87.201,80,11,1582,6,705,5,877,14032.65336,1.361249,4143.253732,5154.090104,Malicious
10.0.2.15,37676,119.254.87.201,80,11,1582,6,705,5,877,14034.97668,1.225946,4600.528898,5722.927437,Malicious
10.0.2.15,59763,119.254.87.201,80,11,1582,6,705,5,877,14037.57342,0.894335,6306.36171,7844.935063,Malicious
10.0.2.15,60842,119.254.87.201,80,11,1579,6,705,5,874,14062.68518,1.218143,4629.998284,5739.884398,Malicious
10.0.2.15,42567,119.254.87.201,80,11,1579,6,705,5,874,14065.00392,1.355387,4161.173156,5158.674238,Malicious
10.0.2.15,53847,119.254.87.201,80,11,1582,6,705,5,877,14067.60625,1.214192,4645.064372,5778.328304,Malicious
10.0.2.15,59682,119.254.87.201,80,11,1582,6,705,5,877,14092.71076,1.941216,2905.395381,3614.229431,Malicious
10.0.2.15,43745,119.254.87.201,80,11,1582,6,705,5,877,14095.02752,1.818494,3101.467478,3858.137558,Malicious
10.0.2.15,42509,119.254.87.201,80,11,1579,6,705,5,874,14097.61019,1.954885,2885.080197,3576.680981,Malicious
10.0.2.15,42735,119.254.87.201,80,11,1587,6,705,5,882,14122.77323,1.6415,3435.881815,4298.507463,Malicious
10.0.2.15,39538,119.254.87.201,80,11,1587,6,705,5,882,14125.05517,1.708622,3300.905642,4129.643654,Malicious
10.0.2.15,37718,119.254.87.201,80,11,1582,6,705,5,877,14127.67385,1.685926,3345.34256,4161.511241,Malicious
10.0.2.15,42100,119.254.87.201,80,11,1579,6,705,5,874,14152.78297,2.542391,2218.38419,2750.167067,Malicious
10.0.2.15,51940,119.254.87.201,80,11,1579,6,705,5,874,14155.0602,1.02625,5495.736906,6813.154689,Malicious
10.0.2.15,33852,119.254.87.201,80,11,1579,6,705,5,874,14157.72664,1.115789,5054.719127,6266.417755,Malicious
10.0.2.15,45003,119.254.87.201,80,11,1579,6,705,5,874,14182.85711,1.415989,3983.081789,4937.891467,Malicious
10.0.2.15,48882,119.254.87.201,80,11,1587,6,705,5,882,14185.11337,1.092795,5161.077787,6456.837742,Malicious
10.0.2.15,51855,119.254.87.201,80,11,1513,6,705,5,808,14187.78512,1.115552,5055.793007,5794.440779,Malicious
10.0.2.15,59464,119.254.87.201,80,11,1587,6,705,5,882,14212.86119,1.093662,5156.986345,6451.719087,Malicious
10.0.2.15,57258,119.254.87.201,80,11,1579,6,705,5,874,14215.12102,1.420802,3969.589007,4921.164244,Malicious
10.0.2.15,43194,119.254.87.201,80,11,1569,6,705,5,864,14217.84436,1.122611,5024.002081,6157.074891,Malicious
10.0.2.15,47672,119.254.87.201,80,11,1582,6,705,5,877,14242.90073,1.553683,3630.084129,4515.721676,Malicious
10.0.2.15,47279,119.254.87.201,80,12,1656,7,779,5,877,14245.16679,5.638953,1105.169701,1244.202603,Malicious
10.0.2.15,57919,119.254.87.201,80,11,1582,6,705,5,877,14247.87436,7.099395,794.4338919,988.2532244,Malicious
10.0.2.15,34425,119.254.87.201,80,11,1579,6,705,5,874,14272.94187,1.842245,3061.48205,3795.369237,Malicious
10.0.2.15,35275,119.254.87.201,80,11,1593,6,705,5,888,14275.22606,4.071281,1385.313369,1744.90535,Malicious
10.0.2.15,57535,119.254.87.201,80,11,1582,6,705,5,877,14278.03253,1.464736,3850.523234,4789.941669,Malicious
10.0.2.15,46347,119.254.87.201,80,11,1579,6,705,5,874,14302.97478,1.511089,3732.407555,4627.126529,Malicious
10.0.2.15,53286,119.254.87.201,80,11,1582,6,705,5,877,14305.26085,1.358062,4152.976815,5166.185344,Malicious
10.0.2.15,46636,119.254.87.201,80,11,1582,6,705,5,877,14307.99412,1.580804,3567.804737,4438.247879,Malicious
10.0.2.15,45617,119.254.87.201,80,11,1582,6,705,5,877,14332.98152,1.157967,4870.605121,6058.894597,Malicious
10.0.2.15,55957,119.254.87.201,80,12,1653,7,779,5,874,14335.3127,7.032056,886.2272997,994.3037996,Malicious
10.0.2.15,42053,119.254.87.201,80,11,1569,6,705,5,864,14338.04325,1.363337,4136.908189,5069.913015,Malicious
10.0.2.15,37111,119.254.87.201,80,12,1656,7,779,5,877,14363.03302,3.864326,1612.700378,1815.581812,Malicious
10.0.2.15,55347,119.254.87.201,80,11,1579,6,705,5,874,14365.42564,1.404665,4015.192234,4977.699309,Malicious
10.0.2.15,33644,119.254.87.201,80,11,1582,6,705,5,877,14368.07843,1.410938,3997.340776,4972.578526,Malicious
10.0.2.15,50379,119.254.87.201,80,11,1579,6,705,5,874,14393.06665,1.092216,5163.813751,6401.66414,Malicious
10.0.2.15,43604,119.254.87.201,80,11,1579,6,705,5,874,14395.38571,1.425377,3956.847908,4905.368895,Malicious
10.0.2.15,52041,119.254.87.201,80,11,1582,6,705,5,877,14398.11172,2.948389,1912.90905,2379.604591,Malicious
10.0.2.15,56145,119.254.87.201,80,11,1582,6,705,5,877,14423.06995,1.413599,3989.816065,4963.217999,Malicious
10.0.2.15,37339,119.254.87.201,80,11,1582,6,705,5,877,14425.39764,1.558186,3619.593553,4502.671696,Malicious
10.0.2.15,55331,119.254.87.201,80,11,1579,6,705,5,874,14428.12878,1.524888,3698.632293,4585.254786,Malicious
10.0.2.15,32905,119.254.87.201,80,11,1579,6,705,5,874,14453.10235,3.067032,1838.911364,2279.728415,Malicious
10.0.2.15,59057,119.254.87.201,80,11,1582,6,705,5,877,14455.409,1.374303,4103.898485,5105.133293,Malicious
10.0.2.15,38833,119.254.87.201,80,11,1579,6,705,5,874,14458.15663,0.980795,5750.437145,7128.910731,Malicious
10.0.2.15,45996,119.254.87.201,80,11,1579,6,705,5,874,14483.28274,1.030185,5474.744827,6787.130467,Malicious
10.0.2.15,43158,119.254.87.201,80,11,1579,6,705,5,874,14485.42478,1.353292,4167.614971,5166.660263,Malicious
10.0.2.15,40476,119.254.87.201,80,11,1582,6,705,5,877,14488.15798,1.267082,4451.172063,5537.131772,Malicious
10.0.2.15,46374,119.254.87.201,80,11,1582,6,705,5,877,14513.1827,0.89914,6272.660542,7803.011767,Malicious
10.0.2.15,41992,119.254.87.201,80,11,1579,6,705,5,874,14515.43974,0.844013,6682.361528,8284.232589,Malicious
10.0.2.15,39053,119.254.87.201,80,11,1582,6,705,5,877,14518.19019,0.944661,5970.395729,7427.002914,Malicious
10.0.2.15,56773,119.254.87.201,80,11,1579,6,705,5,874,14543.20524,0.823181,6851.47009,8493.879232,Malicious
10.0.2.15,36903,119.254.87.201,80,11,1582,6,705,5,877,14545.46238,7.511143,750.884386,934.0788745,Malicious
10.0.2.15,50373,119.254.87.201,80,12,1656,7,779,5,877,14548.21834,5.423238,1149.128989,1293.692071,Malicious
10.0.2.15,56207,119.254.87.201,80,11,1579,6,705,5,874,14573.26649,0.889749,6338.866354,7858.39602,Malicious
10.0.2.15,34169,119.254.87.201,80,11,1582,6,705,5,877,14575.522,2.412198,2338.116523,2908.550625,Malicious
10.0.2.15,48233,119.254.87.201,80,11,1582,6,705,5,877,14578.24712,1.122787,5023.214554,6248.736403,Malicious
10.0.2.15,40615,119.254.87.201,80,11,1582,6,705,5,877,14603.29778,1.29501,4355.178724,5417.718782,Malicious
10.0.2.15,33612,119.254.87.201,80,11,1582,6,705,5,877,14605.57245,1.494415,3774.052054,4694.81369,Malicious
10.0.2.15,57644,119.254.87.201,80,11,1579,6,705,5,874,14608.24336,29.687233,189.980656,235.5221182,Malicious
10.0.2.15,47939,119.254.87.201,80,3,222,3,222,0,0,14633.30587,9.050631,196.2294121,0,Malicious
10.0.2.15,49626,119.254.87.201,80,12,1643,7,779,5,864,14635.60509,4.557419,1367.44065,1516.64791,Malicious
10.0.2.15,53374,119.254.87.201,80,11,1582,6,705,5,877,14638.41216,1.287443,4380.776469,5449.56165,Malicious
10.0.2.15,51751,119.254.87.201,80,11,1582,6,705,5,877,14663.30569,1.458402,3867.246479,4810.744911,Malicious
10.0.2.15,53472,119.254.87.201,80,11,1582,6,705,5,877,14665.6076,2.484651,2269.936502,2823.736613,Malicious
10.0.2.15,36348,119.254.87.201,80,11,1582,6,705,5,877,14668.43262,1.557678,3620.773998,4504.140137,Malicious
10.0.2.15,42895,119.254.87.201,80,11,1579,6,705,5,874,14693.35505,1.749746,3223.324985,3996.008564,Malicious
10.0.2.15,59102,119.254.87.201,80,11,1579,6,705,5,874,14695.61113,1.71679,3285.200869,4072.717106,Malicious
10.0.2.15,35848,119.254.87.201,80,11,1582,6,705,5,877,14698.36231,1.914595,2945.792713,3664.482567,Malicious
10.0.2.15,40921,119.254.87.201,80,11,1579,6,705,5,874,14723.41252,1.825976,3088.759107,3829.18505,Malicious
10.0.2.15,42324,119.254.87.201,80,11,1568,6,705,5,863,14725.71184,1.772792,3181.422299,3894.421906,Malicious
10.0.2.15,39777,119.254.87.201,80,12,1656,7,779,5,877,14728.393,4.816687,1293.835369,1456.602848,Malicious
10.0.2.15,47368,119.254.87.201,80,11,1582,6,705,5,877,14753.44593,1.489378,3786.815704,4710.691309,Malicious
10.0.2.15,51978,119.254.87.201,80,11,1579,6,705,5,874,14755.63643,1.707805,3302.484768,4094.144238,Malicious
10.0.2.15,40566,119.254.87.201,80,11,1582,6,705,5,877,14758.45146,1.551891,3634.275861,4520.936071,Malicious
10.0.2.15,49515,119.254.87.201,80,11,1559,6,705,5,854,14783.47275,1.542179,3657.163014,4430.095339,Malicious
10.0.2.15,60710,119.254.87.201,80,11,1579,6,705,5,874,14785.66274,1.489265,3787.103034,4694.933407,Malicious
10.0.2.15,54974,119.254.87.201,80,11,1579,6,705,5,874,14788.45411,1.580866,3567.664812,4422.892263,Malicious
10.0.2.15,52486,119.254.87.201,80,11,1579,6,705,5,874,14813.49527,1.42237,3965.21299,4915.739224,Malicious
10.0.2.15,48748,119.254.87.201,80,12,1656,7,779,5,877,14815.69329,4.472388,1393.439031,1568.736881,Malicious
10.0.2.15,44302,119.254.87.201,80,11,1579,6,705,5,874,14818.51411,1.163649,4846.822367,6008.684749,Malicious
10.0.2.15,43511,119.254.87.201,80,12,1656,7,779,5,877,14843.5003,12.941185,481.563319,542.1450972,Malicious
10.0.2.15,57562,119.254.87.201,80,11,1582,6,705,5,877,14845.85267,1.049673,5373.101909,6683.986346,Malicious
10.0.2.15,53281,119.254.87.201,80,12,1653,7,779,5,874,14848.56402,3.815388,1633.385648,1832.579019,Malicious
10.0.2.15,60348,119.254.87.201,80,11,1582,6,705,5,877,14873.52296,1.495051,3772.446559,4692.816499,Malicious
10.0.2.15,36168,119.254.87.201,80,11,1582,6,705,5,877,14875.7825,2.28859,2464.399477,3065.643038,Malicious
10.0.2.15,59674,119.254.87.201,80,11,1579,6,705,5,874,14878.57112,1.020088,5528.934759,6854.310609,Malicious
10.0.2.15,49803,119.254.87.201,80,11,1582,6,705,5,877,14903.52611,1.223501,4609.722428,5734.363928,Malicious
10.0.2.15,35648,119.254.87.201,80,12,1656,7,779,5,877,14905.78401,3.895798,1599.672262,1800.914729,Malicious
10.0.2.15,55543,119.254.87.201,80,11,1579,6,705,5,874,14908.62347,0.98933,5700.827833,7067.409257,Malicious
10.0.2.15,37725,119.254.87.201,80,11,1552,6,705,5,847,14933.56665,0.949739,5938.473623,7134.591714,Malicious
10.0.2.15,59851,119.254.87.201,80,12,1656,7,779,5,877,14935.83049,3.930993,1585.350063,1784.790764,Malicious
10.0.2.15,46861,119.254.87.201,80,11,1582,6,705,5,877,14938.68495,1.282564,4397.441375,5470.292321,Malicious
10.0.2.15,55221,119.254.87.201,80,11,1579,6,705,5,874,14963.62952,1.423562,3961.892773,4911.623098,Malicious
10.0.2.15,38758,119.254.87.201,80,5,340,4,276,1,64,14965.92244,12.755861,173.0969003,40.13841167,Malicious
10.0.2.15,38869,119.254.87.201,80,13,1730,8,853,5,877,14968.71249,10.678909,639.0165887,656.9959534,Malicious
10.0.2.15,57565,119.254.87.201,80,11,1582,6,705,5,877,14993.6763,1.676466,3364.219734,4184.99391,Malicious
10.0.2.15,55893,119.254.87.201,80,11,1579,6,705,5,874,14995.8604,1.621341,3478.601972,4312.479608,Malicious
10.0.2.15,57746,119.254.87.201,80,11,1587,6,705,5,882,14998.71654,1.725342,3268.917119,4089.62397,Malicious
10.0.2.15,35670,119.254.87.201,80,11,1513,6,705,5,808,15023.73245,1.050019,5371.331376,6156.07908,Malicious
10.0.2.15,47419,119.254.87.201,80,11,1579,6,705,5,874,15025.89143,246.243727,22.90413676,28.39463196,Malicious
10.0.2.15,36792,119.254.87.201,80,11,1582,6,705,5,877,15028.74413,0.987417,5711.872492,7105.407341,Malicious
10.0.2.15,43589,119.254.87.201,80,11,1582,6,705,5,877,15053.75964,1.221536,4617.137768,5743.5884,Malicious
10.0.2.15,34162,119.254.87.201,80,11,1579,6,705,5,874,15055.9531,3.056141,1845.464591,2287.852557,Malicious
10.0.2.15,52906,119.254.87.201,80,11,1585,6,705,5,880,15058.80374,1.486529,3794.073308,4735.864554,Malicious
10.0.2.15,55537,119.254.87.201,80,11,1579,6,705,5,874,15087.05092,1.659004,3399.63014,4214.576939,Malicious
10.0.2.15,37549,119.254.87.201,80,11,1582,6,705,5,877,15087.0538,1.723124,3273.124859,4071.67447,Malicious
10.0.2.15,51283,119.254.87.201,80,11,1582,6,705,5,877,15088.82398,1.625007,3470.75428,4317.519863,Malicious
10.0.2.15,54907,119.254.87.201,80,11,1513,6,705,5,808,15113.84762,1.662865,3391.736551,3887.266856,Malicious
10.0.2.15,40387,119.254.87.201,80,11,1582,6,705,5,877,15116.01295,1.746645,3229.047689,4016.84372,Malicious
10.0.2.15,56436,119.254.87.201,80,11,1582,6,705,5,877,15118.86434,1.81624,3105.316478,3862.925605,Malicious
10.0.2.15,35059,119.254.87.201,80,11,1582,6,705,5,877,15143.88799,2.083354,2707.173145,3367.646593,Malicious
10.0.2.15,37999,119.254.87.201,80,11,1579,6,705,5,874,15146.07493,1.960451,2876.889042,3566.526274,Malicious
10.0.2.15,36923,119.254.87.201,80,11,1579,6,705,5,874,15148.864,2.054374,2745.361847,3403.469865,Malicious
10.0.2.15,41012,119.254.87.201,80,12,1587,7,779,5,808,15173.91736,13.091754,476.0248321,493.7459106,Malicious
10.0.2.15,56491,119.254.87.201,80,11,1582,6,705,5,877,15176.09164,1.026373,5495.0783,6835.721516,Malicious
10.0.2.15,40688,119.254.87.201,80,11,1558,6,705,5,853,15178.88704,1.230735,4582.627454,5544.654211,Malicious
10.0.2.15,59512,119.254.87.201,80,11,1513,6,705,5,808,15203.94187,1.090733,5170.834659,5926.289935,Malicious
10.0.2.15,47032,119.254.87.201,80,11,1579,6,705,5,874,15206.13355,1.216097,4637.78794,5749.541361,Malicious
10.0.2.15,50225,119.254.87.201,80,11,1579,6,705,5,874,15208.93683,2.415921,2334.513422,2894.134369,Malicious
10.0.2.15,48187,119.254.87.201,80,11,1579,6,705,5,874,15233.97441,1.224823,4604.746972,5708.579934,Malicious
10.0.2.15,36146,119.254.87.201,80,12,1656,7,779,5,877,15236.16092,4.538485,1373.145444,1545.890314,Malicious
10.0.2.15,41154,119.254.87.201,80,11,1579,6,705,5,874,15238.9257,1.15971,4863.284787,6029.09348,Malicious
10.0.2.15,37499,119.254.87.201,80,11,1513,6,705,5,808,15264.05123,1.482688,3803.902102,4359.649501,Malicious
10.0.2.15,40871,119.254.87.201,80,12,1656,7,779,5,877,15266.18137,4.094844,1521.9139,1713.374185,Malicious
10.0.2.15,36750,119.254.87.201,80,11,1544,6,705,5,839,15268.96763,1.573458,3584.46174,4265.763687,Malicious
10.0.2.15,56943,119.254.87.201,80,11,1579,6,705,5,874,15294.08166,2.08917,2699.636698,3346.783651,Malicious
10.0.2.15,47653,119.254.87.201,80,11,1579,6,705,5,874,15296.29739,2.117315,2663.751024,3302.295596,Malicious
10.0.2.15,52572,119.254.87.201,80,12,1653,7,779,5,874,15298.982,5.113818,1218.658935,1367.275879,Malicious
10.0.2.15,58500,119.254.87.201,80,11,1579,6,705,5,874,15324.1167,1.449666,3890.551341,4823.17996,Malicious
10.0.2.15,48850,119.254.87.201,80,11,1579,6,705,5,874,15326.2737,1.084639,5199.886783,6446.384465,Malicious
10.0.2.15,60637,119.254.87.201,80,13,1727,8,853,5,874,15329.01829,10.807339,631.4227767,646.9677688,Malicious
10.0.2.15,37517,119.254.87.201,80,11,1582,6,705,5,877,15354.13831,1.75871,3206.895964,3989.287603,Malicious
10.0.2.15,52037,119.254.87.201,80,11,1579,6,705,5,874,15356.33353,1.223506,4609.70359,5714.724734,Malicious
10.0.2.15,48498,119.254.87.201,80,12,1653,7,779,5,874,15359.06062,7.045696,884.5116224,992.3788934,Malicious
10.0.2.15,37039,119.254.87.201,80,11,1579,6,705,5,874,15384.14049,1.684218,3348.73514,4151.481578,Malicious
10.0.2.15,53006,119.254.87.201,80,12,1587,7,779,5,808,15386.33333,4.443442,1402.516338,1454.728114,Malicious
10.0.2.15,59329,119.254.87.201,80,11,1582,6,705,5,877,15389.06327,1.382587,4079.309295,5074.545038,Malicious
10.0.2.15,46691,119.254.87.201,80,12,1656,7,779,5,877,15414.16535,4.379205,1423.089351,1602.117279,Malicious
10.0.2.15,55063,119.254.87.201,80,13,1727,8,853,5,874,15416.43284,10.16178,671.5358923,688.068429,Malicious
10.0.2.15,60099,119.254.87.201,80,11,1579,6,705,5,874,15419.11701,1.030473,5473.214728,6785.233577,Malicious
10.0.2.15,48461,119.254.87.201,80,11,1513,6,705,5,808,15444.17788,1.225286,4603.006971,5275.503025,Malicious
10.0.2.15,51205,119.254.87.201,80,11,1582,6,705,5,877,15446.38317,3.030059,1861.349895,2315.466465,Malicious
10.0.2.15,36777,119.254.87.201,80,11,1534,6,705,5,829,15449.14281,1.296439,4350.378228,5115.551137,Malicious
10.0.2.15,48636,119.254.87.201,80,11,1582,6,705,5,877,15474.23238,1.227395,4595.097748,5716.171241,Malicious
10.0.2.15,46976,119.254.87.201,80,11,1513,6,705,5,808,15476.4218,1.091003,5169.554987,5924.823305,Malicious
10.0.2.15,37975,119.254.87.201,80,11,1579,6,705,5,874,15479.14798,1.359889,4147.397324,5141.596116,Malicious
10.0.2.15,60156,119.254.87.201,80,11,1579,6,705,5,874,15504.23978,1.48967,3786.073426,4693.656984,Malicious
10.0.2.15,47106,119.254.87.201,80,11,1579,6,705,5,874,15506.44268,1.221827,4616.038113,5722.577746,Malicious
10.0.2.15,38994,119.254.87.201,80,11,1579,6,705,5,874,15509.2029,1.291847,4365.842085,5412.405649,Malicious
10.0.2.15,37148,119.254.87.201,80,11,1513,6,705,5,808,15534.25313,1.428156,3949.148412,4526.116195,Malicious
10.0.2.15,47068,119.254.87.201,80,11,1513,6,705,5,808,15536.47687,1.676348,3364.456545,3856.00126,Malicious
10.0.2.15,49460,119.254.87.201,80,11,1582,6,705,5,877,15539.25911,1.497214,3766.996568,4686.036866,Malicious
10.0.2.15,54665,119.254.87.201,80,11,1579,6,705,5,874,15564.28714,1.700794,3316.098246,4111.021088,Malicious
10.0.2.15,39076,119.254.87.201,80,11,1579,6,705,5,874,15566.5021,1.610853,3501.25058,4340.557456,Malicious
10.0.2.15,56876,119.254.87.201,80,11,1582,6,705,5,877,15569.26079,1.715172,3288.299949,4090.551851,Malicious
10.0.2.15,45109,119.254.87.201,80,11,1579,6,705,5,874,15594.34216,1.428449,3948.338373,4894.819486,Malicious
10.0.2.15,58903,119.254.87.201,80,11,1582,6,705,5,877,15596.53847,1.220168,4622.314304,5750.027865,Malicious
10.0.2.15,49653,119.254.87.201,80,11,1582,6,705,5,877,15599.26147,4.714341,1196.349606,1488.224971,Malicious
10.0.2.15,47732,119.254.87.201,80,11,1579,6,705,5,874,15624.34805,1.691172,3334.965338,4134.410929,Malicious
10.0.2.15,55208,119.254.87.201,80,11,1513,6,705,5,808,15626.55937,1.617917,3485.963742,3995.260573,Malicious
10.0.2.15,47011,119.254.87.201,80,11,1582,6,705,5,877,15629.31983,1.678527,3360.088935,4179.855314,Malicious
10.0.2.15,45465,119.254.87.201,80,11,1582,6,705,5,877,15654.39857,4.496486,1254.312812,1560.329555,Malicious
10.0.2.15,49076,119.254.87.201,80,11,1579,6,705,5,874,15656.61487,1.486092,3795.188992,4704.957701,Malicious
10.0.2.15,33672,119.254.87.201,80,11,1513,6,705,5,808,15659.32776,2.363467,2386.324836,2734.965202,Malicious
10.0.2.15,59820,119.254.87.201,80,11,1579,6,705,5,874,15684.42806,1.28863,4376.74119,5425.917447,Malicious
10.0.2.15,45879,119.254.87.201,80,13,1707,8,853,5,854,15686.62301,10.252931,665.5657782,666.3460429,Malicious
10.0.2.15,56562,119.254.87.201,80,12,1653,7,779,5,874,15689.48949,4.392382,1418.82013,1591.846975,Malicious
10.0.2.15,53715,119.254.87.201,80,11,1579,6,705,5,874,15714.43355,2.02383,2786.795334,3454.835633,Malicious
10.0.2.15,60317,119.254.87.201,80,11,1513,6,705,5,808,15716.62513,2.089245,2699.539786,3093.940634,Malicious
10.0.2.15,43425,119.254.87.201,80,11,1579,6,705,5,874,15719.41399,2.048507,2753.224666,3413.217529,Malicious
10.0.2.15,37466,119.254.87.201,80,11,1579,6,705,5,874,15744.47329,2.114805,2666.912552,3306.214994,Malicious
10.0.2.15,40328,119.254.87.201,80,11,1579,6,705,5,874,15746.70199,2.026115,2783.652458,3450.939359,Malicious
10.0.2.15,35120,119.254.87.201,80,11,1579,6,705,5,874,15749.46387,2.085323,2704.616983,3352.957791,Malicious
10.0.2.15,42767,119.254.87.201,80,11,1582,6,705,5,877,15774.48626,0.902641,6248.331286,7772.746862,Malicious
10.0.2.15,36682,119.254.87.201,80,11,1579,6,705,5,874,15776.76239,1.487336,3792.014716,4701.022499,Malicious
10.0.2.15,43009,119.254.87.201,80,11,1582,6,705,5,877,15779.47794,1.286853,4382.78498,5452.060181,Malicious
10.0.2.15,43680,119.254.87.201,80,11,1579,6,705,5,874,15804.49605,1.114403,5061.005758,6274.211394,Malicious
10.0.2.15,43122,119.254.87.201,80,11,1579,6,705,5,874,15806.78996,1.417528,3978.757386,4932.530433,Malicious
10.0.2.15,43547,119.254.87.201,80,12,1608,7,779,5,829,15809.49,4.456679,1398.350655,1488.103586,Malicious
10.0.2.15,36116,119.254.87.201,80,11,1579,6,705,5,874,15834.5514,2.251718,2504.754148,3105.184575,Malicious
10.0.2.15,39232,119.254.87.201,80,11,1579,6,705,5,874,15836.84907,2.290081,2462.794984,3053.167115,Malicious
10.0.2.15,41548,119.254.87.201,80,11,1579,6,705,5,874,15839.51812,2.21915,2541.513643,3150.75592,Malicious
10.0.2.15,54792,119.254.87.201,80,11,1582,6,705,5,877,15864.60874,1.281083,4402.525051,5476.616269,Malicious
10.0.2.15,34104,119.254.87.201,80,11,1579,6,705,5,874,15866.86011,1.026824,5492.66476,6809.3461,Malicious
10.0.2.15,57047,119.254.87.201,80,11,1582,6,705,5,877,15869.55534,1.355635,4160.41191,5175.434391,Malicious
10.0.2.15,51115,119.254.87.201,80,11,1582,6,705,5,877,15894.63285,1.024664,5504.243342,6847.122569,Malicious
10.0.2.15,37405,119.254.87.201,80,12,1656,7,779,5,877,15896.90799,6.872725,906.7727866,1020.846898,Malicious
10.0.2.15,43607,119.254.87.201,80,11,1582,6,705,5,877,15899.61223,1.554337,3628.556742,4513.821649,Malicious
10.0.2.15,36929,119.254.87.201,80,12,1656,7,779,5,877,15924.6637,3.863586,1613.009261,1815.929554,Malicious
10.0.2.15,37681,119.254.87.201,80,11,1513,6,705,5,808,15927.0602,0.930987,6058.08674,6943.168916,Malicious
10.0.2.15,45746,119.254.87.201,80,11,1579,6,705,5,874,15929.67612,1.437135,3924.474736,4865.235347,Malicious
10.0.2.15,35756,119.254.87.201,80,11,1582,6,705,5,877,15954.72101,2.225953,2533.74622,3151.908419,Malicious
10.0.2.15,58688,119.254.87.201,80,11,1579,6,705,5,874,15956.9957,2.223217,2536.864373,3144.992144,Malicious
10.0.2.15,58812,119.254.87.201,80,11,1579,6,705,5,874,15959.73047,2.149572,2623.778129,3252.740546,Malicious
10.0.2.15,40402,119.254.87.201,80,11,1579,6,705,5,874,15984.75771,2.218935,2541.759898,3151.061207,Malicious
10.0.2.15,58742,119.254.87.201,80,11,1582,6,705,5,877,15987.02411,2.364564,2385.21774,2967.143203,Malicious
10.0.2.15,60028,119.254.87.201,80,11,1560,6,705,5,855,15989.76075,2.218972,2541.717516,3082.508477,Malicious
10.0.2.15,43587,119.254.87.201,80,11,1582,6,705,5,877,16014.81281,1.894406,2977.186517,3703.535567,Malicious
10.0.2.15,56598,119.254.87.201,80,11,1582,6,705,5,877,16017.02434,2.015938,2797.705088,3480.265762,Malicious
10.0.2.15,38392,119.254.87.201,80,11,1579,6,705,5,874,16019.81602,2.153447,2619.056796,3246.887432,Malicious
10.0.2.15,60379,119.254.87.201,80,11,1582,6,705,5,877,16044.84049,1.952428,2888.710877,3593.474382,Malicious
10.0.2.15,52066,119.254.87.201,80,11,1582,6,705,5,877,16047.03376,4.151341,1358.597138,1690.056297,Malicious
10.0.2.15,33192,119.254.87.201,80,11,1579,6,705,5,874,16049.824,2.174034,2594.255656,3216.141054,Malicious
10.0.2.15,53828,119.254.87.201,80,11,1579,6,705,5,874,16074.86646,4.045288,1394.214701,1728.430708,Malicious
10.0.2.15,36676,119.254.87.201,80,11,1582,6,705,5,877,16077.09378,2.221873,2538.398909,3157.696232,Malicious
10.0.2.15,40249,119.254.87.201,80,11,1582,6,705,5,877,16079.88431,2.210593,2551.351606,3173.809019,Malicious
10.0.2.15,55055,119.254.87.201,80,11,1579,6,705,5,874,16104.90197,2.04954,2751.836998,3411.497214,Malicious
10.0.2.15,37202,119.254.87.201,80,11,1582,6,705,5,877,16107.1215,2.118927,2661.724543,3311.109821,Malicious
10.0.2.15,36683,119.254.87.201,80,11,1579,6,705,5,874,16109.94254,2.154959,2617.219168,3244.609294,Malicious
10.0.2.15,41948,119.254.87.201,80,11,1579,6,705,5,874,16134.92451,1.160526,4859.865268,6024.854247,Malicious
10.0.2.15,57214,119.254.87.201,80,11,1579,6,705,5,874,16137.15056,0.822522,6856.959449,8500.68448,Malicious
10.0.2.15,44171,119.254.87.201,80,11,1582,6,705,5,877,16139.9999,1.56226,3610.15452,4490.929807,Malicious
10.0.2.15,45269,119.254.87.201,80,11,1582,6,705,5,877,16164.96509,1.030651,5472.269469,6807.347977,Malicious
10.0.2.15,36023,119.254.87.201,80,11,1582,6,705,5,877,16167.17104,1.166651,4834.350633,6013.795042,Malicious
10.0.2.15,34349,119.254.87.201,80,12,1632,7,779,5,853,16170.00217,3.913807,1592.311527,1743.570902,Malicious
10.0.2.15,33290,119.254.87.201,80,11,1579,6,705,5,874,16194.98604,2.322411,2428.510716,3010.664348,Malicious
10.0.2.15,47393,119.254.87.201,80,13,1661,8,853,5,808,16197.17539,11.251335,606.5058058,574.5096026,Malicious
10.0.2.15,37069,119.254.87.201,80,12,1653,7,779,5,874,16200.01884,5.178781,1203.37199,1350.124672,Malicious
10.0.2.15,37713,119.254.87.201,80,11,1582,6,705,5,877,16224.98568,2.72164,2072.279949,2577.857468,Malicious
10.0.2.15,42996,119.254.87.201,80,11,1582,6,705,5,877,16227.17816,1.691945,3333.44169,4146.706896,Malicious
10.0.2.15,60778,119.254.87.201,80,11,1582,6,705,5,877,16230.07586,1.557306,3621.638907,4505.216059,Malicious
10.0.2.15,46225,119.254.87.201,80,12,1653,7,779,5,874,16254.99073,4.421066,1409.614785,1581.519027,Malicious
10.0.2.15,54382,119.254.87.201,80,11,1579,6,705,5,874,16257.23086,1.163921,4845.689699,6007.280563,Malicious
10.0.2.15,37224,119.254.87.201,80,11,1579,6,705,5,874,16260.11733,2.680629,2103.983804,2608.343042,Malicious
10.0.2.15,33557,119.254.87.201,80,11,1582,6,705,5,877,16285.00462,2.029832,2778.555073,3456.443686,Malicious
10.0.2.15,39067,119.254.87.201,80,11,1534,6,705,5,829,16287.36461,2.010901,2804.712912,3298.02412,Malicious
10.0.2.15,38348,119.254.87.201,80,11,1513,6,705,5,808,16290.28329,2.144274,2630.260872,3014.540119,Malicious
10.0.2.15,43625,119.254.87.201,80,11,1513,6,705,5,808,16315.04359,2.019614,2792.612846,3200.611602,Malicious
10.0.2.15,56220,119.254.87.201,80,11,1582,6,705,5,877,16317.29758,2.183629,2582.856337,3213.000011,Malicious
10.0.2.15,48048,119.254.87.201,80,11,1582,6,705,5,877,16320.19465,2.149683,2623.642649,3263.737025,Malicious
10.0.2.15,45761,119.254.87.201,80,11,1579,6,705,5,874,16345.07765,1.52023,3709.96494,4599.304053,Malicious
10.0.2.15,49606,119.254.87.201,80,11,1513,6,705,5,808,16347.31297,1.221952,4615.565914,5289.896821,Malicious
10.0.2.15,36519,119.254.87.201,80,13,1730,8,853,5,877,16350.19956,12.783719,533.8039736,548.8230772,Malicious
10.0.2.15,56561,119.254.87.201,80,11,1582,6,705,5,877,16375.09313,1.246509,4524.636405,5628.519329,Malicious
10.0.2.15,56189,119.254.87.201,80,11,1582,6,705,5,877,16377.31697,2.8178,2001.561502,2489.885726,Malicious
10.0.2.15,50413,119.254.87.201,80,11,1579,6,705,5,874,16380.24911,1.221509,4617.239824,5724.067526,Malicious
10.0.2.15,49205,119.254.87.201,80,11,1513,6,705,5,808,16405.14967,1.357512,4154.659406,4761.652199,Malicious
10.0.2.15,41183,119.254.87.201,80,11,1579,6,705,5,874,16407.35125,1.02107,5523.617382,6847.71857,Malicious
10.0.2.15,54141,119.254.87.201,80,11,1544,6,705,5,839,16410.31092,1.233379,4572.803656,5441.960663,Malicious
10.0.2.15,55927,119.254.87.201,80,11,1560,6,705,5,855,16435.18772,3.429261,1644.669216,1994.598836,Malicious
10.0.2.15,52947,119.254.87.201,80,11,1579,6,705,5,874,16437.37041,1.047587,5383.801059,6674.385994,Malicious
10.0.2.15,38779,119.254.87.201,80,11,1579,6,705,5,874,16440.33902,2.087098,2702.316805,3350.106224,Malicious
10.0.2.15,41656,119.254.87.201,80,11,1582,6,705,5,877,16465.23957,0.864087,6527.120533,8119.552776,Malicious
10.0.2.15,34225,119.254.87.201,80,11,1579,6,705,5,874,16467.40761,1.719122,3280.744473,4067.192439,Malicious
10.0.2.15,36119,119.254.87.201,80,11,1579,6,705,5,874,16470.36893,1.419811,3972.359701,4924.599119,Malicious
10.0.2.15,36935,119.254.87.201,80,12,1587,7,779,5,808,16495.29713,7.396277,842.586074,873.9532065,Malicious
10.0.2.15,34251,119.254.87.201,80,11,1582,6,705,5,877,16497.46738,1.361918,4141.218487,5151.558317,Malicious
10.0.2.15,33332,119.254.87.201,80,11,1579,6,705,5,874,16500.40473,3.588697,1571.601057,1948.339467,Malicious
10.0.2.15,43488,119.254.87.201,80,11,1579,6,705,5,874,16525.3361,1.023937,5508.15138,6828.545116,Malicious
10.0.2.15,59275,119.254.87.201,80,12,1587,7,779,5,808,16527.63249,4.876614,1277.935879,1325.509872,Malicious
10.0.2.15,40138,119.254.87.201,80,11,1579,6,705,5,874,16530.40908,0.957205,5892.154763,7304.600373,Malicious
10.0.2.15,52705,119.254.87.201,80,13,1730,8,853,5,877,16555.36485,13.482111,506.1521894,520.3932826,Malicious
10.0.2.15,48009,119.254.87.201,80,11,1579,6,705,5,874,16557.58708,1.245692,4527.603934,5612.944452,Malicious
10.0.2.15,52349,119.254.87.201,80,11,1582,6,705,5,877,16560.41264,1.457149,3870.571918,4814.881663,Malicious
10.0.2.15,57324,119.254.87.201,80,11,1582,6,705,5,877,16585.41816,1.223175,4610.951009,5735.892248,Malicious
10.0.2.15,37559,119.254.87.201,80,11,1582,6,705,5,877,16587.61405,2.402458,2347.595671,2920.342416,Malicious
10.0.2.15,59930,119.254.87.201,80,11,1582,6,705,5,877,16590.45682,1.418666,3975.565778,4945.491046,Malicious
10.0.2.15,55707,119.254.87.201,80,11,1582,6,705,5,877,16615.44613,1.286911,4382.587452,5451.814461,Malicious
10.0.2.15,56987,119.254.87.201,80,11,1582,6,705,5,877,16617.63983,1.687385,3342.450004,4157.912984,Malicious
10.0.2.15,39928,119.254.87.201,80,11,1513,6,705,5,808,16620.51353,3.079737,1831.325207,2098.880521,Malicious
10.0.2.15,52182,119.254.87.201,80,11,1513,6,705,5,808,16645.47292,3.423951,1647.219835,1887.877484,Malicious
10.0.2.15,42653,119.254.87.201,80,11,1579,6,705,5,874,16647.66037,1.536509,3670.658616,4550.575363,Malicious
10.0.2.15,59922,119.254.87.201,80,11,1513,6,705,5,808,16650.57137,1.221526,4617.175566,5291.741641,Malicious
10.0.2.15,35037,119.254.87.201,80,11,1579,6,705,5,874,16675.51749,1.268918,4444.731653,5510.206333,Malicious
10.0.2.15,42966,119.254.87.201,80,11,1582,6,705,5,877,16677.69156,1.289979,4372.164198,5438.848229,Malicious
10.0.2.15,59667,119.254.87.201,80,11,1582,6,705,5,877,16680.63396,1.215573,4639.787162,5771.763604,Malicious
10.0.2.15,47318,119.254.87.201,80,11,1513,6,705,5,808,16705.52895,2.111203,2671.462668,3061.76147,Malicious
10.0.2.15,57162,119.254.87.201,80,11,1582,6,705,5,877,16707.75374,1.991451,2832.105836,3523.059317,Malicious
10.0.2.15,44097,119.254.87.201,80,11,1582,6,705,5,877,16710.6417,2.107635,2675.985168,3328.849635,Malicious
10.0.2.15,57709,119.254.87.201,80,11,1558,6,705,5,853,16735.56522,2.115617,2665.888958,3225.536569,Malicious
10.0.2.15,58040,119.254.87.201,80,11,1582,6,705,5,877,16737.78641,2.149578,2623.770805,3263.896449,Malicious
10.0.2.15,35792,119.254.87.201,80,11,1579,6,705,5,874,16740.65973,2.088275,2700.793717,3348.218027,Malicious
10.0.2.15,43995,119.254.87.201,80,13,1717,8,853,5,864,16765.62019,13.158647,518.5943509,525.2819686,Malicious
10.0.2.15,55861,119.254.87.201,80,11,1513,6,705,5,808,16767.78674,3.245094,1738.008206,1991.929972,Malicious
10.0.2.15,37834,119.254.87.201,80,11,1569,6,705,5,864,16770.6995,1.090237,5173.187114,6339.90591,Malicious
10.0.2.15,50784,119.254.87.201,80,11,1558,6,705,5,853,16795.68208,1.754101,3215.322265,3890.311903,Malicious
10.0.2.15,37172,119.254.87.201,80,12,1656,7,779,5,877,16797.91261,4.16877,1494.925362,1682.990426,Malicious
10.0.2.15,37924,119.254.87.201,80,11,1582,6,705,5,877,16800.72161,1.426774,3952.973631,4917.387056,Malicious
10.0.2.15,40841,119.254.87.201,80,11,1582,6,705,5,877,16825.70608,1.95284,2888.101432,3592.716249,Malicious
10.0.2.15,54851,119.254.87.201,80,11,1560,6,705,5,855,16827.83695,2.096163,2690.630452,3263.105016,Malicious
10.0.2.15,54783,119.254.87.201,80,11,1579,6,705,5,874,16830.77492,2.09312,2694.542119,3340.467818,Malicious
10.0.2.15,35943,119.254.87.201,80,11,1568,6,705,5,863,16855.73806,1.855613,3039.426863,3720.60338,Malicious
10.0.2.15,49648,119.254.87.201,80,11,1579,6,705,5,874,16857.89953,1.952209,2889.034934,3581.583734,Malicious
10.0.2.15,44779,119.254.87.201,80,11,1579,6,705,5,874,16860.84187,1.823895,3092.283273,3833.554015,Malicious
10.0.2.15,56258,119.254.87.201,80,11,1579,6,705,5,874,16885.79756,1.554791,3627.497201,4497.067452,Malicious
10.0.2.15,55070,119.254.87.201,80,11,1582,6,705,5,877,16887.92661,1.450789,3887.539815,4835.989244,Malicious
10.0.2.15,48222,119.254.87.201,80,11,1579,6,705,5,874,16891.02816,1.371219,4113.128537,5099.112541,Malicious
10.0.2.15,43117,119.254.87.201,80,13,1730,8,853,5,877,16915.85214,10.411106,655.453897,673.8957417,Malicious
10.0.2.15,50039,119.254.87.201,80,11,1582,6,705,5,877,16917.9536,1.427493,3950.982597,4914.910266,Malicious
10.0.2.15,37595,119.254.87.201,80,11,1579,6,705,5,874,16920.89262,2.821496,1998.93957,2478.117991,Malicious
10.0.2.15,35295,119.254.87.201,80,11,1582,6,705,5,877,16945.89027,1.351466,4173.245942,5191.399562,Malicious
10.0.2.15,53086,119.254.87.201,80,11,1579,6,705,5,874,16948.01413,0.894101,6308.012182,7820.145599,Malicious
10.0.2.15,33262,119.254.87.201,80,11,1585,6,705,5,880,16951.00197,1.389887,4057.883842,5065.159973,Malicious
10.0.2.15,58762,119.254.87.201,80,11,1579,6,705,5,874,16975.91349,0.894989,6301.753429,7812.386521,Malicious
10.0.2.15,42084,119.254.87.201,80,11,1513,6,705,5,808,16978.05128,1.41809,3977.180574,4558.243835,Malicious
10.0.2.15,57672,119.254.87.201,80,11,1582,6,705,5,877,16980.98013,2.470126,2283.284334,2840.340938,Malicious
10.0.2.15,40230,119.254.87.201,80,11,1579,6,705,5,874,17005.923,1.655124,3407.599672,4224.456899,Malicious
10.0.2.15,42624,119.254.87.201,80,11,1582,6,705,5,877,17008.07942,1.308739,4309.491809,5360.885555,Malicious
10.0.2.15,60203,119.254.87.201,80,11,1582,6,705,5,877,17011.02101,1.388195,4062.82979,5054.045001,Malicious
10.0.2.15,45409,119.254.87.201,80,11,1582,6,705,5,877,17035.98157,2.213257,2548.280656,3169.988844,Malicious
10.0.2.15,40043,119.254.87.201,80,11,1582,6,705,5,877,17038.12834,2.159633,2611.554834,3248.700126,Malicious
10.0.2.15,57864,119.254.87.201,80,11,1582,6,705,5,877,17041.05276,2.215186,2546.061595,3167.228395,Malicious
10.0.2.15,57129,119.254.87.201,80,11,1582,6,705,5,877,17066.00573,2.054707,2744.916915,3414.598772,Malicious
10.0.2.15,35768,119.254.87.201,80,11,1582,6,705,5,877,17068.16572,2.106768,2677.086419,3330.219559,Malicious
10.0.2.15,41409,119.254.87.201,80,11,1513,6,705,5,808,17071.1056,2.025014,2785.16593,3192.076697,Malicious
10.0.2.15,43442,119.254.87.201,80,11,1582,6,705,5,877,17096.06056,1.360636,4145.12037,5156.412148,Malicious
10.0.2.15,33102,119.254.87.201,80,11,1582,6,705,5,877,17098.19128,1.617865,3486.075785,4336.579381,Malicious
10.0.2.15,56612,119.254.87.201,80,11,1582,6,705,5,877,17101.10761,1.392679,4049.748722,5037.772523,Malicious
10.0.2.15,49854,119.254.87.201,80,11,1582,6,705,5,877,17126.09605,1.658833,3399.980589,4229.479399,Malicious
10.0.2.15,58963,119.254.87.201,80,11,1534,6,705,5,829,17128.19247,3.1904,1767.80341,2078.736209,Malicious
10.0.2.15,35016,119.254.87.201,80,11,1582,6,705,5,877,17131.18384,1.227071,4596.311053,5717.680558,Malicious
10.0.2.15,43493,119.254.87.201,80,11,1579,6,705,5,874,17156.11365,2.085899,2703.87013,3352.031906,Malicious
10.0.2.15,55634,119.254.87.201,80,11,1585,6,705,5,880,17158.24547,2.024074,2786.459388,3478.133705,Malicious
10.0.2.15,50034,119.254.87.201,80,11,1582,6,705,5,877,17161.24597,2.095652,2691.28653,3347.884095,Malicious
10.0.2.15,47668,119.254.87.201,80,11,1582,6,705,5,877,17186.15115,1.823048,3093.719968,3848.499875,Malicious
10.0.2.15,55219,119.254.87.201,80,13,1661,8,853,5,808,17188.27972,10.066776,677.8734324,642.1122314,Malicious
10.0.2.15,53891,119.254.87.201,80,11,1582,6,705,5,877,17191.27935,1.183055,4767.31851,5930.408984,Malicious
10.0.2.15,46982,119.254.87.201,80,11,1579,6,705,5,874,17216.15369,2.217275,2543.662829,3153.420302,Malicious
10.0.2.15,44548,119.254.87.201,80,11,1582,6,705,5,877,17218.30395,4.318159,1306.112165,1624.76648,Malicious
10.0.2.15,48984,119.254.87.201,80,11,1582,6,705,5,877,17221.38541,2.194593,2569.952606,3196.948136,Malicious
10.0.2.15,60575,119.254.87.201,80,11,1579,6,705,5,874,17246.17944,1.155085,4882.757546,6053.234178,Malicious
10.0.2.15,44124,119.254.87.201,80,11,1579,6,705,5,874,17248.31074,1.520886,3708.36473,4597.320246,Malicious
10.0.2.15,49642,119.254.87.201,80,11,1579,6,705,5,874,17251.33504,1.171697,4813.531143,5967.413077,Malicious
10.0.2.15,49831,119.254.87.201,80,11,1560,6,705,5,855,17276.23668,1.451659,3885.209956,4711.850373,Malicious
10.0.2.15,34449,119.254.87.201,80,11,1513,6,705,5,808,17278.33296,1.488349,3789.433795,4343.067385,Malicious
10.0.2.15,48802,119.254.87.201,80,11,1579,6,705,5,874,17281.39284,1.317723,4280.110463,5306.122759,Malicious
10.0.2.15,43711,119.254.87.201,80,12,1656,7,779,5,877,17306.26489,4.945148,1260.225174,1418.764413,Malicious
10.0.2.15,38620,119.254.87.201,80,12,1653,7,779,5,874,17308.36569,4.606474,1352.878579,1517.863772,Malicious
10.0.2.15,60527,119.254.87.201,80,11,1582,6,705,5,877,17311.45253,1.789516,3151.690178,3920.613171,Malicious
10.0.2.15,55895,119.254.87.201,80,11,1513,6,705,5,808,17336.31284,1.298979,4341.871578,4976.215936,Malicious
10.0.2.15,40307,119.254.87.201,80,12,1653,7,779,5,874,17338.48177,4.027029,1547.542866,1736.267606,Malicious
10.0.2.15,51928,119.254.87.201,80,11,1582,6,705,5,877,17341.45988,1.320013,4272.685193,5315.099169,Malicious
10.0.2.15,37391,119.254.87.201,80,11,1579,6,705,5,874,17366.32715,1.430155,3943.628488,4888.980565,Malicious
10.0.2.15,54915,119.254.87.201,80,11,1582,6,705,5,877,17368.3934,2.883071,1956.247349,2433.516205,Malicious
10.0.2.15,59136,119.254.87.201,80,11,1582,6,705,5,877,17371.5151,1.572444,3586.773201,4461.84411,Malicious
10.0.2.15,54735,119.254.87.201,80,11,1582,6,705,5,877,17396.32836,1.422644,3964.449293,4931.662454,Malicious
10.0.2.15,55788,119.254.87.201,80,11,1582,6,705,5,877,17398.45264,2.885449,1954.635137,2431.510659,Malicious
10.0.2.15,33550,119.254.87.201,80,11,1579,6,705,5,874,17401.57579,1.420454,3970.561525,4922.36989,Malicious
10.0.2.15,41916,119.254.87.201,80,13,1661,8,853,5,808,17426.356,10.1559,671.924694,636.4773186,Malicious
10.0.2.15,39761,119.254.87.201,80,11,1579,6,705,5,874,17428.51515,1.216773,4635.211334,5746.3471,Malicious
10.0.2.15,41671,119.254.87.201,80,11,1579,6,705,5,874,17431.62719,1.162781,4850.440453,6013.17015,Malicious
10.0.2.15,46855,119.254.87.201,80,11,1582,6,705,5,877,17456.40885,2.023588,2787.128605,3467.108917,Malicious
10.0.2.15,42166,119.254.87.201,80,12,1656,7,779,5,877,17458.63556,5.161979,1207.28891,1359.168644,Malicious
10.0.2.15,37905,119.254.87.201,80,11,1593,6,705,5,888,17461.63535,2.300278,2451.877556,3088.322368,Malicious
10.0.2.15,55655,119.254.87.201,80,11,1582,6,705,5,877,17486.41614,2.619426,2153.143475,2678.449401,Malicious
10.0.2.15,43433,119.254.87.201,80,11,1582,6,705,5,877,17488.60363,1.439506,3918.010762,4873.894239,Malicious
10.0.2.15,36935,119.254.87.201,80,11,1582,6,705,5,877,17491.82298,1.273191,4429.814537,5510.563615,Malicious
10.0.2.15,59871,119.254.87.201,80,11,1579,6,705,5,874,17516.43432,1.415505,3984.443714,4939.579867,Malicious
10.0.2.15,33160,119.254.87.201,80,11,1579,6,705,5,874,17518.62662,1.164272,4844.22884,6005.469512,Malicious
10.0.2.15,60518,119.254.87.201,80,13,1727,8,853,5,874,17521.68903,10.032073,680.2183357,696.9646254,Malicious
10.0.2.15,37202,119.254.87.201,80,11,1582,6,705,5,877,17546.46384,1.485737,3796.09581,4722.235497,Malicious
10.0.2.15,58217,119.254.87.201,80,11,1579,6,705,5,874,17548.65796,0.923646,6106.235506,7569.999762,Malicious
10.0.2.15,57586,119.254.87.201,80,11,1582,6,705,5,877,17551.74716,1.476497,3819.851988,4751.787508,Malicious
10.0.2.15,40912,119.254.87.201,80,11,1579,6,705,5,874,17576.46608,1.356244,4158.543743,5155.414512,Malicious
10.0.2.15,53467,119.254.87.201,80,12,1653,7,779,5,874,17578.65966,3.985723,1563.580811,1754.261397,Malicious
10.0.2.15,53828,119.254.87.201,80,3,222,3,222,0,0,17581.75279,9.042574,196.4042539,0,Malicious
10.0.2.15,41632,119.254.87.201,80,11,1579,6,705,5,874,17606.46947,0.820441,6874.351721,8522.245963,Malicious
10.0.2.15,46248,119.254.87.201,80,11,1582,6,705,5,877,17608.81541,1.424499,3959.286739,4925.240383,Malicious
10.0.2.15,39267,119.254.87.201,80,11,1582,6,705,5,877,17611.81046,1.409506,4001.40191,4977.630461,Malicious
10.0.2.15,51218,119.254.87.201,80,11,1582,6,705,5,877,17636.50503,1.508525,3738.751429,4650.900714,Malicious
10.0.2.15,40534,119.254.87.201,80,11,1593,6,705,5,888,17638.78274,1.484855,3798.350681,4784.305538,Malicious
10.0.2.15,39768,119.254.87.201,80,11,1582,6,705,5,877,17641.83518,2.450519,2301.553263,2863.066967,Malicious
10.0.2.15,49826,119.254.87.201,80,11,1579,6,705,5,874,17666.51639,1.555921,3624.862702,4493.801421,Malicious
10.0.2.15,43358,119.254.87.201,80,11,1579,6,705,5,874,17668.84213,1.192231,4730.626867,5864.635293,Malicious
10.0.2.15,42397,119.254.87.201,80,11,1513,6,705,5,808,17671.86668,1.448752,3893.005842,4461.771235,Malicious
10.0.2.15,48070,119.254.87.201,80,11,1579,6,705,5,874,17696.55209,1.754934,3213.796074,3984.195417,Malicious
10.0.2.15,52092,119.254.87.201,80,11,1582,6,705,5,877,17698.88909,1.089895,5174.810418,6437.317356,Malicious
10.0.2.15,57597,119.254.87.201,80,11,1534,6,705,5,829,17701.88926,1.447783,3895.611428,4580.796984,Malicious
10.0.2.15,55567,119.254.87.201,80,11,1513,6,705,5,808,17726.55663,1.480001,3810.808236,4367.564617,Malicious
10.0.2.15,36934,119.254.87.201,80,12,1656,7,779,5,877,17728.96156,3.99128,1561.40386,1757.832074,Malicious
10.0.2.15,52022,119.254.87.201,80,11,1579,6,705,5,874,17731.93063,0.954236,5910.487552,7327.327831,Malicious
10.0.2.15,48727,119.254.87.201,80,11,1582,6,705,5,877,17756.55691,1.4194,3973.509934,4942.933634,Malicious
10.0.2.15,44886,119.254.87.201,80,11,1582,6,705,5,877,17758.95016,1.272257,4433.06659,5514.609077,Malicious
10.0.2.15,59786,119.254.87.201,80,11,1579,6,705,5,874,17761.98675,1.311737,4299.642383,5330.336798,Malicious
10.0.2.15,38687,119.254.87.201,80,11,1582,6,705,5,877,17786.58195,0.823115,6852.019463,8523.717828,Malicious
10.0.2.15,58125,119.254.87.201,80,11,1569,6,705,5,864,17789.01365,1.285473,4387.490052,5377.009085,Malicious
10.0.2.15,41808,119.254.87.201,80,11,1513,6,705,5,808,17792.00606,1.419138,3974.24352,4554.877679,Malicious
10.0.2.15,37692,119.254.87.201,80,11,1582,6,705,5,877,17816.61031,1.751409,3220.26437,4005.917521,Malicious
10.0.2.15,45596,119.254.87.201,80,12,1656,7,779,5,877,17819.00629,4.528517,1376.16796,1549.293069,Malicious
10.0.2.15,58768,119.254.87.201,80,11,1582,6,705,5,877,17822.038,1.165857,4837.643039,6017.890702,Malicious
10.0.2.15,59422,119.254.87.201,80,11,1579,6,705,5,874,17846.61636,2.019035,2793.413685,3463.040512,Malicious
10.0.2.15,54194,119.254.87.201,80,11,1579,6,705,5,874,17849.04122,2.069314,2725.540928,3378.897548,Malicious
10.0.2.15,34163,119.254.87.201,80,11,1582,6,705,5,877,17852.09214,2.256465,2499.484814,3109.288201,Malicious
10.0.2.15,37786,119.254.87.201,80,11,1593,6,705,5,888,17876.64052,1.618642,3484.402357,4388.864245,Malicious
10.0.2.15,40279,119.254.87.201,80,11,1513,6,705,5,808,17879.09715,6.303105,894.7970881,1025.526308,Malicious
10.0.2.15,44259,119.254.87.201,80,11,1582,6,705,5,877,17882.1512,1.420064,3971.651982,4940.622394,Malicious
10.0.2.15,50887,119.254.87.201,80,12,1656,7,779,5,877,17906.66121,4.407626,1413.913068,1591.786599,Malicious
10.0.2.15,38297,119.254.87.201,80,11,1582,6,705,5,877,17909.13027,1.192521,4729.476462,5883.334549,Malicious
10.0.2.15,60055,119.254.87.201,80,11,1559,6,705,5,854,17912.18161,1.356267,4158.473221,5037.356214,Malicious
10.0.2.15,56975,119.254.87.201,80,11,1579,6,705,5,874,17936.69587,1.234831,4567.426636,5662.313304,Malicious
10.0.2.15,59570,119.254.87.201,80,11,1582,6,705,5,877,17939.25449,1.049001,5376.543969,6688.268171,Malicious
10.0.2.15,40659,119.254.87.201,80,11,1582,6,705,5,877,17942.21351,1.121134,5030.620782,6257.94954,Malicious
10.0.2.15,39272,119.254.87.201,80,11,1513,6,705,5,808,17966.74834,5.174028,1090.059814,1249.31678,Malicious
10.0.2.15,47456,119.254.87.201,80,11,1579,6,705,5,874,17969.23755,126.959641,44.42356607,55.07261949,Malicious
10.0.2.15,55571,119.254.87.201,80,11,1582,6,705,5,877,17972.23937,2.19401,2570.635503,3197.79764,Malicious
10.0.2.15,48271,119.254.87.201,80,11,1579,6,705,5,874,17996.78346,1.076387,5239.75113,6495.804947,Malicious
10.0.2.15,33749,119.254.87.201,80,13,1727,8,853,5,874,17999.29849,10.426618,654.4787581,670.5913653,Malicious
10.0.2.15,50759,119.254.87.201,80,12,1656,7,779,5,877,18002.2855,9.528754,654.0204522,736.2977363,Malicious
10.0.2.15,51513,119.254.87.201,80,12,1587,7,779,5,808,18026.81153,4.103175,1518.823838,1575.365418,Malicious
10.0.2.15,59252,119.254.87.201,80,12,1626,7,779,5,847,18029.29855,249.696778,24.95827159,27.13691404,Malicious
10.0.2.15,33453,119.254.87.201,80,12,1653,7,779,5,874,18032.27967,6.561193,949.8272646,1065.659858,Malicious
10.0.2.15,40232,119.254.87.201,80,13,1730,8,853,5,877,18056.84121,19.469442,350.4979752,360.359583,Malicious
10.0.2.15,59638,119.254.87.201,80,11,1582,6,705,5,877,18059.35519,1.217076,4634.057364,5764.635898,Malicious
10.0.2.15,60245,119.254.87.201,80,13,1730,8,853,5,877,18062.35268,10.018931,681.1105895,700.2743107,Malicious
10.0.2.15,45190,119.254.87.201,80,11,1579,6,705,5,874,18086.8733,1.442691,3909.361048,4846.498661,Malicious
10.0.2.15,56007,119.254.87.201,80,11,1513,6,705,5,808,18089.3833,1.292667,4363.072624,5000.51444,Malicious
10.0.2.15,36789,119.254.87.201,80,11,1513,6,705,5,808,18092.52495,1.225081,4603.77722,5276.385806,Malicious
10.0.2.15,54490,119.254.87.201,80,11,1579,6,705,5,874,18116.93656,2.279082,2474.680595,3067.901901,Malicious
10.0.2.15,39765,119.254.87.201,80,11,1582,6,705,5,877,18119.3892,2.156563,2615.272542,3253.324851,Malicious
10.0.2.15,40817,119.254.87.201,80,11,1513,6,705,5,808,18122.44662,125.202975,45.04685292,51.62816618,Malicious
10.0.2.15,35340,119.254.87.201,80,11,1587,6,705,5,882,18146.9861,2.018425,2794.257899,3495.794989,Malicious
10.0.2.15,56776,119.254.87.201,80,11,1513,6,705,5,808,18149.44525,2.21213,2549.578913,2922.070584,Malicious
10.0.2.15,33329,119.254.87.201,80,11,1582,6,705,5,877,18152.50259,2.053822,2746.099711,3416.070137,Malicious
10.0.2.15,52647,119.254.87.201,80,11,1582,6,705,5,877,18176.99673,1.553394,3630.759485,4516.5618,Malicious
10.0.2.15,60923,119.254.87.201,80,11,1582,6,705,5,877,18179.4688,0.95032,5934.843,7382.776328,Malicious
10.0.2.15,33533,119.254.87.201,80,11,1582,6,705,5,877,18182.5282,1.198908,4704.280896,5851.991979,Malicious
10.0.2.15,55732,119.254.87.201,80,11,1513,6,705,5,808,18207.05467,2.134121,2642.774238,3028.88168,Malicious
10.0.2.15,55728,119.254.87.201,80,11,1582,6,705,5,877,18209.49934,2.222423,2537.770712,3156.914773,Malicious
10.0.2.15,47315,119.254.87.201,80,11,1582,6,705,5,877,18212.56402,2.173899,2594.41676,3227.380849,Malicious
10.0.2.15,43789,119.254.87.201,80,11,1582,6,705,5,877,18237.09898,5.338511,1056.474361,1314.224135,Malicious
10.0.2.15,39541,119.254.87.201,80,12,1656,7,779,5,877,18239.53689,5.189621,1200.858406,1351.929168,Malicious
10.0.2.15,56777,119.254.87.201,80,11,1579,6,705,5,874,18242.61717,4.033409,1398.320874,1733.521198,Malicious
10.0.2.15,36556,119.254.87.201,80,12,1653,7,779,5,874,18267.12627,4.432851,1405.86724,1577.314464,Malicious
10.0.2.15,43225,119.254.87.201,80,11,1582,6,705,5,877,18269.59811,0.970515,5811.347583,7229.151533,Malicious
10.0.2.15,38314,119.254.87.201,80,11,1579,6,705,5,874,18272.65878,1.08839,5181.966023,6424.167807,Malicious
10.0.2.15,49995,119.254.87.201,80,11,1582,6,705,5,877,18297.18931,2.016516,2796.903174,3479.268203,Malicious
10.0.2.15,35694,119.254.87.201,80,11,1582,6,705,5,877,18299.65328,4.324579,1304.173192,1622.354453,Malicious
10.0.2.15,41935,119.254.87.201,80,11,1513,6,705,5,808,18302.70794,2.018952,2793.528524,3201.66106,Malicious
10.0.2.15,38511,119.254.87.201,80,11,1579,6,705,5,874,18327.19973,2.834774,1989.576594,2466.510558,Malicious
10.0.2.15,59287,119.254.87.201,80,11,1513,6,705,5,808,18329.70427,1.352233,4170.878835,4780.241275,Malicious
10.0.2.15,59977,119.254.87.201,80,11,1579,6,705,5,874,18332.72268,1.434977,3930.376584,4872.551964,Malicious
10.0.2.15,41157,119.254.87.201,80,11,1579,6,705,5,874,18357.25244,1.480698,3809.014397,4722.097281,Malicious
10.0.2.15,35454,119.254.87.201,80,11,1582,6,705,5,877,18359.70763,1.386638,4067.391778,5059.719985,Malicious
10.0.2.15,49891,119.254.87.201,80,11,1579,6,705,5,874,18362.73412,1.240159,4547.803951,5637.986742,Malicious
10.0.2.15,49957,119.254.87.201,80,13,1730,8,853,5,877,18387.25308,14.355247,475.3662546,488.7411551,Malicious
10.0.2.15,59930,119.254.87.201,80,12,1587,7,779,5,808,18389.73434,7.215798,863.6605404,895.8122165,Malicious
10.0.2.15,60274,119.254.87.201,80,12,1656,7,779,5,877,18392.8729,14.108447,441.7211901,497.2907365,Malicious
10.0.2.15,50728,119.254.87.201,80,12,1653,7,779,5,874,18417.25438,4.175299,1492.587716,1674.610609,Malicious
10.0.2.15,37378,119.254.87.201,80,12,1656,7,779,5,877,18419.76062,11.795299,528.3460809,594.8132387,Malicious
10.0.2.15,54775,119.254.87.201,80,11,1579,6,705,5,874,18422.79888,1.799838,3133.615359,3884.794076,Malicious
10.0.2.15,48986,119.254.87.201,80,11,1579,6,705,5,874,18447.28005,1.204259,4683.377911,5806.059992,Malicious
10.0.2.15,46136,119.254.87.201,80,11,1513,6,705,5,808,18449.76252,1.556833,3622.73924,4152.018874,Malicious
10.0.2.15,49123,119.254.87.201,80,11,1582,6,705,5,877,18452.94705,3.411337,1653.310711,2056.671622,Malicious
10.0.2.15,37113,119.254.87.201,80,11,1582,6,705,5,877,18477.2776,1.748408,3225.791692,4012.793353,Malicious
10.0.2.15,58197,119.254.87.201,80,11,1579,6,705,5,874,18479.79799,3.490039,1616.027787,2003.416008,Malicious
10.0.2.15,51194,119.254.87.201,80,11,1579,6,705,5,874,18482.855,1.667115,3383.089949,4194.071795,Malicious
10.0.2.15,32978,119.254.87.201,80,11,1582,6,705,5,877,18507.33637,1.225215,4603.273711,5726.341907,Malicious
10.0.2.15,58614,119.254.87.201,80,11,1582,6,705,5,877,18509.83055,1.430081,3943.832552,4906.015813,Malicious
10.0.2.15,36042,119.254.87.201,80,11,1582,6,705,5,877,18512.89175,1.643059,3432.621714,4270.084032,Malicious
10.0.2.15,33155,119.254.87.201,80,10,981,6,725,4,256,18537.33622,135.765244,42.72080121,15.08486222,Malicious
10.0.2.15,55239,119.254.87.201,80,11,1579,6,705,5,874,18539.90791,123.818284,45.5506232,56.46985061,Malicious
10.0.2.15,54567,119.254.87.201,80,9,907,5,651,4,256,18542.91506,131.515345,39.59994174,15.57232732,Malicious
10.0.2.15,35752,119.254.87.201,80,11,1579,6,705,5,874,18567.39712,1.448937,3892.508784,4825.606634,Malicious
10.0.2.15,55573,119.254.87.201,80,11,1582,6,705,5,877,18570.01252,4.468686,1262.115978,1570.036472,Malicious
10.0.2.15,42594,119.254.87.201,80,11,1579,6,705,5,874,18572.96694,1.911169,2951.073401,3658.493833,Malicious
10.0.2.15,41330,119.254.87.201,80,11,1579,6,705,5,874,18597.44753,1.820225,3098.51804,3841.283358,Malicious
10.0.2.15,39376,119.254.87.201,80,12,1653,7,779,5,874,18599.9703,4.378922,1423.181322,1596.74002,Malicious
10.0.2.15,58502,119.254.87.201,80,11,1579,6,705,5,874,18603.00323,3.278634,1720.228607,2132.595465,Malicious
10.0.2.15,53161,119.254.87.201,80,11,1579,6,705,5,874,18627.51047,3.710969,1519.818678,1884.144007,Malicious
10.0.2.15,40122,119.254.87.201,80,11,1513,6,705,5,808,18630.01148,2.289056,2463.897781,2823.8715,Malicious
10.0.2.15,46155,119.254.87.201,80,11,1582,6,705,5,877,18633.00588,5.208719,1082.799821,1346.972259,Malicious
10.0.2.15,40398,119.254.87.201,80,11,1579,6,705,5,874,18657.56164,1.687494,3342.234106,4143.42214,Malicious
10.0.2.15,42145,119.254.87.201,80,11,1579,6,705,5,874,18660.02324,1.552891,3631.935532,4502.569723,Malicious
10.0.2.15,33108,119.254.87.201,80,11,1579,6,705,5,874,18663.02222,3.652031,1544.346146,1914.551109,Malicious
10.0.2.15,55896,119.254.87.201,80,11,1579,6,705,5,874,18687.56657,1.657198,3403.335027,4219.169948,Malicious
10.0.2.15,54964,119.254.87.201,80,13,1661,8,853,5,808,18690.05789,10.409302,655.5674915,620.98304,Malicious
10.0.2.15,46904,119.254.87.201,80,11,1513,6,705,5,808,18693.2406,1.777291,3173.368908,3636.995855,Malicious
10.0.2.15,42906,119.254.87.201,80,11,1582,6,705,5,877,18717.59964,1.676871,3363.407203,4183.983145,Malicious
10.0.2.15,52721,119.254.87.201,80,11,1582,6,705,5,877,18720.1173,1.355273,4161.523177,5176.816774,Malicious
10.0.2.15,57181,119.254.87.201,80,11,1582,6,705,5,877,18723.20315,2.3755,2374.237003,2953.483477,Malicious
10.0.2.15,44346,119.254.87.201,80,12,1667,7,779,5,888,18747.65747,4.66274,1336.553185,1523.567688,Malicious
10.0.2.15,35111,119.254.87.201,80,11,1513,6,705,5,808,18750.14093,1.774377,3178.580426,3642.968772,Malicious
10.0.2.15,37621,119.254.87.201,80,11,1579,6,705,5,874,18753.17079,1.513534,3726.378132,4619.651755,Malicious
10.0.2.15,54121,119.254.87.201,80,11,1569,6,705,5,864,18777.65667,2.161269,2609.577984,3198.121104,Malicious
10.0.2.15,50653,119.254.87.201,80,11,1582,6,705,5,877,18780.18569,2.293224,2459.419577,3059.448183,Malicious
10.0.2.15,42998,119.254.87.201,80,11,1582,6,705,5,877,18783.19857,5.220502,1080.355874,1343.932059,Malicious
10.0.2.15,43608,119.254.87.201,80,11,1579,6,705,5,874,18807.67653,1.589007,3549.386504,4400.232346,Malicious
10.0.2.15,56581,119.254.87.201,80,11,1582,6,705,5,877,18810.23664,1.458925,3865.860137,4809.02034,Malicious
10.0.2.15,46873,119.254.87.201,80,11,1582,6,705,5,877,18813.20294,1.611704,3499.401875,4353.156659,Malicious
10.0.2.15,40348,119.254.87.201,80,11,1582,6,705,5,877,18837.68162,1.456607,3872.012149,4816.673269,Malicious
10.0.2.15,33581,119.254.87.201,80,11,1513,6,705,5,808,18840.23847,1.612812,3496.99779,4007.906687,Malicious
10.0.2.15,47686,119.254.87.201,80,11,1544,6,705,5,839,18843.2292,4.482259,1258.294088,1497.459205,Malicious
10.0.2.15,36075,119.254.87.201,80,11,1582,6,705,5,877,18867.69225,8.098797,696.3997246,866.3015013,Malicious
10.0.2.15,59386,119.254.87.201,80,11,1579,6,705,5,874,18870.25765,2.354354,2395.561585,2969.816774,Malicious
10.0.2.15,56412,119.254.87.201,80,11,1582,6,705,5,877,18873.27899,1.520057,3710.387176,4615.616388,Malicious
10.0.2.15,42495,119.254.87.201,80,11,1579,6,705,5,874,18897.74327,2.606422,2163.885971,2682.604736,Malicious
10.0.2.15,55497,119.254.87.201,80,11,1582,6,705,5,877,18900.28289,1.748855,3224.967193,4011.767699,Malicious
10.0.2.15,58501,119.254.87.201,80,11,1593,6,705,5,888,18903.27127,4.712532,1196.808849,1507.46987,Malicious
10.0.2.15,54035,119.254.87.201,80,11,1582,6,705,5,877,18927.76783,1.920452,2936.808626,3653.306617,Malicious
10.0.2.15,39906,119.254.87.201,80,11,1579,6,705,5,874,18930.3266,1.62789,3464.607559,4295.130506,Malicious
10.0.2.15,40665,119.254.87.201,80,3,222,3,222,0,0,18933.32166,9.03183,196.6378907,0,Malicious
10.0.2.15,48190,119.254.87.201,80,11,1582,6,705,5,877,18957.77301,8.132206,693.538752,862.7425326,Malicious
10.0.2.15,39005,119.254.87.201,80,11,1579,6,705,5,874,18960.34723,1.638822,3441.496392,4266.479215,Malicious
10.0.2.15,58234,119.254.87.201,80,11,1579,6,705,5,874,18963.44444,1.462717,3855.838142,4780.145442,Malicious
10.0.2.15,58319,119.254.87.201,80,11,1579,6,705,5,874,18987.79109,1.458678,3866.514748,4793.381404,Malicious
10.0.2.15,52502,119.254.87.201,80,11,1582,6,705,5,877,18990.35389,1.244824,4530.760975,5636.138121,Malicious
10.0.2.15,57246,119.254.87.201,80,11,1513,6,705,5,808,18993.37976,1.665039,3387.308045,3882.191348,Malicious
10.0.2.15,56273,119.254.87.201,80,12,1656,7,779,5,877,19017.79985,3.996706,1559.28407,1755.445609,Malicious
10.0.2.15,33327,119.254.87.201,80,11,1585,6,705,5,880,19020.37059,1.781881,3165.194533,3950.881119,Malicious
10.0.2.15,41208,119.254.87.201,80,11,1579,6,705,5,874,19023.38551,1.015961,5551.394197,6882.153941,Malicious
10.0.2.15,38274,119.254.87.201,80,11,1582,6,705,5,877,19047.82458,2.242552,2514.991849,3128.578512,Malicious
10.0.2.15,41725,119.254.87.201,80,11,1582,6,705,5,877,19050.37458,1.413596,3989.824533,4963.228532,Malicious
10.0.2.15,51630,119.254.87.201,80,11,1582,6,705,5,877,19053.43414,1.818046,3102.231737,3859.088274,Malicious
10.0.2.15,49640,119.254.87.201,80,11,1579,6,705,5,874,19077.83166,2.865099,1968.518365,2440.404328,Malicious
10.0.2.15,39002,119.254.87.201,80,11,1579,6,705,5,874,19080.43211,1.025747,5498.431875,6816.495686,Malicious
10.0.2.15,42031,119.254.87.201,80,11,1579,6,705,5,874,19083.49125,1.589694,3547.852606,4398.330748,Malicious
10.0.2.15,54482,119.254.87.201,80,11,1579,6,705,5,874,19107.88346,2.192069,2572.91171,3189.680617,Malicious
10.0.2.15,52535,119.254.87.201,80,11,1582,6,705,5,877,19110.4575,2.290996,2461.811369,3062.423505,Malicious
10.0.2.15,48922,119.254.87.201,80,11,1579,6,705,5,874,19113.52422,2.178341,2589.126312,3209.782123,Malicious
10.0.2.15,34803,119.254.87.201,80,11,1579,6,705,5,874,19137.91996,1.690154,3336.974027,4136.901134,Malicious
10.0.2.15,60255,119.254.87.201,80,12,1656,7,779,5,877,19140.51878,6.121592,1018.035831,1146.107091,Malicious
10.0.2.15,39934,119.254.87.201,80,11,1582,6,705,5,877,19143.55297,1.482362,3804.738654,4732.986949,Malicious
10.0.2.15,53865,119.254.87.201,80,11,1582,6,705,5,877,19167.99033,1.725479,3268.657573,4066.117293,Malicious
10.0.2.15,39311,119.254.87.201,80,11,1587,6,705,5,882,19170.55719,1.661748,3394.016421,4246.131182,Malicious
10.0.2.15,54871,119.254.87.201,80,11,1579,6,705,5,874,19173.58355,1.844479,3057.774038,3790.772354,Malicious
10.0.2.15,51335,119.254.87.201,80,11,1579,6,705,5,874,19198.03209,1.650398,3417.35751,4236.553849,Malicious
10.0.2.15,52807,119.254.87.201,80,11,1579,6,705,5,874,19200.58476,1.885878,2990.649448,3707.556905,Malicious
10.0.2.15,60408,119.254.87.201,80,11,1569,6,705,5,864,19203.64159,3.138089,1797.272161,2202.614394,Malicious
10.0.2.15,36636,119.254.87.201,80,11,1579,6,705,5,874,19228.09114,1.714134,3290.291191,4079.027661,Malicious
10.0.2.15,48335,119.254.87.201,80,12,1661,7,779,5,882,19230.64322,4.684069,1330.467164,1506.382592,Malicious
10.0.2.15,43342,119.254.87.201,80,11,1582,6,705,5,877,19233.6919,1.502419,3753.946136,4669.802499,Malicious
10.0.2.15,59845,119.254.87.201,80,11,1513,6,705,5,808,19258.08928,2.14864,2624.916226,3008.414625,Malicious
10.0.2.15,56823,119.254.87.201,80,11,1593,6,705,5,888,19260.67195,2.136108,2640.315939,3325.674545,Malicious
10.0.2.15,54697,119.254.87.201,80,11,1579,6,705,5,874,19263.72109,1.684999,3347.182995,4149.557359,Malicious
10.0.2.15,58223,119.254.87.201,80,11,1579,6,705,5,874,19288.15053,2.048231,2753.595664,3413.677461,Malicious
10.0.2.15,53437,119.254.87.201,80,11,1579,6,705,5,874,19290.69966,2.283004,2470.429312,3062.631515,Malicious
10.0.2.15,51785,119.254.87.201,80,11,1582,6,705,5,877,19294.52672,2.02603,2783.769243,3462.929966,Malicious
10.0.2.15,42885,119.254.87.201,80,11,1579,6,705,5,874,19318.16961,2.318745,2432.350258,3015.424292,Malicious
10.0.2.15,43559,119.254.87.201,80,11,1582,6,705,5,877,19320.72732,2.217116,2543.845248,3164.471322,Malicious
10.0.2.15,35934,119.254.87.201,80,11,1582,6,705,5,877,19323.78582,2.250616,2505.980585,3117.368756,Malicious
10.0.2.15,44557,119.254.87.201,80,11,1587,6,705,5,882,19348.18286,1.07626,5240.369427,6556.036645,Malicious
10.0.2.15,52278,119.254.87.201,80,11,1544,6,705,5,839,19350.75831,1.612893,3496.82217,4161.466384,Malicious
10.0.2.15,44393,119.254.87.201,80,12,1642,7,779,5,863,19353.8158,4.012437,1553.170804,1720.650069,Malicious
10.0.2.15,51711,119.254.87.201,80,11,1579,6,705,5,874,19378.23928,5.174614,1089.93637,1351.211897,Malicious
10.0.2.15,37724,119.254.87.201,80,11,1579,6,705,5,874,19380.81014,2.067704,2727.663147,3381.528497,Malicious
10.0.2.15,50863,119.254.87.201,80,11,1534,6,705,5,829,19383.84796,4.537934,1242.856331,1461.458012,Malicious
10.0.2.15,48556,119.254.87.201,80,12,1659,7,779,5,880,19408.27168,5.213725,1195.306619,1350.282188,Malicious
10.0.2.15,37035,119.254.87.201,80,11,1582,6,705,5,877,19410.87092,2.0846,2705.555023,3365.633695,Malicious
10.0.2.15,36538,119.254.87.201,80,11,1554,6,705,5,849,19413.8524,2.188107,2577.570475,3104.052955,Malicious
10.0.2.15,50015,119.254.87.201,80,11,1579,6,705,5,874,19438.3198,1.402223,4022.184774,4986.368074,Malicious
10.0.2.15,47207,119.254.87.201,80,11,1582,6,705,5,877,19440.8978,1.351281,4173.817289,5192.110301,Malicious
10.0.2.15,35426,119.254.87.201,80,12,1653,7,779,5,874,19443.89499,7.469311,834.3473715,936.097051,Malicious
10.0.2.15,59209,119.254.87.201,80,11,1559,6,705,5,854,19468.35879,2.116132,2665.240165,3228.532058,Malicious
10.0.2.15,50955,119.254.87.201,80,11,1579,6,705,5,874,19470.90802,2.084856,2705.222807,3353.708841,Malicious
10.0.2.15,45875,119.254.87.201,80,11,1554,6,705,5,849,19473.90016,2.146774,2627.197833,3163.816964,Malicious
10.0.2.15,48116,119.254.87.201,80,12,1653,7,779,5,874,19498.38511,6.179455,1008.503177,1131.491369,Malicious
10.0.2.15,55656,119.254.87.201,80,11,1579,6,705,5,874,19500.93723,1.246341,4525.246301,5610.021655,Malicious
10.0.2.15,45976,119.254.87.201,80,11,1582,6,705,5,877,19503.9613,1.618324,3485.087041,4335.349411,Malicious
10.0.2.15,33950,119.254.87.201,80,11,1544,6,705,5,839,19528.38505,1.302122,4331.391375,5154.662927,Malicious
10.0.2.15,53647,119.254.87.201,80,11,1579,6,705,5,874,19530.99123,1.418122,3977.090829,4930.464375,Malicious
10.0.2.15,48840,119.254.87.201,80,11,1582,6,705,5,877,19533.9868,1.364428,4133.600307,5142.081517,Malicious
10.0.2.15,40507,119.254.87.201,80,12,1656,7,779,5,877,19558.41193,4.618992,1349.212122,1518.946125,Malicious
10.0.2.15,41862,119.254.87.201,80,11,1513,6,705,5,808,19561.04573,1.785224,3159.267408,3620.834136,Malicious
10.0.2.15,52290,119.254.87.201,80,11,1569,6,705,5,864,19564.01323,1.545777,3648.650485,4471.537615,Malicious
10.0.2.15,60008,119.254.87.201,80,11,1558,6,705,5,853,19588.43998,1.742589,3236.563527,3916.012324,Malicious
10.0.2.15,50821,119.254.87.201,80,11,1585,6,705,5,880,19591.1819,2.044755,2758.276664,3442.955268,Malicious
10.0.2.15,52536,119.254.87.201,80,11,1579,6,705,5,874,19594.02582,1.291866,4365.777875,5412.326046,Malicious
10.0.2.15,50133,119.254.87.201,80,11,1579,6,705,5,874,19618.49401,1.427283,3951.563916,4898.818244,Malicious
10.0.2.15,50967,119.254.87.201,80,11,1534,6,705,5,829,19621.15802,3.125276,1804.640614,2122.05258,Malicious
10.0.2.15,55239,119.254.87.201,80,11,1579,6,705,5,874,19624.01831,1.414983,3985.913612,4941.402123,Malicious
10.0.2.15,59623,119.254.87.201,80,11,1513,6,705,5,808,19648.50393,1.588947,3549.520532,4068.102964,Malicious
10.0.2.15,59358,119.254.87.201,80,11,1582,6,705,5,877,19651.19702,1.426086,3954.880701,4919.759397,Malicious
10.0.2.15,39641,119.254.87.201,80,11,1587,6,705,5,882,19654.07917,1.532897,3679.307873,4603.048998,Malicious
10.0.2.15,42933,119.254.87.201,80,11,1582,6,705,5,877,19678.56047,2.228126,2531.275161,3148.834491,Malicious
10.0.2.15,44625,119.254.87.201,80,11,1579,6,705,5,874,19681.22579,2.277939,2475.922314,3069.44128,Malicious
10.0.2.15,60946,119.254.87.201,80,11,1582,6,705,5,877,19684.14032,2.221462,2538.868547,3158.280448,Malicious
10.0.2.15,57425,119.254.87.201,80,11,1560,6,705,5,855,19708.5797,2.256585,2499.351897,3031.128896,Malicious
10.0.2.15,37344,119.254.87.201,80,11,1579,6,705,5,874,19711.27901,2.218514,2542.24224,3151.659174,Malicious
10.0.2.15,56105,119.254.87.201,80,11,1560,6,705,5,855,19714.16131,4.384229,1286.429153,1560.137484,Malicious
10.0.2.15,36660,119.254.87.201,80,11,1560,6,705,5,855,19738.64041,2.24956,2507.156955,3040.594605,Malicious
10.0.2.15,34457,119.254.87.201,80,11,1579,6,705,5,874,19741.32314,2.365965,2383.805339,2955.242364,Malicious
10.0.2.15,50818,119.254.87.201,80,11,1579,6,705,5,874,19744.19269,2.215405,2545.809908,3156.082071,Malicious
10.0.2.15,43295,119.254.87.201,80,11,1513,6,705,5,808,19768.69922,2.191531,2573.543336,2949.536192,Malicious
10.0.2.15,59074,119.254.87.201,80,11,1582,6,705,5,877,19771.33738,2.212352,2549.323073,3171.285582,Malicious
10.0.2.15,44974,119.254.87.201,80,11,1582,6,705,5,877,19774.21661,2.204727,2558.139851,3182.253404,Malicious
10.0.2.15,38793,119.254.87.201,80,12,1653,7,779,5,874,19798.7264,4.655113,1338.743012,1502.004355,Malicious
10.0.2.15,41852,119.254.87.201,80,3,222,3,222,0,0,19801.37032,9.107153,195.0115475,0,Malicious
10.0.2.15,50354,119.254.87.201,80,11,1582,6,705,5,877,19804.22209,1.769383,3187.551819,3965.224036,Malicious
10.0.2.15,54940,119.254.87.201,80,11,1582,6,705,5,877,19828.73336,2.331704,2418.831893,3008.958255,Malicious
10.0.2.15,46723,119.254.87.201,80,11,1513,6,705,5,808,19831.4726,1.247537,4520.907997,5181.409449,Malicious
10.0.2.15,55007,119.254.87.201,80,11,1582,6,705,5,877,19834.24711,1.930053,2922.199546,3635.133336,Malicious
10.0.2.15,37446,119.254.87.201,80,11,1513,6,705,5,808,19858.79453,2.153288,2619.250189,3001.920783,Malicious
10.0.2.15,55798,119.254.87.201,80,11,1579,6,705,5,874,19861.39488,2.314915,2436.374554,3020.413277,Malicious
10.0.2.15,50059,119.254.87.201,80,11,1582,6,705,5,877,19864.27928,2.154123,2618.234892,3257.009929,Malicious
10.0.2.15,54196,119.254.87.201,80,11,1582,6,705,5,877,19888.84855,1.380926,4084.215954,5080.648782,Malicious
10.0.2.15,54148,119.254.87.201,80,11,1579,6,705,5,874,19891.40663,6.079941,927.6405807,1150.01116,Malicious
10.0.2.15,47882,119.254.87.201,80,11,1582,6,705,5,877,19894.33355,1.463011,3855.063291,4795.58937,Malicious
10.0.2.15,45761,119.254.87.201,80,11,1579,6,705,5,874,19919.00895,2.161165,2609.703563,3235.292076,Malicious
10.0.2.15,50165,119.254.87.201,80,11,1582,6,705,5,877,19921.42164,2.055605,2743.717786,3413.10709,Malicious
10.0.2.15,38323,119.254.87.201,80,12,1653,7,779,5,874,19924.37575,5.245646,1188.032894,1332.914955,Malicious
10.0.2.15,44182,119.254.87.201,80,11,1534,6,705,5,829,19948.92698,2.562918,2200.616641,2587.675454,Malicious
10.0.2.15,47310,119.254.87.201,80,11,1582,6,705,5,877,19951.42341,1.421509,3967.614697,4935.600126,Malicious
10.0.2.15,41728,119.254.87.201,80,11,1582,6,705,5,877,19954.37607,2.424941,2325.829783,2893.266269,Malicious
10.0.2.15,44693,119.254.87.201,80,11,1582,6,705,5,877,19978.95848,1.889146,2985.475977,3713.847421,Malicious
10.0.2.15,45055,119.254.87.201,80,11,1579,6,705,5,874,19981.42692,1.485717,3796.146911,4706.145248,Malicious
10.0.2.15,59922,119.254.87.201,80,11,1582,6,705,5,877,19984.41954,2.107097,2676.668421,3329.699582,Malicious
10.0.2.15,49087,119.254.87.201,80,11,1579,6,705,5,874,20008.95992,1.781265,3166.289126,3925.300278,Malicious
10.0.2.15,58537,119.254.87.201,80,11,1579,6,705,5,874,20011.45434,1.549891,3638.965579,4511.284987,Malicious
10.0.2.15,33307,119.254.87.201,80,11,1582,6,705,5,877,20014.46379,1.485619,3796.397327,4722.610575,Malicious
10.0.2.15,52222,119.254.87.201,80,11,1551,6,705,5,846,20038.96405,1.224986,4604.134251,5524.961102,Malicious
10.0.2.15,43611,119.254.87.201,80,11,1513,6,705,5,808,20041.48831,1.018664,5536.663709,6345.56635,Malicious
10.0.2.15,58432,119.254.87.201,80,11,1582,6,705,5,877,20044.48005,1.429035,3946.71929,4909.606833,Malicious
10.0.2.15,35274,119.254.87.201,80,11,1579,6,705,5,874,20069.00831,1.429244,3946.142156,4892.096801,Malicious
10.0.2.15,55359,119.254.87.201,80,11,1579,6,705,5,874,20071.53814,1.68057,3356.004213,4160.493166,Malicious
10.0.2.15,38715,119.254.87.201,80,11,1579,6,705,5,874,20074.48552,1.613162,3496.239063,4334.344598,Malicious
10.0.2.15,51306,119.254.87.201,80,11,1544,6,705,5,839,20099.02468,2.212152,2549.553557,3034.149552,Malicious
10.0.2.15,47704,119.254.87.201,80,11,1593,6,705,5,888,20101.54267,2.160647,2610.329221,3287.90404,Malicious
10.0.2.15,60736,119.254.87.201,80,11,1582,6,705,5,877,20104.5389,2.1895,2575.930578,3204.384563,Malicious
10.0.2.15,38564,119.254.87.201,80,11,1582,6,705,5,877,20129.04309,1.555853,3625.02113,4509.423448,Malicious
10.0.2.15,42792,119.254.87.201,80,11,1582,6,705,5,877,20131.57011,1.680886,3355.373297,4173.989194,Malicious
10.0.2.15,51680,119.254.87.201,80,11,1579,6,705,5,874,20134.57475,1.616327,3489.392926,4325.85733,Malicious
10.0.2.15,42740,119.254.87.201,80,11,1513,6,705,5,808,20159.04942,1.697218,3323.08519,3808.585579,Malicious
10.0.2.15,50897,119.254.87.201,80,11,1579,6,705,5,874,20161.59219,1.644576,3429.455373,4251.551768,Malicious
10.0.2.15,41416,119.254.87.201,80,11,1513,6,705,5,808,20164.62033,1.652422,3413.171696,3911.83366,Malicious
10.0.2.15,55249,119.254.87.201,80,11,1579,6,705,5,874,20189.05131,3.271468,1723.996689,2137.266817,Malicious
10.0.2.15,55621,119.254.87.201,80,11,1579,6,705,5,874,20191.60607,1.892328,2980.455819,3694.919697,Malicious
10.0.2.15,46491,119.254.87.201,80,11,1582,6,705,5,877,20194.62902,3.248481,1736.196087,2159.778678,Malicious
10.0.2.15,53441,119.254.87.201,80,11,1582,6,705,5,877,20219.07236,2.718747,2074.485048,2580.600549,Malicious
10.0.2.15,52634,119.254.87.201,80,12,1656,7,779,5,877,20221.65867,4.889651,1274.528591,1434.867233,Malicious
10.0.2.15,55680,119.254.87.201,80,11,1579,6,705,5,874,20224.70957,1.764653,3196.095776,3962.252069,Malicious
10.0.2.15,49135,119.254.87.201,80,11,1582,6,705,5,877,20249.13098,1.62083,3479.698673,4328.646434,Malicious
10.0.2.15,38094,119.254.87.201,80,11,1513,6,705,5,808,20251.72131,1.662458,3392.56691,3888.218529,Malicious
10.0.2.15,43457,119.254.87.201,80,11,1582,6,705,5,877,20254.71657,3.693308,1527.086287,1899.652019,Malicious
10.0.2.15,41036,119.254.87.201,80,11,1579,6,705,5,874,20279.15953,2.02391,2786.685179,3454.699073,Malicious
10.0.2.15,59310,119.254.87.201,80,11,1568,6,705,5,863,20281.76616,2.213428,2548.083787,3119.143699,Malicious
10.0.2.15,35488,119.254.87.201,80,11,1582,6,705,5,877,20284.74934,2.042205,2761.720787,3435.502312,Malicious
10.0.2.15,54797,119.254.87.201,80,11,1582,6,705,5,877,20309.17295,4.642298,1214.915544,1511.320471,Malicious
10.0.2.15,57315,119.254.87.201,80,12,1587,7,779,5,808,20311.7975,4.443874,1402.379995,1454.586696,Malicious
10.0.2.15,60504,119.254.87.201,80,11,1513,6,705,5,808,20314.81119,1.430035,3943.959414,4520.169087,Malicious
10.0.2.15,51341,119.254.87.201,80,11,1582,6,705,5,877,20339.222,3.583926,1573.693207,1957.629706,Malicious
10.0.2.15,40439,119.254.87.201,80,11,1582,6,705,5,877,20341.79924,1.89278,2979.74408,3706.717104,Malicious
10.0.2.15,36383,119.254.87.201,80,11,1582,6,705,5,877,20344.86132,1.743649,3234.595954,4023.745605,Malicious
10.0.2.15,55283,119.254.87.201,80,12,1633,7,779,5,854,20369.25349,5.639517,1105.059174,1211.451264,Malicious
10.0.2.15,42282,119.254.87.201,80,11,1579,6,705,5,874,20371.82512,1.876412,3005.73648,3726.260544,Malicious
10.0.2.15,44851,119.254.87.201,80,11,1513,6,705,5,808,20374.90068,1.637917,3443.397926,3946.47592,Malicious
10.0.2.15,48739,119.254.87.201,80,11,1579,6,705,5,874,20399.30695,5.329344,1058.291602,1311.981362,Malicious
10.0.2.15,39572,119.254.87.201,80,13,1730,8,853,5,877,20401.82984,10.631583,641.8611415,659.9205405,Malicious
10.0.2.15,56417,119.254.87.201,80,12,1656,7,779,5,877,20404.96836,4.94825,1259.435154,1417.875006,Malicious
10.0.2.15,41891,119.254.87.201,80,11,1582,6,705,5,877,20429.31502,2.230929,2528.094798,3144.87821,Malicious
10.0.2.15,58676,119.254.87.201,80,11,1568,6,705,5,863,20431.85517,1.92181,2934.733402,3592.446704,Malicious
10.0.2.15,56779,119.254.87.201,80,11,1568,6,705,5,863,20434.97862,1.985465,2840.644383,3477.271067,Malicious
10.0.2.15,56481,119.254.87.201,80,11,1582,6,705,5,877,20459.33005,2.489667,2265.363199,2818.047554,Malicious
10.0.2.15,52978,119.254.87.201,80,11,1554,6,705,5,849,20461.85944,1.678174,3360.795722,4047.256125,Malicious
10.0.2.15,43722,119.254.87.201,80,11,1579,6,705,5,874,20465.0413,1.85446,3041.31661,3770.369811,Malicious
10.0.2.15,34481,119.254.87.201,80,11,1582,6,705,5,877,20489.33938,1.95595,2883.509292,3587.003758,Malicious
10.0.2.15,40067,119.254.87.201,80,11,1582,6,705,5,877,20491.87902,1.619286,3483.016589,4332.773827,Malicious
10.0.2.15,43282,119.254.87.201,80,11,1582,6,705,5,877,20495.11669,6.279878,898.1066193,1117.219156,Malicious
10.0.2.15,35032,119.254.87.201,80,11,1579,6,705,5,874,20524.48517,1.265923,4455.247278,5523.242725,Malicious
10.0.2.15,34418,119.254.87.201,80,12,1653,7,779,5,874,20525.13198,7.751248,803.9995624,902.0482895,Malicious
10.0.2.15,47836,119.254.87.201,80,11,1579,6,705,5,874,20527.01784,4.747393,1188.020457,1472.808339,Malicious
10.0.2.15,53720,119.254.87.201,80,11,1582,6,705,5,877,20549.45108,4.713704,1196.511279,1488.426087,Malicious
10.0.2.15,38214,119.254.87.201,80,12,1656,7,779,5,877,20551.94227,4.453546,1399.334373,1575.373871,Malicious
10.0.2.15,38896,119.254.87.201,80,11,1569,6,705,5,864,20555.16686,1.856085,3038.653941,3723.967383,Malicious
10.0.2.15,34241,119.254.87.201,80,11,1579,6,705,5,874,20579.45802,1.502427,3753.926147,4653.803479,Malicious
10.0.2.15,44988,119.254.87.201,80,11,1579,6,705,5,874,20582.00185,1.617513,3486.834418,4322.685505,Malicious
10.0.2.15,54326,119.254.87.201,80,11,1582,6,705,5,877,20585.14219,1.889452,2984.992474,3713.245957,Malicious
10.0.2.15,41314,119.254.87.201,80,11,1513,6,705,5,808,20609.47866,2.494921,2260.59262,2590.863598,Malicious
10.0.2.15,51560,119.254.87.201,80,11,1579,6,705,5,874,20612.00637,3.545724,1590.648341,1971.952696,Malicious
10.0.2.15,53425,119.254.87.201,80,11,1579,6,705,5,874,20615.15472,1.425402,3956.778509,4905.282861,Malicious
10.0.2.15,50114,119.254.87.201,80,11,1582,6,705,5,877,20639.48523,1.49855,3763.638184,4681.85913,Malicious
10.0.2.15,33115,119.254.87.201,80,11,1513,6,705,5,808,20642.03243,6.159493,915.6597791,1049.437023,Malicious
10.0.2.15,36756,119.254.87.201,80,11,1579,6,705,5,874,20645.17207,1.491751,3780.791835,4687.10931,Malicious
10.0.2.15,41754,119.254.87.201,80,13,1727,8,853,5,874,20669.51098,10.466626,651.9770555,668.0280732,Malicious
10.0.2.15,35570,119.254.87.201,80,11,1582,6,705,5,877,20672.08482,6.507918,866.636611,1078.071359,Malicious
10.0.2.15,38446,119.254.87.201,80,11,1579,6,705,5,874,20675.1753,1.55123,3635.824475,4507.390909,Malicious
10.0.2.15,60774,119.254.87.201,80,11,1513,6,705,5,808,20699.5621,2.288066,2464.96386,2825.093332,Malicious
10.0.2.15,60819,119.254.87.201,80,11,1513,6,705,5,808,20702.09311,2.123038,2656.570443,3044.693501,Malicious
10.0.2.15,58781,119.254.87.201,80,11,1582,6,705,5,877,20705.27525,2.222052,2538.194426,3157.44186,Malicious
10.0.2.15,58885,119.254.87.201,80,11,1554,6,705,5,849,20729.62411,1.681669,3353.811006,4038.844743,Malicious
10.0.2.15,34547,119.254.87.201,80,12,1656,7,779,5,877,20732.14996,5.046021,1235.032514,1390.402458,Malicious
10.0.2.15,56415,119.254.87.201,80,11,1513,6,705,5,808,20735.20615,1.250734,4509.352108,5168.165253,Malicious
10.0.2.15,38558,119.254.87.201,80,11,1582,6,705,5,877,20759.66125,2.032227,2775.280517,3452.370232,Malicious
10.0.2.15,34322,119.254.87.201,80,11,1582,6,705,5,877,20762.20848,2.195055,2569.4117,3196.275264,Malicious
10.0.2.15,60933,119.254.87.201,80,11,1579,6,705,5,874,20765.24162,11.085293,508.7822216,630.7456194,Malicious
10.0.2.15,49018,119.254.87.201,80,11,1582,6,705,5,877,20789.69716,2.024995,2785.192062,3464.699913,Malicious
10.0.2.15,56454,119.254.87.201,80,11,1579,6,705,5,874,20792.23294,2.244298,2513.035256,3115.4508,Malicious
10.0.2.15,44658,119.254.87.201,80,11,1582,6,705,5,877,20795.25944,2.084917,2705.143658,3365.121969,Malicious
10.0.2.15,34606,119.254.87.201,80,11,1513,6,705,5,808,20819.71091,1.827019,3086.995811,3538.00371,Malicious
10.0.2.15,51605,119.254.87.201,80,11,1587,6,705,5,882,20822.24523,1.423734,3961.414141,4955.981946,Malicious
10.0.2.15,34688,119.254.87.201,80,13,1727,8,853,5,874,20825.25556,10.659765,640.1642062,655.9244036,Malicious
10.0.2.15,41782,119.254.87.201,80,11,1582,6,705,5,877,20849.71781,1.38679,4066.945969,5059.165411,Malicious
10.0.2.15,44537,119.254.87.201,80,11,1579,6,705,5,874,20852.27088,1.419708,3972.647897,4924.956399,Malicious
10.0.2.15,34445,119.254.87.201,80,11,1513,6,705,5,808,20855.28957,1.311079,4301.800273,4930.290242,Malicious
10.0.2.15,44821,119.254.87.201,80,11,1579,6,705,5,874,20879.77243,1.291867,4365.774495,5412.321857,Malicious
10.0.2.15,57006,119.254.87.201,80,11,1579,6,705,5,874,20882.3169,10.593664,532.3937025,660.0171574,Malicious
10.0.2.15,51468,119.254.87.201,80,11,1579,6,705,5,874,20885.29189,2.917561,1933.121535,2396.522301,Malicious
10.0.2.15,46388,119.254.87.201,80,11,1579,6,705,5,874,20909.80105,4.389988,1284.741553,1592.71506,Malicious
10.0.2.15,48263,119.254.87.201,80,11,1513,6,705,5,808,20912.32524,2.263719,2491.475311,2855.478087,Malicious
10.0.2.15,42031,119.254.87.201,80,11,1544,6,705,5,839,20915.29589,4.276288,1318.900879,1569.585585,Malicious
10.0.2.15,34805,119.254.87.201,80,11,1559,6,705,5,854,20939.85931,1.416287,3982.243712,4823.881035,Malicious
10.0.2.15,47832,119.254.87.201,80,11,1568,6,705,5,863,20942.38556,1.484101,3800.280439,4651.974495,Malicious
10.0.2.15,54550,119.254.87.201,80,11,1579,6,705,5,874,20945.30104,1.02475,5503.78141,6823.127592,Malicious
10.0.2.15,58863,119.254.87.201,80,11,1582,6,705,5,877,20969.893,1.680298,3356.54747,4175.449831,Malicious
10.0.2.15,48103,119.254.87.201,80,11,1579,6,705,5,874,20972.41278,1.582683,3563.568952,4417.814559,Malicious
10.0.2.15,57600,119.254.87.201,80,11,1579,6,705,5,874,20975.37298,1.323436,4261.63411,5283.217322,Malicious
10.0.2.15,51897,119.254.87.201,80,11,1579,6,705,5,874,20999.94208,1.44597,3900.495861,4835.508344,Malicious
10.0.2.15,57695,119.254.87.201,80,11,1582,6,705,5,877,21002.43907,1.189052,4743.274474,5900.498885,Malicious
10.0.2.15,37270,119.254.87.201,80,11,1579,6,705,5,874,21005.40548,1.419626,3972.877363,4925.240873,Malicious
10.0.2.15,40338,119.254.87.201,80,12,1653,7,779,5,874,21029.94652,6.860376,908.4050204,1019.18612,Malicious
10.0.2.15,47018,119.254.87.201,80,11,1579,6,705,5,874,21032.50204,1.29576,4352.6579,5396.060999,Malicious
10.0.2.15,59970,119.254.87.201,80,12,1587,7,779,5,808,21035.46722,4.066737,1532.432513,1589.480707,Malicious
10.0.2.15,41685,119.254.87.201,80,11,1579,6,705,5,874,21059.9768,1.642641,3433.495207,4256.560015,Malicious
10.0.2.15,34835,119.254.87.201,80,11,1513,6,705,5,808,21062.62527,1.79518,3141.746232,3600.753128,Malicious
10.0.2.15,36540,119.254.87.201,80,11,1579,6,705,5,874,21065.52276,1.891824,2981.249841,3695.904059,Malicious
10.0.2.15,37044,119.254.87.201,80,11,1513,6,705,5,808,21090.00516,1.224927,4604.356015,5277.049163,Malicious
10.0.2.15,55470,119.254.87.201,80,11,1559,6,705,5,854,21092.5314,1.215798,4638.928506,5619.354531,Malicious
10.0.2.15,36802,119.254.87.201,80,12,1656,7,779,5,877,21095.55113,3.985112,1563.82054,1760.552777,Malicious
10.0.2.15,40139,119.254.87.201,80,11,1579,6,705,5,874,21120.04382,1.885052,2991.959903,3709.181497,Malicious
10.0.2.15,42126,119.254.87.201,80,11,1579,6,705,5,874,21122.58195,3.640279,1549.331796,1920.7319,Malicious
10.0.2.15,44216,119.254.87.201,80,11,1587,6,705,5,882,21125.58892,1.984965,2841.359923,3554.722627,Malicious
10.0.2.15,55266,119.254.87.201,80,11,1579,6,705,5,874,21150.23642,1.819111,3100.415533,3843.63571,Malicious
10.0.2.15,60704,119.254.87.201,80,11,1560,6,705,5,855,21152.61922,1.087276,5187.275356,6290.950964,Malicious
10.0.2.15,49121,119.254.87.201,80,12,1653,7,779,5,874,21155.57975,3.850937,1618.307441,1815.662006,Malicious
10.0.2.15,33557,119.254.87.201,80,11,1579,6,705,5,874,21180.15131,1.373948,4104.958849,5088.984445,Malicious
10.0.2.15,53465,119.254.87.201,80,11,1582,6,705,5,877,21182.63673,1.03252,5462.363925,6795.025762,Malicious
10.0.2.15,55109,119.254.87.201,80,11,1582,6,705,5,877,21185.64021,1.510151,3734.725865,4645.893027,Malicious
10.0.2.15,36343,119.254.87.201,80,11,1579,6,705,5,874,21210.18503,1.288814,4376.116336,5425.142806,Malicious
10.0.2.15,44529,119.254.87.201,80,11,1579,6,705,5,874,21212.64335,1.442634,3909.515511,4846.690151,Malicious
10.0.2.15,57208,119.254.87.201,80,11,1579,6,705,5,874,21215.66543,1.448593,3893.433145,4826.75258,Malicious
10.0.2.15,57983,119.254.87.201,80,11,1579,6,705,5,874,21240.2034,1.120191,5034.855663,6241.792694,Malicious
10.0.2.15,39683,119.254.87.201,80,11,1593,6,705,5,888,21242.69706,1.289518,4373.727238,5509.035159,Malicious
10.0.2.15,48618,119.254.87.201,80,11,1513,6,705,5,808,21245.7185,1.088207,5182.837456,5940.046333,Malicious
10.0.2.15,46608,119.254.87.201,80,11,1582,6,705,5,877,21270.24658,4.440693,1270.072036,1579.933582,Malicious
10.0.2.15,34434,119.254.87.201,80,11,1579,6,705,5,874,21272.75407,1.601438,3521.834751,4366.075989,Malicious
10.0.2.15,60866,119.254.87.201,80,11,1587,6,705,5,882,21275.73025,1.545083,3650.289337,4566.744958,Malicious
10.0.2.15,33466,119.254.87.201,80,11,1579,6,705,5,874,21300.30103,1.05687,5336.512532,6615.761636,Malicious
10.0.2.15,58328,119.254.87.201,80,11,1513,6,705,5,808,21302.79206,1.961997,2874.622132,3294.602387,Malicious
10.0.2.15,44961,119.254.87.201,80,11,1579,6,705,5,874,21305.79003,2.483085,2271.368076,2815.852055,Malicious
10.0.2.15,55753,119.254.87.201,80,11,1513,6,705,5,808,21330.32191,1.030774,5471.616475,6271.015761,Malicious
10.0.2.15,38609,119.254.87.201,80,11,1513,6,705,5,808,21332.8518,1.383927,4075.359466,4670.766594,Malicious
10.0.2.15,51484,119.254.87.201,80,3,222,3,222,0,0,21335.83239,9.062415,195.9742519,0,Malicious
10.0.2.15,38169,119.254.87.201,80,11,1582,6,705,5,877,21360.35646,1.58496,3558.449425,4426.610135,Malicious
10.0.2.15,53625,119.254.87.201,80,11,1582,6,705,5,877,21362.91147,1.02499,5502.492707,6844.944829,Malicious
10.0.2.15,47342,119.254.87.201,80,11,1513,6,705,5,808,21365.94282,1.055598,5342.943052,6123.543243,Malicious
10.0.2.15,60428,119.254.87.201,80,11,1582,6,705,5,877,21390.39157,2.220512,2539.954749,3159.631653,Malicious
10.0.2.15,54276,119.254.87.201,80,11,1579,6,705,5,874,21392.91261,2.078542,2713.440479,3363.896424,Malicious
10.0.2.15,47777,119.254.87.201,80,11,1582,6,705,5,877,21395.90422,2.147916,2625.801009,3266.421964,Malicious
10.0.2.15,51848,119.254.87.201,80,11,1513,6,705,5,808,21420.42196,2.013825,2800.640572,3209.812173,Malicious
10.0.2.15,48395,119.254.87.201,80,11,1582,6,705,5,877,21422.93667,2.096168,2690.624034,3347.059968,Malicious
10.0.2.15,43223,119.254.87.201,80,11,1582,6,705,5,877,21425.93389,2.224013,2535.9564,3154.657819,Malicious
10.0.2.15,41080,119.254.87.201,80,3,222,3,222,0,0,21450.47338,9.042089,196.4147887,0,Malicious
10.0.2.15,55593,119.254.87.201,80,11,1579,6,705,5,874,21452.97032,1.586107,3555.876117,4408.277626,Malicious
10.0.2.15,37215,119.254.87.201,80,11,1582,6,705,5,877,21455.9935,3.859063,1461.494669,1818.057907,Malicious
10.0.2.15,53544,119.254.87.201,80,11,1579,6,705,5,874,21480.60262,2.127535,2650.955213,3286.432421,Malicious
10.0.2.15,53085,119.254.87.201,80,11,1593,6,705,5,888,21483.02986,2.219264,2541.383089,3201.061253,Malicious
10.0.2.15,60244,119.254.87.201,80,11,1587,6,705,5,882,21486.02373,2.018464,2794.20391,3495.727444,Malicious
10.0.2.15,50034,119.254.87.201,80,11,1579,6,705,5,874,21510.56357,1.092259,5163.610462,6401.412119,Malicious
10.0.2.15,48107,119.254.87.201,80,11,1579,6,705,5,874,21513.08686,1.549006,3641.044644,4513.862438,Malicious
10.0.2.15,50891,119.254.87.201,80,11,1579,6,705,5,874,21516.09741,1.722551,3274.213652,4059.096073,Malicious
10.0.2.15,38928,119.254.87.201,80,11,1582,6,705,5,877,21540.5869,2.021638,2789.81697,3470.453167,Malicious
10.0.2.15,44197,119.254.87.201,80,11,1579,6,705,5,874,21543.11156,2.162015,2608.677553,3234.020115,Malicious
10.0.2.15,57626,119.254.87.201,80,11,1582,6,705,5,877,21546.10891,2.025676,2784.255725,3463.535136,Malicious
10.0.2.15,42482,119.254.87.201,80,11,1582,6,705,5,877,21570.59022,1.688031,3341.170867,4156.321774,Malicious
10.0.2.15,54333,119.254.87.201,80,11,1513,6,705,5,808,21573.11945,2.510941,2246.169862,2574.333686,Malicious
10.0.2.15,44627,119.254.87.201,80,11,1513,6,705,5,808,21576.1558,1.489526,3786.439445,4339.635562,Malicious
10.0.2.15,46324,119.254.87.201,80,11,1579,6,705,5,874,21600.59511,1.422709,3964.268167,4914.567912,Malicious
10.0.2.15,38741,119.254.87.201,80,11,1582,6,705,5,877,21603.13247,1.07939,5225.173478,6499.967574,Malicious
10.0.2.15,53420,119.254.87.201,80,11,1579,6,705,5,874,21606.19632,1.753755,3215.956619,3986.873879,Malicious
10.0.2.15,51419,119.254.87.201,80,11,1579,6,705,5,874,21630.61107,2.221532,2538.788548,3147.377575,Malicious
10.0.2.15,48616,119.254.87.201,80,11,1559,6,705,5,854,21633.1382,2.182389,2584.323876,3130.514313,Malicious
10.0.2.15,35201,119.254.87.201,80,11,1579,6,705,5,874,21636.22766,2.253101,2503.216678,3103.278548,Malicious
10.0.2.15,58137,119.254.87.201,80,11,1582,6,705,5,877,21660.67109,2.018135,2794.659426,3476.477044,Malicious
10.0.2.15,51648,119.254.87.201,80,11,1587,6,705,5,882,21663.19682,2.196463,2567.764629,3212.437451,Malicious
10.0.2.15,48971,119.254.87.201,80,11,1513,6,705,5,808,21666.2904,2.025988,2783.826953,3190.542096,Malicious
10.0.2.15,51443,119.254.87.201,80,11,1559,6,705,5,854,21690.70381,278.257549,20.26899188,24.552793,Malicious
10.0.2.15,56669,119.254.87.201,80,11,1513,6,705,5,808,21693.22227,1.447764,3895.662553,4464.816089,Malicious
10.0.2.15,47212,119.254.87.201,80,12,1656,7,779,5,877,21696.33891,4.105171,1518.085361,1709.064007,Malicious
10.0.2.15,33602,119.254.87.201,80,11,1579,6,705,5,874,21720.73312,1.825571,3089.444344,3830.034548,Malicious
10.0.2.15,56369,119.254.87.201,80,11,1513,6,705,5,808,21723.25808,2.016581,2796.813022,3205.425421,Malicious
10.0.2.15,33232,119.254.87.201,80,11,1579,6,705,5,874,21726.38371,2.151202,2621.79005,3250.275892,Malicious
10.0.2.15,39946,119.254.87.201,80,11,1559,6,705,5,854,21750.92817,1.424109,3960.371011,4797.385593,Malicious
10.0.2.15,35360,119.254.87.201,80,11,1579,6,705,5,874,21753.31933,0.986218,5718.816732,7089.710389,Malicious
10.0.2.15,56705,119.254.87.201,80,12,1653,7,779,5,874,21756.40389,3.983631,1564.401924,1755.182646,Malicious
10.0.2.15,38785,119.254.87.201,80,11,1579,6,705,5,874,21780.82905,1.48014,3810.450363,4723.877471,Malicious
10.0.2.15,59033,119.254.87.201,80,12,1587,7,779,5,808,21783.34548,7.432779,838.4481767,869.6612667,Malicious
10.0.2.15,40102,119.254.87.201,80,11,1579,6,705,5,874,21786.46636,1.500875,3757.807945,4658.615807,Malicious
10.0.2.15,52491,119.254.87.201,80,11,1579,6,705,5,874,21810.90595,1.631731,3456.452075,4285.020019,Malicious
10.0.2.15,40079,119.254.87.201,80,11,1582,6,705,5,877,21813.40346,1.083221,5206.69374,6476.979305,Malicious
10.0.2.15,53037,119.254.87.201,80,11,1579,6,705,5,874,21816.46047,1.819414,3099.899198,3842.995602,Malicious
10.0.2.15,54951,119.254.87.201,80,12,1656,7,779,5,877,21840.91474,4.107671,1517.161428,1708.023841,Malicious
10.0.2.15,51785,119.254.87.201,80,11,1544,6,705,5,839,21843.41038,1.031112,5469.822871,6509.477147,Malicious
10.0.2.15,58880,119.254.87.201,80,11,1579,6,705,5,874,21846.46974,2.543793,2217.161538,2748.651325,Malicious
10.0.2.15,47330,119.254.87.201,80,11,1559,6,705,5,854,21870.93662,2.248459,2508.384631,3038.525497,Malicious
10.0.2.15,34288,119.254.87.201,80,11,1579,6,705,5,874,21873.43107,2.084139,2706.153476,3354.862608,Malicious
10.0.2.15,46605,119.254.87.201,80,11,1579,6,705,5,874,21876.48511,2.255173,2500.916781,3100.427329,Malicious
10.0.2.15,33576,119.254.87.201,80,11,1579,6,705,5,874,21900.99146,1.439361,3918.405459,4857.711165,Malicious
10.0.2.15,57057,119.254.87.201,80,11,1582,6,705,5,877,21903.46414,6.66286,846.483342,1053.001264,Malicious
10.0.2.15,40138,119.254.87.201,80,11,1579,6,705,5,874,21906.52158,1.44838,3894.005717,4827.462406,Malicious
10.0.2.15,39431,119.254.87.201,80,11,1582,6,705,5,877,21931.02187,1.556657,3623.148838,4507.09437,Malicious
10.0.2.15,44602,119.254.87.201,80,11,1579,6,705,5,874,21933.48685,0.978613,5763.258816,7144.805965,Malicious
10.0.2.15,49340,119.254.87.201,80,11,1579,6,705,5,874,21936.57535,1.098325,5135.092072,6366.057406,Malicious
10.0.2.15,42839,119.254.87.201,80,11,1582,6,705,5,877,21961.05348,1.027625,5488.383408,6827.393261,Malicious
10.0.2.15,60482,119.254.87.201,80,11,1579,6,705,5,874,21963.51692,0.98337,5735.379359,7110.243347,Malicious
10.0.2.15,60346,119.254.87.201,80,11,1582,6,705,5,877,21966.60784,1.024452,5505.38239,6848.539512,Malicious
10.0.2.15,60802,119.254.87.201,80,11,1582,6,705,5,877,21991.0854,1.054463,5348.694075,6653.623693,Malicious
10.0.2.15,47134,119.254.87.201,80,12,1656,7,779,5,877,21993.57572,4.074309,1529.584526,1722.009794,Malicious
10.0.2.15,57028,119.254.87.201,80,12,1656,7,779,5,877,21996.65597,4.118029,1513.345341,1703.727681,Malicious
10.0.2.15,56927,119.254.87.201,80,11,1569,6,705,5,864,22021.12529,2.083244,2707.31609,3317.902272,Malicious
10.0.2.15,43905,119.254.87.201,80,11,1579,6,705,5,874,22023.58084,2.12175,2658.183104,3295.392954,Malicious
10.0.2.15,48814,119.254.87.201,80,11,1582,6,705,5,877,22026.67397,2.031695,2776.007225,3453.274237,Malicious
10.0.2.15,35969,119.254.87.201,80,11,1582,6,705,5,877,22051.1505,2.154807,2617.403786,3255.976057,Malicious
10.0.2.15,36377,119.254.87.201,80,11,1513,6,705,5,808,22053.60739,2.042973,2760.682593,3164.016362,Malicious
10.0.2.15,60631,119.254.87.201,80,11,1585,6,705,5,880,22056.69336,2.2461,2511.0191,3134.321713,Malicious
10.0.2.15,37401,119.254.87.201,80,11,1582,6,705,5,877,22081.17039,1.45351,3880.262262,4826.936175,Malicious
10.0.2.15,40169,119.254.87.201,80,11,1582,6,705,5,877,22083.65888,1.423143,3963.059229,4929.933253,Malicious
10.0.2.15,35327,119.254.87.201,80,11,1579,6,705,5,874,22086.72118,1.328003,4246.978358,5265.048347,Malicious
10.0.2.15,58043,119.254.87.201,80,11,1551,6,705,5,846,22111.17427,2.149346,2624.054015,3148.864817,Malicious
10.0.2.15,38747,119.254.87.201,80,11,1582,6,705,5,877,22113.69376,2.113894,2668.06188,3318.993289,Malicious
10.0.2.15,42291,119.254.87.201,80,11,1582,6,705,5,877,22116.77922,2.185609,2580.51646,3210.08927,Malicious
10.0.2.15,45643,119.254.87.201,80,11,1582,6,705,5,877,22141.20854,2.820114,1999.919152,2487.84269,Malicious
10.0.2.15,36767,119.254.87.201,80,11,1513,6,705,5,808,22143.75674,3.015732,1870.192709,2143.426538,Malicious
10.0.2.15,60500,119.254.87.201,80,11,1582,6,705,5,877,22146.81278,0.823688,6847.252843,8517.788289,Malicious
10.0.2.15,53022,119.254.87.201,80,11,1579,6,705,5,874,22171.2821,1.485948,3795.556776,4705.413648,Malicious
10.0.2.15,44355,119.254.87.201,80,11,1579,6,705,5,874,22173.80859,1.446428,3899.2608,4833.977218,Malicious
10.0.2.15,60766,119.254.87.201,80,11,1554,6,705,5,849,22176.83658,1.042495,5410.09789,6515.139161,Malicious
10.0.2.15,40062,119.254.87.201,80,11,1513,6,705,5,808,22201.31449,0.831265,6784.839973,7776.100281,Malicious
10.0.2.15,47306,119.254.87.201,80,11,1513,6,705,5,808,22203.84182,1.48296,3803.204402,4358.849868,Malicious
10.0.2.15,34723,119.254.87.201,80,11,1579,6,705,5,874,22206.8341,0.817729,6897.150523,8550.51001,Malicious
10.0.2.15,45744,119.254.87.201,80,11,1582,6,705,5,877,22231.316,0.952421,5921.75099,7366.490239,Malicious
10.0.2.15,44083,119.254.87.201,80,11,1579,6,705,5,874,22233.90339,1.448004,3895.016865,4828.715943,Malicious
10.0.2.15,42140,119.254.87.201,80,12,1587,7,779,5,808,22236.89276,4.478771,1391.453146,1443.253071,Malicious
10.0.2.15,56798,119.254.87.201,80,11,1579,6,705,5,874,22261.35183,4.413392,1277.928632,1584.26897,Malicious
10.0.2.15,57944,119.254.87.201,80,11,1582,6,705,5,877,22263.95552,2.214579,2546.759452,3168.09651,Malicious
10.0.2.15,44948,119.254.87.201,80,11,1558,6,705,5,853,22266.95282,2.155396,2616.688534,3166.007546,Malicious
10.0.2.15,50854,119.254.87.201,80,11,1582,6,705,5,877,22291.41477,1.501067,3757.327288,4674.008555,Malicious
10.0.2.15,47233,119.254.87.201,80,11,1587,6,705,5,882,22294.0288,0.960056,5874.657312,7349.571275,Malicious
10.0.2.15,57636,119.254.87.201,80,11,1582,6,705,5,877,22296.95778,1.717085,3284.636462,4085.994578,Malicious
10.0.2.15,41623,119.254.87.201,80,11,1579,6,705,5,874,22321.46565,1.030825,5471.345767,6782.916596,Malicious
10.0.2.15,48283,119.254.87.201,80,11,1579,6,705,5,874,22324.06831,1.028227,5485.170103,6800.054852,Malicious
10.0.2.15,35618,119.254.87.201,80,11,1579,6,705,5,874,22326.98963,1.031994,5465.148053,6775.233189,Malicious
10.0.2.15,58682,119.254.87.201,80,11,1513,6,705,5,808,22351.60903,0.945171,5967.174194,6838.974112,Malicious
10.0.2.15,49755,119.254.87.201,80,11,1587,6,705,5,882,22354.09787,1.421368,3968.008285,4964.231642,Malicious
10.0.2.15,58598,119.254.87.201,80,11,1582,6,705,5,877,22357.03766,0.960636,5871.110389,7303.494768,Malicious
10.0.2.15,56115,119.254.87.201,80,12,1653,7,779,5,874,22381.54664,4.523335,1377.744518,1545.762142,Malicious
10.0.2.15,60096,119.254.87.201,80,11,1582,6,705,5,877,22384.12785,0.892165,6321.700582,7864.016185,Malicious
10.0.2.15,42735,119.254.87.201,80,11,1579,6,705,5,874,22387.04261,1.424303,3959.831581,4909.067804,Malicious
10.0.2.15,53746,119.254.87.201,80,11,1579,6,705,5,874,22411.57959,1.125978,5008.978861,6209.712801,Malicious
10.0.2.15,58426,119.254.87.201,80,11,1579,6,705,5,874,22414.16694,1.220675,4620.394454,5727.978373,Malicious
10.0.2.15,60657,119.254.87.201,80,11,1579,6,705,5,874,22417.11795,1.214653,4643.30142,5756.376512,Malicious
10.0.2.15,59890,119.254.87.201,80,13,1727,8,853,5,874,22441.63388,10.017491,681.2084982,697.9791646,Malicious
10.0.2.15,58498,119.254.87.201,80,11,1579,6,705,5,874,22444.21201,1.423292,3962.644348,4912.554838,Malicious
10.0.2.15,50998,119.254.87.201,80,11,1579,6,705,5,874,22447.13412,1.027377,5489.708257,6805.680875,Malicious
10.0.2.15,34043,119.254.87.201,80,11,1513,6,705,5,808,22471.64269,4.448492,1267.845373,1453.076683,Malicious
10.0.2.15,44949,119.254.87.201,80,11,1513,6,705,5,808,22474.27183,1.819205,3100.255331,3553.200436,Malicious
10.0.2.15,40625,119.254.87.201,80,11,1560,6,705,5,855,22477.32229,0.981683,5745.235478,6967.626006,Malicious
10.0.2.15,32944,119.254.87.201,80,11,1579,6,705,5,874,22501.67361,1.087044,5188.382439,6432.122343,Malicious
10.0.2.15,39211,119.254.87.201,80,11,1582,6,705,5,877,22504.27618,1.88353,2994.377578,3724.92076,Malicious
10.0.2.15,32975,119.254.87.201,80,11,1582,6,705,5,877,22507.21289,1.098878,5132.507885,6384.694206,Malicious
10.0.2.15,56964,119.254.87.201,80,11,1569,6,705,5,864,22531.69623,0.893088,6315.16715,7739.438891,Malicious
10.0.2.15,44405,119.254.87.201,80,11,1579,6,705,5,874,22534.31246,1.516981,3717.910771,4609.15463,Malicious
10.0.2.15,46198,119.254.87.201,80,11,1579,6,705,5,874,22537.21101,1.016351,5549.263985,6879.513082,Malicious
10.0.2.15,43232,119.254.87.201,80,11,1579,6,705,5,874,22561.72066,1.483277,3802.391596,4713.886887,Malicious
10.0.2.15,45950,119.254.87.201,80,11,1579,6,705,5,874,22564.37629,1.708445,3301.247626,4092.610532,Malicious
10.0.2.15,58874,119.254.87.201,80,11,1582,6,705,5,877,22567.2495,1.529671,3687.06735,4586.607185,Malicious
10.0.2.15,59045,119.254.87.201,80,11,1582,6,705,5,877,22591.77846,1.442266,3910.51304,4864.567285,Malicious
10.0.2.15,33160,119.254.87.201,80,11,1579,6,705,5,874,22594.41996,1.127841,5000.704887,6199.45542,Malicious
10.0.2.15,35198,119.254.87.201,80,11,1579,6,705,5,874,22597.30989,2.654531,2124.669104,2633.986945,Malicious
10.0.2.15,34072,119.254.87.201,80,11,1513,6,705,5,808,22621.81161,1.487799,3790.834649,4344.672903,Malicious
10.0.2.15,43040,119.254.87.201,80,11,1579,6,705,5,874,22624.47751,1.819955,3098.977722,3841.853233,Malicious
10.0.2.15,51276,119.254.87.201,80,11,1513,6,705,5,808,22627.33475,6.630962,850.5553191,974.820848,Malicious
10.0.2.15,37074,119.254.87.201,80,13,1730,8,853,5,877,22651.86684,10.426378,654.4938233,672.9086553,Malicious
10.0.2.15,35407,119.254.87.201,80,11,1582,6,705,5,877,22654.5217,1.700465,3316.739833,4125.93026,Malicious
10.0.2.15,38912,119.254.87.201,80,11,1579,6,705,5,874,22657.39277,1.544518,3651.624649,4526.978643,Malicious
10.0.2.15,41360,119.254.87.201,80,11,1513,6,705,5,808,22681.8737,1.181087,4775.26211,5472.924518,Malicious
10.0.2.15,51102,119.254.87.201,80,11,1579,6,705,5,874,22684.56445,1.621433,3478.404596,4312.234918,Malicious
10.0.2.15,59426,119.254.87.201,80,11,1513,6,705,5,808,22687.55234,1.447522,3896.313838,4465.562527,Malicious
10.0.2.15,55938,119.254.87.201,80,11,1582,6,705,5,877,22711.92965,1.753813,3215.850265,4000.426499,Malicious
10.0.2.15,45022,119.254.87.201,80,13,1730,8,853,5,877,22714.62416,10.011594,681.6097417,700.787507,Malicious
10.0.2.15,49241,119.254.87.201,80,11,1579,6,705,5,874,22717.47562,3.415036,1651.519925,2047.416191,Malicious
10.0.2.15,37734,119.254.87.201,80,11,1579,6,705,5,874,22741.96165,0.985545,5722.721946,7094.551745,Malicious
10.0.2.15,47748,119.254.87.201,80,11,1579,6,705,5,874,22744.65659,1.01463,5558.676562,6891.182007,Malicious
10.0.2.15,48958,119.254.87.201,80,11,1579,6,705,5,874,22747.50981,1.419505,3973.216015,4925.660706,Malicious
10.0.2.15,53372,119.254.87.201,80,11,1582,6,705,5,877,22771.98857,1.121285,5029.943324,6257.106802,Malicious
10.0.2.15,45763,119.254.87.201,80,11,1582,6,705,5,877,22774.69353,6.898436,817.5766217,1017.042124,Malicious
10.0.2.15,54154,119.254.87.201,80,11,1559,6,705,5,854,22777.56096,1.079935,5222.536542,6326.306676,Malicious
10.0.2.15,59578,119.254.87.201,80,11,1513,6,705,5,808,22802.04116,1.052337,5359.499856,6142.518984,Malicious
10.0.2.15,34468,119.254.87.201,80,11,1587,6,705,5,882,22804.7229,0.993706,5675.723001,7100.691754,Malicious
10.0.2.15,47986,119.254.87.201,80,11,1534,6,705,5,829,22807.62367,1.088925,5179.42007,6090.410267,Malicious
10.0.2.15,60326,119.254.87.201,80,11,1582,6,705,5,877,22832.04147,0.822803,6854.617691,8526.94995,Malicious
10.0.2.15,59784,119.254.87.201,80,12,1653,7,779,5,874,22834.80009,5.363239,1161.98439,1303.689804,Malicious
10.0.2.15,38569,119.254.87.201,80,11,1579,6,705,5,874,22837.63197,1.15543,4881.299603,6051.426742,Malicious
10.0.2.15,33732,119.254.87.201,80,11,1582,6,705,5,877,22862.1044,1.885549,2991.171272,3720.932206,Malicious
10.0.2.15,44486,119.254.87.201,80,11,1579,6,705,5,874,22864.83333,0.818678,6889.155443,8540.598379,Malicious
10.0.2.15,36172,119.254.87.201,80,11,1560,6,705,5,855,22867.74659,0.993464,5677.105562,6885.000362,Malicious
10.0.2.15,40983,119.254.87.201,80,11,1582,6,705,5,877,22892.13295,1.484616,3798.962156,4725.80115,Malicious
10.0.2.15,59569,119.254.87.201,80,11,1579,6,705,5,874,22894.87083,1.056902,5336.350958,6615.561329,Malicious
10.0.2.15,40508,119.254.87.201,80,11,1513,6,705,5,808,22897.63315,1.71752,3283.804555,3763.566072,Malicious
10.0.2.15,37379,119.254.87.201,80,11,1579,6,705,5,874,22922.18845,9.11208,618.9585693,767.3330348,Malicious
10.0.2.15,45295,119.254.87.201,80,11,1582,6,705,5,877,22924.93307,1.084298,5201.522091,6470.54592,Malicious
10.0.2.15,37628,119.254.87.201,80,11,1579,6,705,5,874,22927.65448,1.022891,5513.783971,6835.52793,Malicious
10.0.2.15,50780,119.254.87.201,80,11,1579,6,705,5,874,22953.20605,1.547924,3643.589737,4517.017631,Malicious
10.0.2.15,52075,119.254.87.201,80,11,1582,6,705,5,877,22954.9883,0.959796,5876.248703,7309.886684,Malicious
10.0.2.15,59480,119.254.87.201,80,11,1579,6,705,5,874,22957.65365,1.087509,5186.163977,6429.372079,Malicious
10.0.2.15,59213,119.254.87.201,80,11,1579,6,705,5,874,22982.22374,2.222978,2537.13712,3145.330273,Malicious
10.0.2.15,56222,119.254.87.201,80,11,1582,6,705,5,877,22985.0142,2.289591,2463.322052,3064.302751,Malicious
10.0.2.15,41627,119.254.87.201,80,11,1582,6,705,5,877,22987.67843,2.248462,2508.381285,3120.355158,Malicious
10.0.2.15,40831,119.254.87.201,80,11,1513,6,705,5,808,23012.24837,2.181979,2584.809478,2962.44831,Malicious
10.0.2.15,60371,119.254.87.201,80,11,1587,6,705,5,882,23015.06881,2.088683,2700.266149,3378.205309,Malicious
10.0.2.15,40301,119.254.87.201,80,11,1582,6,705,5,877,23017.73893,2.246545,2510.521712,3123.01779,Malicious
10.0.2.15,33293,119.254.87.201,80,11,1582,6,705,5,877,23042.27965,0.84843,6647.572575,8269.3917,Malicious
10.0.2.15,56087,119.254.87.201,80,12,1656,7,779,5,877,23045.09899,3.88221,1605.271224,1807.218054,Malicious
10.0.2.15,57457,119.254.87.201,80,11,1582,6,705,5,877,23047.79729,3.264971,1727.427288,2148.870541,Malicious
10.0.2.15,37920,119.254.87.201,80,11,1582,6,705,5,877,23072.30788,0.959912,5875.538591,7309.003325,Malicious
10.0.2.15,53377,119.254.87.201,80,11,1582,6,705,5,877,23075.13002,1.413748,3989.395564,4962.694907,Malicious
10.0.2.15,43761,119.254.87.201,80,11,1558,6,705,5,853,23077.91473,3.154213,1788.084698,2163.45567,Malicious
10.0.2.15,55787,119.254.87.201,80,11,1593,6,705,5,888,23102.36506,0.886397,6362.837419,8014.467558,Malicious
10.0.2.15,43642,119.254.87.201,80,11,1582,6,705,5,877,23105.15694,0.818604,6889.778208,8570.688636,Malicious
10.0.2.15,42655,119.254.87.201,80,11,1513,6,705,5,808,23107.84005,0.958535,5883.979197,6743.624385,Malicious
10.0.2.15,37097,119.254.87.201,80,11,1551,6,705,5,846,23132.36992,2.122257,2657.548073,3189.057687,Malicious
10.0.2.15,46212,119.254.87.201,80,11,1579,6,705,5,874,23135.18999,2.181315,2585.596303,3205.405913,Malicious
10.0.2.15,59452,119.254.87.201,80,11,1582,6,705,5,877,23137.82091,2.215335,2545.890351,3167.015372,Malicious
10.0.2.15,51839,119.254.87.201,80,11,1582,6,705,5,877,23162.42196,2.317918,2433.218086,3026.854272,Malicious
10.0.2.15,60020,119.254.87.201,80,11,1513,6,705,5,808,23165.24489,2.218967,2541.723243,2913.067207,Malicious
10.0.2.15,52763,119.254.87.201,80,11,1569,6,705,5,864,23167.83069,2.275306,2478.787469,3037.833153,Malicious
10.0.2.15,45704,119.254.87.201,80,11,1582,6,705,5,877,23192.42553,0.96105,5868.581239,7300.348577,Malicious
10.0.2.15,37833,119.254.87.201,80,11,1579,6,705,5,874,23195.25053,1.02509,5501.955926,6820.864509,Malicious
10.0.2.15,52413,119.254.87.201,80,11,1582,6,705,5,877,23197.84896,0.926729,6085.921559,7570.713769,Malicious
10.0.2.15,34087,119.254.87.201,80,11,1582,6,705,5,877,23222.45124,0.948976,5943.248301,7393.232284,Malicious
10.0.2.15,54901,119.254.87.201,80,11,1513,6,705,5,808,23225.30593,0.851344,6624.81911,7592.700483,Malicious
10.0.2.15,39097,119.254.87.201,80,11,1579,6,705,5,874,23227.87947,1.489807,3785.725265,4693.225364,Malicious
10.0.2.15,38279,119.254.87.201,80,11,1582,6,705,5,877,23252.46162,1.594283,3537.640431,4400.724338,Malicious
10.0.2.15,38258,119.254.87.201,80,11,1579,6,705,5,874,23255.35675,0.898253,6278.854621,7783.998495,Malicious
10.0.2.15,59853,119.254.87.201,80,11,1582,6,705,5,877,23257.90516,3.850052,1464.915279,1822.313049,Malicious
10.0.2.15,50418,119.254.87.201,80,12,1653,7,779,5,874,23282.5134,4.347402,1433.499824,1608.316875,Malicious
10.0.2.15,38702,119.254.87.201,80,11,1582,6,705,5,877,23285.41427,1.446378,3899.395594,4850.737497,Malicious
10.0.2.15,38302,119.254.87.201,80,12,1656,7,779,5,877,23287.96509,4.442632,1402.77205,1579.244016,Malicious
10.0.2.15,57175,119.254.87.201,80,11,1582,6,705,5,877,23312.53773,0.819577,6881.598678,8560.513533,Malicious
10.0.2.15,43828,119.254.87.201,80,11,1513,6,705,5,808,23315.52504,0.787331,7163.442059,8210.015864,Malicious
10.0.2.15,46527,119.254.87.201,80,11,1585,6,705,5,880,23318.00711,0.893354,6313.286782,7880.414707,Malicious
10.0.2.15,40606,119.254.87.201,80,12,1656,7,779,5,877,23342.59691,5.152157,1209.590469,1361.759745,Malicious
10.0.2.15,51858,119.254.87.201,80,11,1582,6,705,5,877,23345.50293,2.106246,2677.749892,3331.044902,Malicious
10.0.2.15,33202,119.254.87.201,80,11,1579,6,705,5,874,23348.05734,5.117874,1102.020097,1366.19229,Malicious
10.0.2.15,49592,119.254.87.201,80,11,1582,6,705,5,877,23372.59782,2.080832,2710.45428,3371.728232,Malicious
10.0.2.15,44549,119.254.87.201,80,11,1582,6,705,5,877,23375.51279,2.155198,2616.928932,3255.385352,Malicious
10.0.2.15,59539,119.254.87.201,80,11,1582,6,705,5,877,23378.11181,2.086001,2703.737918,3363.373268,Malicious
10.0.2.15,42348,119.254.87.201,80,11,1582,6,705,5,877,23402.61001,4.279917,1317.782564,1639.284126,Malicious
10.0.2.15,43150,119.254.87.201,80,11,1579,6,705,5,874,23405.53314,2.022247,2788.976816,3457.540053,Malicious
10.0.2.15,35181,119.254.87.201,80,11,1587,6,705,5,882,23408.12069,2.12677,2651.908763,3317.707133,Malicious
10.0.2.15,51454,119.254.87.201,80,11,1582,6,705,5,877,23432.62729,2.053917,2745.972695,3415.912133,Malicious
10.0.2.15,54410,119.254.87.201,80,11,1544,6,705,5,839,23435.59025,2.157011,2614.729364,3111.713385,Malicious
10.0.2.15,50752,119.254.87.201,80,11,1582,6,705,5,877,23438.18079,2.088444,2700.575165,3359.438893,Malicious
10.0.2.15,33750,119.254.87.201,80,11,1513,6,705,5,808,23462.68381,4.131058,1365.267687,1564.732328,Malicious
10.0.2.15,46281,119.254.87.201,80,12,1625,7,779,5,846,23465.61734,5.121671,1216.79038,1321.443724,Malicious
10.0.2.15,39471,119.254.87.201,80,11,1569,6,705,5,864,23468.2575,2.074415,2718.838805,3332.023727,Malicious
10.0.2.15,52720,119.254.87.201,80,11,1579,6,705,5,874,23492.74504,2.11636,2664.953033,3303.785745,Malicious
10.0.2.15,47703,119.254.87.201,80,11,1579,6,705,5,874,23495.63073,2.072922,2720.79702,3373.016447,Malicious
10.0.2.15,49087,119.254.87.201,80,11,1582,6,705,5,877,23498.26928,2.145317,2628.982104,3270.379156,Malicious
10.0.2.15,50331,119.254.87.201,80,11,1582,6,705,5,877,23522.79673,2.118474,2662.293708,3311.817846,Malicious
10.0.2.15,35212,119.254.87.201,80,11,1579,6,705,5,874,23525.68687,2.087295,2702.061759,3349.790039,Malicious
10.0.2.15,50160,119.254.87.201,80,11,1513,6,705,5,808,23528.2734,2.021872,2789.494093,3197.037201,Malicious
10.0.2.15,36876,119.254.87.201,80,11,1579,6,705,5,874,23552.82467,2.11923,2661.343979,3299.311542,Malicious
10.0.2.15,56744,119.254.87.201,80,11,1582,6,705,5,877,23555.87216,4.029819,1399.566581,1741.021123,Malicious
10.0.2.15,53677,119.254.87.201,80,11,1513,6,705,5,808,23558.32683,5.047149,1117.462552,1280.723038,Malicious
10.0.2.15,42278,119.254.87.201,80,11,1582,6,705,5,877,23582.866,2.02361,2787.098305,3467.071224,Malicious
10.0.2.15,38947,119.254.87.201,80,11,1554,6,705,5,849,23585.79527,2.159393,2611.845088,3145.32834,Malicious
10.0.2.15,54215,119.254.87.201,80,11,1582,6,705,5,877,23588.32731,2.049463,2751.940386,3423.335771,Malicious
10.0.2.15,59987,119.254.87.201,80,11,1587,6,705,5,882,23612.88577,0.931378,6055.543506,7575.871451,Malicious
10.0.2.15,49505,119.254.87.201,80,11,1579,6,705,5,874,23615.82285,0.831421,6783.566929,8409.698576,Malicious
10.0.2.15,43896,119.254.87.201,80,11,1579,6,705,5,874,23618.37139,2.617885,2154.410908,2670.858346,Malicious
10.0.2.15,58582,119.254.87.201,80,11,1582,6,705,5,877,23642.89303,2.149851,2623.437624,3263.481981,Malicious
10.0.2.15,47942,119.254.87.201,80,11,1582,6,705,5,877,23645.82337,2.282572,2470.896865,3073.725604,Malicious
10.0.2.15,44136,119.254.87.201,80,11,1582,6,705,5,877,23648.41404,5.174189,1090.025896,1355.961292,Malicious
10.0.2.15,49816,119.254.87.201,80,13,1730,8,853,5,877,23672.94513,10.136672,673.1992512,692.140379,Malicious
10.0.2.15,43978,119.254.87.201,80,11,1579,6,705,5,874,23675.82445,1.356234,4158.574405,5155.452525,Malicious
10.0.2.15,41737,119.254.87.201,80,12,1653,7,779,5,874,23678.41676,3.846038,1620.368806,1817.974757,Malicious
10.0.2.15,56450,119.254.87.201,80,11,1579,6,705,5,874,23702.94897,1.32332,4262.007678,5283.68044,Malicious
10.0.2.15,58575,119.254.87.201,80,11,1579,6,705,5,874,23705.93274,1.25763,4484.625844,5559.663812,Malicious
10.0.2.15,49394,119.254.87.201,80,11,1513,6,705,5,808,23708.43624,0.879197,6414.944546,7352.163395,Malicious
10.0.2.15,43473,119.254.87.201,80,11,1582,6,705,5,877,23732.94851,1.025503,5499.740128,6841.520698,Malicious
10.0.2.15,40073,119.254.87.201,80,11,1582,6,705,5,877,23735.89788,1.350098,4177.474524,5196.659798,Malicious
10.0.2.15,54300,119.254.87.201,80,11,1582,6,705,5,877,23738.4934,1.421749,3966.944939,4934.766967,Malicious
10.0.2.15,35508,119.254.87.201,80,11,1582,6,705,5,877,23763.00752,2.218269,2542.523021,3162.82651,Malicious
10.0.2.15,51006,119.254.87.201,80,11,1513,6,705,5,808,23765.92407,2.216628,2544.405286,2916.141094,Malicious
10.0.2.15,42876,119.254.87.201,80,11,1552,6,705,5,847,23768.5212,2.284572,2468.73375,2965.98225,Malicious
10.0.2.15,42494,119.254.87.201,80,11,1579,6,705,5,874,23793.04274,1.117636,5046.365722,6256.061902,Malicious
10.0.2.15,36660,119.254.87.201,80,11,1582,6,705,5,877,23795.99842,1.166126,4836.527099,6016.502505,Malicious
10.0.2.15,38702,119.254.87.201,80,11,1579,6,705,5,874,23798.53357,1.022833,5514.096632,6835.91554,Malicious
10.0.2.15,45493,119.254.87.201,80,11,1579,6,705,5,874,23823.09962,1.351429,4173.360199,5173.782714,Malicious
10.0.2.15,49213,119.254.87.201,80,11,1582,6,705,5,877,23826.00776,1.023284,5511.66636,6856.356593,Malicious
10.0.2.15,42554,119.254.87.201,80,11,1582,6,705,5,877,23828.54741,1.124796,5014.242583,6237.575525,Malicious
10.0.2.15,59684,119.254.87.201,80,11,1582,6,705,5,877,23853.12468,5.041279,1118.763711,1391.710318,Malicious
10.0.2.15,35241,119.254.87.201,80,11,1582,6,705,5,877,23856.06199,2.103824,2680.832617,3334.879724,Malicious
10.0.2.15,44081,119.254.87.201,80,11,1534,6,705,5,829,23858.60969,2.05814,2740.338364,3222.326955,Malicious
10.0.2.15,38507,119.254.87.201,80,11,1579,6,705,5,874,23883.15713,2.07335,2720.235368,3372.320158,Malicious
10.0.2.15,35123,119.254.87.201,80,12,1633,7,779,5,854,23886.06651,5.154038,1209.149021,1325.562598,Malicious
10.0.2.15,57799,119.254.87.201,80,12,1653,7,779,5,874,23888.63445,5.009151,1244.123006,1395.845324,Malicious
10.0.2.15,55501,119.254.87.201,80,11,1558,6,705,5,853,23913.17704,2.171051,2597.820134,3143.17812,Malicious
10.0.2.15,54595,119.254.87.201,80,11,1579,6,705,5,874,23916.11861,4.06559,1387.252527,1719.799586,Malicious
10.0.2.15,40561,119.254.87.201,80,11,1579,6,705,5,874,23918.6462,2.21701,2543.966874,3153.797231,Malicious
10.0.2.15,34686,119.254.87.201,80,11,1582,6,705,5,877,23943.21968,11.217389,502.790801,625.4574928,Malicious
10.0.2.15,44405,119.254.87.201,80,11,1579,6,705,5,874,23946.12388,2.118038,2662.841743,3301.168345,Malicious
10.0.2.15,57665,119.254.87.201,80,11,1582,6,705,5,877,23948.67493,2.048954,2752.624022,3424.186195,Malicious
10.0.2.15,44890,119.254.87.201,80,11,1582,6,705,5,877,23973.2658,2.070679,2723.74424,3388.260566,Malicious
10.0.2.15,42291,119.254.87.201,80,11,1579,6,705,5,874,23976.17832,2.088205,2700.884252,3348.330265,Malicious
10.0.2.15,58242,119.254.87.201,80,11,1579,6,705,5,874,23978.7012,2.052409,2747.990288,3406.728386,Malicious
10.0.2.15,51187,119.254.87.201,80,11,1579,6,705,5,874,24003.32266,2.116565,2664.694918,3303.465757,Malicious
10.0.2.15,32983,119.254.87.201,80,12,1656,7,779,5,877,24006.20722,5.14414,1211.475582,1363.882009,Malicious
10.0.2.15,39827,119.254.87.201,80,11,1513,6,705,5,808,24008.70206,2.053275,2746.831282,3148.141384,Malicious
10.0.2.15,39335,119.254.87.201,80,11,1582,6,705,5,877,24033.3651,2.103831,2680.823697,3334.868628,Malicious
10.0.2.15,33983,119.254.87.201,80,11,1579,6,705,5,874,24036.23679,2.071202,2723.056467,3375.81752,Malicious
10.0.2.15,34745,119.254.87.201,80,11,1513,6,705,5,808,24038.75059,2.21248,2549.175586,2921.608331,Malicious
10.0.2.15,33402,119.254.87.201,80,11,1579,6,705,5,874,24063.41341,2.05313,2747.025274,3405.532041,Malicious
10.0.2.15,46090,119.254.87.201,80,11,1534,6,705,5,829,24066.30187,2.153803,2618.623895,3079.204551,Malicious
10.0.2.15,46181,119.254.87.201,80,11,1582,6,705,5,877,24068.75875,2.019117,2793.30024,3474.786256,Malicious
10.0.2.15,33139,119.254.87.201,80,12,1587,7,779,5,808,24093.4377,6.208659,1003.759427,1041.126594,Malicious
10.0.2.15,37926,119.254.87.201,80,11,1579,6,705,5,874,24096.35963,1.182755,4768.527717,5911.621595,Malicious
10.0.2.15,59857,119.254.87.201,80,11,1579,6,705,5,874,24098.77971,3.875702,1455.220241,1804.060271,Malicious
10.0.2.15,40962,119.254.87.201,80,11,1582,6,705,5,877,24123.43819,1.35571,4160.18175,5175.148077,Malicious
10.0.2.15,59042,119.254.87.201,80,11,1582,6,705,5,877,24126.4623,2.577702,2187.995354,2721.80415,Malicious
10.0.2.15,40908,119.254.87.201,80,11,1579,6,705,5,874,24128.84132,1.482777,3803.673782,4715.476434,Malicious
10.0.2.15,54536,119.254.87.201,80,11,1582,6,705,5,877,24153.50052,5.078251,1110.618597,1381.578028,Malicious
10.0.2.15,41961,119.254.87.201,80,11,1582,6,705,5,877,24156.5161,2.133631,2643.381166,3288.291181,Malicious
10.0.2.15,55552,119.254.87.201,80,11,1513,6,705,5,808,24158.89504,5.070604,1112.293526,1274.798821,Malicious
10.0.2.15,43756,119.254.87.201,80,11,1561,6,705,5,856,24183.55658,1.467776,3842.548182,4665.562048,Malicious
10.0.2.15,33016,119.254.87.201,80,11,1582,6,705,5,877,24186.40392,2.494001,2261.426519,2813.150436,Malicious
10.0.2.15,59774,119.254.87.201,80,11,1513,6,705,5,808,24188.93114,1.41434,3987.725724,4570.329624,Malicious
10.0.2.15,36983,119.254.87.201,80,11,1582,6,705,5,877,24213.59558,2.115437,2666.115795,3316.572415,Malicious
10.0.2.15,46208,119.254.87.201,80,11,1582,6,705,5,877,24216.41576,2.023314,2787.506042,3467.578438,Malicious
10.0.2.15,44146,119.254.87.201,80,11,1551,6,705,5,846,24218.93776,2.168389,2601.009321,3121.211185,Malicious
10.0.2.15,53327,119.254.87.201,80,11,1513,6,705,5,808,24243.59804,1.224639,4605.438827,5278.290174,Malicious
10.0.2.15,37501,119.254.87.201,80,11,1579,6,705,5,874,24246.46914,1.279609,4407.596383,5464.169133,Malicious
10.0.2.15,35339,119.254.87.201,80,11,1582,6,705,5,877,24248.98741,1.220372,4621.541628,5749.066678,Malicious
10.0.2.15,55024,119.254.87.201,80,11,1582,6,705,5,877,24273.65597,0.909484,6201.31855,7714.264352,Malicious
10.0.2.15,43923,119.254.87.201,80,12,1608,7,779,5,829,24276.53174,3.861829,1613.743125,1717.32099,Malicious
10.0.2.15,33134,119.254.87.201,80,11,1593,6,705,5,888,24279.04409,1.001471,5631.715746,7093.565365,Malicious
10.0.2.15,59220,119.254.87.201,80,11,1579,6,705,5,874,24303.68015,2.083998,2706.33657,3355.089592,Malicious
10.0.2.15,36052,119.254.87.201,80,11,1582,6,705,5,877,24306.54899,2.220357,2540.13206,3159.852222,Malicious
10.0.2.15,55268,119.254.87.201,80,11,1582,6,705,5,877,24309.07617,2.14603,2628.108647,3269.292601,Malicious
10.0.2.15,59580,119.254.87.201,80,11,1579,6,705,5,874,24333.73922,1.112532,5069.517102,6284.763045,Malicious
10.0.2.15,45363,119.254.87.201,80,11,1582,6,705,5,877,24336.56002,1.418813,3975.153879,4944.978655,Malicious
10.0.2.15,38131,119.254.87.201,80,11,1579,6,705,5,874,24339.08189,1.059031,5325.62314,6602.261879,Malicious
10.0.2.15,41643,119.254.87.201,80,11,1579,6,705,5,874,24363.75933,1.225113,4603.656969,5707.228639,Malicious
10.0.2.15,60105,119.254.87.201,80,11,1582,6,705,5,877,24366.6222,1.086306,5191.907253,6458.585334,Malicious
10.0.2.15,56655,119.254.87.201,80,11,1513,6,705,5,808,24369.1392,1.253417,4499.699621,5157.102544,Malicious
10.0.2.15,54603,119.254.87.201,80,12,1653,7,779,5,874,24393.7867,3.904761,1596.00037,1790.634561,Malicious
10.0.2.15,41085,119.254.87.201,80,11,1582,6,705,5,877,24396.64411,1.047187,5385.85754,6699.85399,Malicious
10.0.2.15,34926,119.254.87.201,80,11,1579,6,705,5,874,24399.19779,1.150441,4902.467836,6077.669346,Malicious
10.0.2.15,37051,119.254.87.201,80,11,1579,6,705,5,874,24423.82856,1.25634,4489.230622,5565.372431,Malicious
10.0.2.15,36587,119.254.87.201,80,11,1513,6,705,5,808,24426.74638,1.609572,3504.037098,4015.974433,Malicious
10.0.2.15,58408,119.254.87.201,80,11,1582,6,705,5,877,24429.25814,1.111894,5072.425969,6309.954006,Malicious
10.0.2.15,39676,119.254.87.201,80,11,1582,6,705,5,877,24453.88527,0.981235,5747.858566,7150.172996,Malicious
10.0.2.15,59969,119.254.87.201,80,11,1579,6,705,5,874,24456.70377,1.099906,5127.710913,6356.906863,Malicious
10.0.2.15,56245,119.254.87.201,80,13,1727,8,853,5,874,24459.30954,9.86134,691.9952055,709.0314298,Malicious
10.0.2.15,53498,119.254.87.201,80,11,1579,6,705,5,874,24483.90785,0.951417,5928.000025,7349.038329,Malicious
10.0.2.15,40345,119.254.87.201,80,11,1579,6,705,5,874,24486.76346,1.02087,5524.699521,6849.060115,Malicious
10.0.2.15,57485,119.254.87.201,80,11,1579,6,705,5,874,24489.36575,1.095565,5148.028643,6382.095083,Malicious
10.0.2.15,33118,119.254.87.201,80,11,1579,6,705,5,874,24513.91093,0.986026,5719.930306,7091.090904,Malicious
10.0.2.15,56715,119.254.87.201,80,11,1582,6,705,5,877,24516.79329,1.095751,5147.154782,6402.914531,Malicious
10.0.2.15,54798,119.254.87.201,80,11,1582,6,705,5,877,24519.39536,1.427657,3950.528733,4914.345673,Malicious
10.0.2.15,56244,119.254.87.201,80,11,1579,6,705,5,874,24543.9674,1.509193,3737.096581,4632.939591,Malicious
10.0.2.15,41729,119.254.87.201,80,11,1513,6,705,5,808,24546.84693,0.825868,6829.178513,7826.91665,Malicious
10.0.2.15,45021,119.254.87.201,80,11,1582,6,705,5,877,24549.44963,1.428169,3949.112465,4912.583875,Malicious
10.0.2.15,33486,119.254.87.201,80,11,1582,6,705,5,877,24574.01234,2.148978,2624.503369,3264.807737,Malicious
10.0.2.15,59562,119.254.87.201,80,11,1569,6,705,5,864,24576.87434,2.282028,2471.485889,3028.884834,Malicious
10.0.2.15,44987,119.254.87.201,80,11,1579,6,705,5,874,24579.45954,5.101984,1105.45231,1370.447261,Malicious
10.0.2.15,47293,119.254.87.201,80,11,1582,6,705,5,877,24604.02207,1.321889,4266.621479,5307.556081,Malicious
10.0.2.15,42435,119.254.87.201,80,11,1561,6,705,5,856,24606.91322,1.548901,3641.291471,4421.199289,Malicious
10.0.2.15,47680,119.254.87.201,80,11,1582,6,705,5,877,24609.50866,0.917516,6147.031768,7646.733136,Malicious
10.0.2.15,51326,119.254.87.201,80,11,1579,6,705,5,874,24634.01446,0.993211,5678.551687,7039.793156,Malicious
10.0.2.15,43266,119.254.87.201,80,11,1587,6,705,5,882,24636.9689,6.260953,900.8213286,1126.984981,Malicious
10.0.2.15,59552,119.254.87.201,80,11,1579,6,705,5,874,24639.56902,0.900778,6261.25416,7762.178916,Malicious
10.0.2.15,58379,119.254.87.201,80,11,1579,6,705,5,874,24664.04888,2.2785,2475.312706,3068.685539,Malicious
10.0.2.15,50438,119.254.87.201,80,11,1513,6,705,5,808,24667.03253,2.091908,2696.10327,3090.002046,Malicious
10.0.2.15,38499,119.254.87.201,80,11,1569,6,705,5,864,24669.56778,2.220807,2539.617355,3112.382121,Malicious
10.0.2.15,40099,119.254.87.201,80,11,1579,6,705,5,874,24694.07792,2.110168,2672.772974,3313.480254,Malicious
10.0.2.15,44389,119.254.87.201,80,11,1582,6,705,5,877,24697.08941,2.276736,2477.230562,3081.604543,Malicious
10.0.2.15,42432,119.254.87.201,80,11,1582,6,705,5,877,24699.60455,2.127729,2650.713507,3297.412405,Malicious
10.0.2.15,54603,119.254.87.201,80,11,1579,6,705,5,874,24724.08467,2.250093,2506.563062,3107.427115,Malicious
10.0.2.15,39542,119.254.87.201,80,11,1579,6,705,5,874,24727.11126,2.019691,2792.506378,3461.915709,Malicious
10.0.2.15,44968,119.254.87.201,80,11,1582,6,705,5,877,24729.6365,2.142382,2632.583732,3274.859479,Malicious
10.0.2.15,36346,119.254.87.201,80,11,1582,6,705,5,877,24754.13537,2.487102,2267.699515,2820.953865,Malicious
10.0.2.15,46885,119.254.87.201,80,11,1579,6,705,5,874,24757.27015,1.29744,4347.021828,5389.073869,Malicious
10.0.2.15,51180,119.254.87.201,80,12,1587,7,779,5,808,24759.68707,7.338635,849.2042457,880.8177543,Malicious
10.0.2.15,37842,119.254.87.201,80,11,1513,6,705,5,808,24784.16281,2.084384,2705.835393,3101.156025,Malicious
10.0.2.15,57396,119.254.87.201,80,11,1579,6,705,5,874,24787.1505,2.025706,2784.214491,3451.636121,Malicious
10.0.2.15,34292,119.254.87.201,80,11,1579,6,705,5,874,24789.74764,2.059696,2738.268172,3394.675719,Malicious
10.0.2.15,48552,119.254.87.201,80,11,1513,6,705,5,808,24814.22744,0.822407,6857.918281,7859.855278,Malicious
10.0.2.15,43059,119.254.87.201,80,11,1579,6,705,5,874,24817.22357,1.108303,5088.861079,6308.744089,Malicious
10.0.2.15,39909,119.254.87.201,80,11,1579,6,705,5,874,24819.77585,1.023149,5512.393601,6833.804265,Malicious
10.0.2.15,50904,119.254.87.201,80,11,1579,6,705,5,874,24844.26349,1.089066,5178.749497,6420.180228,Malicious
10.0.2.15,39583,119.254.87.201,80,11,1559,6,705,5,854,24847.25759,0.817058,6902.814733,8361.707492,Malicious
10.0.2.15,60710,119.254.87.201,80,11,1582,6,705,5,877,24849.80177,1.547914,3643.613276,4532.55155,Malicious
10.0.2.15,54155,119.254.87.201,80,11,1579,6,705,5,874,24874.28835,2.02886,2779.886242,3446.270319,Malicious
10.0.2.15,57367,119.254.87.201,80,11,1582,6,705,5,877,24877.28529,2.088981,2699.880947,3358.575305,Malicious
10.0.2.15,37688,119.254.87.201,80,11,1544,6,705,5,839,24879.82989,2.152471,2620.244361,3118.276623,Malicious
10.0.2.15,33543,119.254.87.201,80,11,1513,6,705,5,808,24904.34865,2.11424,2667.625246,3057.363402,Malicious
10.0.2.15,35981,119.254.87.201,80,11,1579,6,705,5,874,24907.31042,2.020546,2791.324721,3460.450789,Malicious
10.0.2.15,48071,119.254.87.201,80,11,1579,6,705,5,874,24909.83566,2.195459,2568.938887,3184.755443,Malicious
10.0.2.15,40592,119.254.87.201,80,11,1582,6,705,5,877,24934.37309,3.701632,1523.65227,1895.3802,Malicious
10.0.2.15,54744,119.254.87.201,80,12,1587,7,779,5,808,24937.34058,5.090198,1224.313868,1269.891662,Malicious
10.0.2.15,37229,119.254.87.201,80,11,1582,6,705,5,877,24939.83831,2.194515,2570.04395,3197.061765,Malicious
10.0.2.15,46538,119.254.87.201,80,11,1582,6,705,5,877,24964.40225,1.3612,4143.40288,5154.275639,Malicious
10.0.2.15,40405,119.254.87.201,80,11,1582,6,705,5,877,24967.40011,1.017264,5544.28349,6896.931377,Malicious
10.0.2.15,49659,119.254.87.201,80,11,1513,6,705,5,808,24969.96259,0.986959,5714.523096,6549.410867,Malicious
10.0.2.15,45986,119.254.87.201,80,11,1579,6,705,5,874,24994.43106,2.092922,2694.797035,3340.783842,Malicious
10.0.2.15,39948,119.254.87.201,80,11,1582,6,705,5,877,24997.42923,2.021807,2789.583773,3470.163077,Malicious
10.0.2.15,59687,119.254.87.201,80,12,1653,7,779,5,874,24999.89418,14.466284,430.7948054,483.3307572,Malicious
10.0.2.15,47373,119.254.87.201,80,11,1582,6,705,5,877,25024.45818,1.051555,5363.485505,6672.023812,Malicious
10.0.2.15,49047,119.254.87.201,80,11,1582,6,705,5,877,25027.48833,7.863616,717.2272909,892.2104029,Malicious
10.0.2.15,48575,119.254.87.201,80,11,1582,6,705,5,877,25029.8961,1.033783,5455.690411,6786.7241,Malicious
10.0.2.15,39998,119.254.87.201,80,11,1513,6,705,5,808,25054.48318,1.653178,3411.610849,3910.044774,Malicious
10.0.2.15,39654,119.254.87.201,80,11,1560,6,705,5,855,25057.51405,2.410978,2339.299654,2837.022984,Malicious
10.0.2.15,37627,119.254.87.201,80,11,1513,6,705,5,808,25059.93637,0.891157,6328.851145,7253.491809,Malicious
10.0.2.15,40512,119.254.87.201,80,11,1582,6,705,5,877,25084.52516,0.820947,6870.114636,8546.22771,Malicious
10.0.2.15,44740,119.254.87.201,80,11,1582,6,705,5,877,25087.51882,1.356368,4158.163566,5172.637514,Malicious
10.0.2.15,39345,119.254.87.201,80,11,1582,6,705,5,877,25089.91665,0.823715,6847.028402,8517.50909,Malicious
10.0.2.15,36096,119.254.87.201,80,11,1552,6,705,5,847,25114.5472,1.091689,5166.306521,6206.89592,Malicious
10.0.2.15,51678,119.254.87.201,80,11,1582,6,705,5,877,25117.54173,0.825135,6835.245142,8502.851049,Malicious
10.0.2.15,54703,119.254.87.201,80,11,1579,6,705,5,874,25119.9455,1.187414,4749.817671,5888.426446,Malicious
10.0.2.15,58530,119.254.87.201,80,11,1582,6,705,5,877,25144.58797,4.4826,1258.198367,1565.163075,Malicious
10.0.2.15,55691,119.254.87.201,80,11,1551,6,705,5,846,25147.57663,2.089871,2698.731166,3238.477399,Malicious
10.0.2.15,49254,119.254.87.201,80,11,1560,6,705,5,855,25149.97502,2.113555,2668.489819,3236.253611,Malicious
10.0.2.15,45018,119.254.87.201,80,11,1579,6,705,5,874,25174.63529,4.601976,1225.560498,1519.347341,Malicious
10.0.2.15,58613,119.254.87.201,80,11,1534,6,705,5,829,25177.63564,5.071594,1112.0764,1307.675654,Malicious
10.0.2.15,58314,119.254.87.201,80,11,1582,6,705,5,877,25180.00965,2.233686,2524.974414,3140.996541,Malicious
10.0.2.15,52544,119.254.87.201,80,11,1579,6,705,5,874,25204.66454,2.089489,2699.224547,3346.272701,Malicious
10.0.2.15,33422,119.254.87.201,80,11,1579,6,705,5,874,25207.66201,2.054961,2744.577634,3402.497663,Malicious
10.0.2.15,53652,119.254.87.201,80,11,1579,6,705,5,874,25210.03353,2.149414,2623.970999,3252.979649,Malicious
10.0.2.15,60758,119.254.87.201,80,11,1582,6,705,5,877,25234.66761,0.820963,6869.980742,8546.06115,Malicious
10.0.2.15,38378,119.254.87.201,80,11,1579,6,705,5,874,25237.66318,1.356458,4157.887675,5154.601175,Malicious
10.0.2.15,34424,119.254.87.201,80,12,1653,7,779,5,874,25240.06229,3.785473,1646.293607,1847.06112,Malicious
10.0.2.15,34398,119.254.87.201,80,12,1628,7,779,5,849,25264.6771,4.001465,1557.429591,1697.378335,Malicious
10.0.2.15,35427,119.254.87.201,80,11,1579,6,705,5,874,25267.70241,0.97599,5778.747733,7164.007828,Malicious
10.0.2.15,46379,119.254.87.201,80,11,1579,6,705,5,874,25270.11862,1.354747,4163.138948,5161.111263,Malicious
10.0.2.15,47240,119.254.87.201,80,11,1582,6,705,5,877,25294.68618,1.222788,4612.410328,5737.707599,Malicious
10.0.2.15,47751,119.254.87.201,80,11,1579,6,705,5,874,25297.84514,1.250809,4509.081722,5589.982164,Malicious
10.0.2.15,37012,119.254.87.201,80,11,1582,6,705,5,877,25300.13092,1.085141,5197.481249,6465.519227,Malicious
10.0.2.15,39231,119.254.87.201,80,11,1582,6,705,5,877,25324.72353,1.058134,5330.137771,6630.540177,Malicious
10.0.2.15,50719,119.254.87.201,80,11,1582,6,705,5,877,25327.81351,0.896225,6293.062568,7828.391308,Malicious
10.0.2.15,54921,119.254.87.201,80,11,1579,6,705,5,874,25330.14836,1.251316,4507.254762,5587.717251,Malicious
10.0.2.15,50334,119.254.87.201,80,11,1579,6,705,5,874,25354.74466,3.952828,1426.826566,1768.860168,Malicious
10.0.2.15,59818,119.254.87.201,80,11,1579,6,705,5,874,25357.93942,2.840111,1985.837877,2461.87561,Malicious
10.0.2.15,57541,119.254.87.201,80,11,1579,6,705,5,874,25360.20507,0.856368,6585.953702,8164.714235,Malicious
10.0.2.15,37418,119.254.87.201,80,11,1579,6,705,5,874,25384.756,2.018101,2794.706509,3464.643246,Malicious
10.0.2.15,52954,119.254.87.201,80,11,1582,6,705,5,877,25387.87419,2.097841,2688.478297,3344.390733,Malicious
10.0.2.15,53146,119.254.87.201,80,11,1582,6,705,5,877,25390.21085,11.098523,508.1757275,632.1561887,Malicious
10.0.2.15,33719,119.254.87.201,80,11,1513,6,705,5,808,25414.7775,0.8933,6313.66842,7236.090899,Malicious
10.0.2.15,33933,119.254.87.201,80,11,1513,6,705,5,808,25417.90266,0.890157,6335.96096,7261.640362,Malicious
10.0.2.15,51954,119.254.87.201,80,11,1582,6,705,5,877,25420.23306,1.223692,4609.002919,5733.468879,Malicious
10.0.2.15,46978,119.254.87.201,80,11,1579,6,705,5,874,25444.8075,0.898023,6280.46275,7785.992118,Malicious
10.0.2.15,56087,119.254.87.201,80,12,1656,7,779,5,877,25447.93111,4.308419,1446.470271,1628.439574,Malicious
10.0.2.15,55393,119.254.87.201,80,11,1579,6,705,5,874,25450.25841,1.206495,4674.698196,5795.299608,Malicious
10.0.2.15,44464,119.254.87.201,80,11,1579,6,705,5,874,25474.8664,1.028716,5482.562729,6796.822447,Malicious
10.0.2.15,55571,119.254.87.201,80,11,1513,6,705,5,808,25477.98956,1.095524,5148.221308,5900.37279,Malicious
10.0.2.15,41753,119.254.87.201,80,11,1579,6,705,5,874,25480.26187,0.817334,6900.483768,8554.642288,Malicious
10.0.2.15,47335,119.254.87.201,80,11,1579,6,705,5,874,25504.92811,5.145868,1096.025005,1358.760077,Malicious
10.0.2.15,37359,119.254.87.201,80,11,1582,6,705,5,877,25508.03851,2.035321,2771.061665,3447.1221,Malicious
10.0.2.15,58441,119.254.87.201,80,11,1513,6,705,5,808,25510.31862,5.054308,1115.87976,1278.909002,Malicious
10.0.2.15,39309,119.254.87.201,80,11,1582,6,705,5,877,25534.98935,0.827136,6818.709378,8482.281028,Malicious
10.0.2.15,49948,119.254.87.201,80,11,1552,6,705,5,847,25538.04933,0.887264,6356.619901,7636.960364,Malicious
10.0.2.15,54517,119.254.87.201,80,11,1552,6,705,5,847,25540.38047,0.825152,6835.10432,8211.820368,Malicious
10.0.2.15,33746,119.254.87.201,80,11,1579,6,705,5,874,25565.03633,1.290863,4369.170082,5416.531421,Malicious
10.0.2.15,59062,119.254.87.201,80,11,1582,6,705,5,877,25568.09847,1.225693,4601.478511,5724.108729,Malicious
10.0.2.15,60073,119.254.87.201,80,11,1582,6,705,5,877,25570.43643,0.934859,6032.99535,7504.875067,Malicious
10.0.2.15,42120,119.254.87.201,80,11,1582,6,705,5,877,25595.0428,0.822058,6860.829771,8534.677602,Malicious
10.0.2.15,37465,119.254.87.201,80,11,1513,6,705,5,808,25598.10195,0.952141,5923.492424,6788.910466,Malicious
10.0.2.15,34222,119.254.87.201,80,11,1579,6,705,5,874,25600.49776,0.822219,6859.486341,8503.81711,Malicious
10.0.2.15,40118,119.254.87.201,80,11,1579,6,705,5,874,25625.10557,2.015106,2798.860209,3469.792656,Malicious
10.0.2.15,49206,119.254.87.201,80,11,1579,6,705,5,874,25628.16027,2.020354,2791.589989,3460.779646,Malicious
10.0.2.15,40859,119.254.87.201,80,11,1582,6,705,5,877,25630.55615,2.056496,2742.52904,3411.628323,Malicious
10.0.2.15,38988,119.254.87.201,80,11,1582,6,705,5,877,25655.15732,2.025955,2783.872297,3463.058163,Malicious
10.0.2.15,60545,119.254.87.201,80,11,1579,6,705,5,874,25658.1595,1.958943,2879.10368,3569.271796,Malicious
10.0.2.15,47979,119.254.87.201,80,11,1569,6,705,5,864,25660.55866,1.955722,2883.845455,3534.244642,Malicious
10.0.2.15,42204,119.254.87.201,80,11,1513,6,705,5,808,25685.19738,2.021528,2789.968776,3197.581236,Malicious
10.0.2.15,56337,119.254.87.201,80,11,1582,6,705,5,877,25688.18728,1.958745,2879.394714,3581.88534,Malicious
10.0.2.15,34998,119.254.87.201,80,11,1579,6,705,5,874,25690.58592,2.055116,2744.370634,3402.241041,Malicious
10.0.2.15,60277,119.254.87.201,80,11,1582,6,705,5,877,25715.25454,2.019045,2793.39985,3474.910168,Malicious
10.0.2.15,55760,119.254.87.201,80,11,1582,6,705,5,877,25718.24719,2.024595,2785.742334,3465.384435,Malicious
10.0.2.15,51261,119.254.87.201,80,11,1582,6,705,5,877,25720.64755,1.949147,2893.573445,3599.523279,Malicious
10.0.2.15,58158,119.254.87.201,80,11,1579,6,705,5,874,25745.27489,2.092394,2695.477047,3341.626864,Malicious
10.0.2.15,60454,119.254.87.201,80,11,1513,6,705,5,808,25748.27573,2.016716,2796.625802,3205.210848,Malicious
10.0.2.15,47252,119.254.87.201,80,11,1579,6,705,5,874,25750.67172,4.049739,1392.682343,1726.531018,Malicious
10.0.2.15,52688,119.254.87.201,80,11,1579,6,705,5,874,25775.33823,3.528779,1598.286546,1981.421903,Malicious
10.0.2.15,39872,119.254.87.201,80,11,1579,6,705,5,874,25778.33749,5.112601,1103.156691,1367.601344,Malicious
10.0.2.15,54657,119.254.87.201,80,12,1653,7,779,5,874,25780.70974,9.875624,631.0487317,708.0058941,Malicious
10.0.2.15,52352,119.254.87.201,80,11,1579,6,705,5,874,25805.36977,2.107896,2675.653827,3317.051695,Malicious
10.0.2.15,41086,119.254.87.201,80,11,1579,6,705,5,874,25808.37382,2.021902,2789.452703,3458.130018,Malicious
10.0.2.15,58049,119.254.87.201,80,11,1579,6,705,5,874,25810.76877,2.048071,2753.810781,3413.944145,Malicious
10.0.2.15,44320,119.254.87.201,80,11,1579,6,705,5,874,25835.42512,2.023224,2787.63004,3455.870433,Malicious
10.0.2.15,57952,119.254.87.201,80,11,1579,6,705,5,874,25838.42345,2.087942,2701.224459,3348.752025,Malicious
10.0.2.15,60782,119.254.87.201,80,11,1513,6,705,5,808,25840.82013,2.018327,2794.393574,3202.652494,Malicious
10.0.2.15,42457,119.254.87.201,80,11,1593,6,705,5,888,25865.48472,0.905343,6229.683115,7846.749795,Malicious
10.0.2.15,49256,119.254.87.201,80,11,1582,6,705,5,877,25868.42568,1.220399,4621.439382,5748.939486,Malicious
10.0.2.15,37056,119.254.87.201,80,11,1579,6,705,5,874,25870.87953,1.401685,4023.728584,4988.281961,Malicious
10.0.2.15,47618,119.254.87.201,80,11,1579,6,705,5,874,25895.54194,1.230805,4582.366825,5680.834901,Malicious
10.0.2.15,48267,119.254.87.201,80,11,1513,6,705,5,808,25898.48072,1.34812,4183.603833,4794.825386,Malicious
10.0.2.15,39728,119.254.87.201,80,11,1582,6,705,5,877,25900.9384,0.8295,6799.276673,8458.107294,Malicious
10.0.2.15,33127,119.254.87.201,80,11,1513,6,705,5,808,25925.57231,1.298121,4344.741361,4979.504992,Malicious
10.0.2.15,54307,119.254.87.201,80,11,1579,6,705,5,874,25928.50831,1.222155,4614.799269,5721.04193,Malicious
10.0.2.15,44475,119.254.87.201,80,11,1582,6,705,5,877,25930.9691,1.388459,4062.057288,5053.084031,Malicious
10.0.2.15,40451,119.254.87.201,80,11,1593,6,705,5,888,25955.6313,0.827879,6812.589763,8580.964126,Malicious
10.0.2.15,33123,119.254.87.201,80,11,1582,6,705,5,877,25958.70608,0.970134,5813.62987,7231.990632,Malicious
10.0.2.15,41907,119.254.87.201,80,11,1582,6,705,5,877,25960.99789,0.822395,6858.018349,8531.180272,Malicious
10.0.2.15,37918,119.254.87.201,80,11,1582,6,705,5,877,25985.68128,0.879619,6411.866956,7976.180596,Malicious
10.0.2.15,35164,119.254.87.201,80,11,1582,6,705,5,877,25988.60572,1.231198,4580.904128,5698.51478,Malicious
10.0.2.15,42227,119.254.87.201,80,11,1579,6,705,5,874,25990.99986,0.933167,6043.934258,7492.763889,Malicious
10.0.2.15,46211,119.254.87.201,80,11,1579,6,705,5,874,26015.72407,1.228492,4590.994488,5691.530755,Malicious
10.0.2.15,58234,119.254.87.201,80,11,1582,6,705,5,877,26018.65944,1.347094,4186.790231,5208.248274,Malicious
10.0.2.15,40929,119.254.87.201,80,12,1634,7,779,5,855,26021.05167,3.853096,1617.400657,1775.195843,Malicious
10.0.2.15,47531,119.254.87.201,80,11,1582,6,705,5,877,26045.75111,0.89311,6315.011589,7855.695267,Malicious
10.0.2.15,55387,119.254.87.201,80,11,1579,6,705,5,874,26048.686,0.828317,6808.98738,8441.212724,Malicious
10.0.2.15,41092,119.254.87.201,80,11,1554,6,705,5,849,26051.08387,0.86653,6508.718683,7838.159094,Malicious
10.0.2.15,34882,119.254.87.201,80,11,1579,6,705,5,874,26075.77011,0.827829,6813.001236,8446.188766,Malicious
10.0.2.15,41829,119.254.87.201,80,11,1582,6,705,5,877,26078.69252,0.893455,6312.573101,7852.661858,Malicious
10.0.2.15,58810,119.254.87.201,80,11,1582,6,705,5,877,26081.08761,0.818485,6890.779917,8571.934733,Malicious
10.0.2.15,33297,119.254.87.201,80,11,1582,6,705,5,877,26105.78458,0.886033,6365.4514,7918.440961,Malicious
10.0.2.15,37853,119.254.87.201,80,11,1579,6,705,5,874,26108.71792,1.220783,4619.985698,5727.471631,Malicious
10.0.2.15,54499,119.254.87.201,80,11,1582,6,705,5,877,26111.10899,1.331742,4235.054538,5268.287701,Malicious
10.0.2.15,47215,119.254.87.201,80,11,1579,6,705,5,874,26135.83386,1.496485,3768.831629,4672.282048,Malicious
10.0.2.15,49851,119.254.87.201,80,11,1582,6,705,5,877,26138.77129,0.880101,6408.355405,7971.812326,Malicious
10.0.2.15,34962,119.254.87.201,80,11,1585,6,705,5,880,26141.14851,1.36194,4141.151593,5169.097023,Malicious
10.0.2.15,42261,119.254.87.201,80,11,1582,6,705,5,877,26165.85545,1.423487,3962.101516,4928.741885,Malicious
10.0.2.15,57632,119.254.87.201,80,12,1587,7,779,5,808,26168.78314,3.914979,1591.834848,1651.094425,Malicious
10.0.2.15,43286,119.254.87.201,80,11,1579,6,705,5,874,26171.21582,1.349303,4179.935863,5181.934673,Malicious
10.0.2.15,44959,119.254.87.201,80,11,1582,6,705,5,877,26195.90245,1.293231,4361.169814,5425.171528,Malicious
10.0.2.15,38906,119.254.87.201,80,11,1579,6,705,5,874,26198.83282,0.892959,6316.079462,7830.146737,Malicious
10.0.2.15,59425,119.254.87.201,80,11,1582,6,705,5,877,26201.23031,0.816508,6907.464471,8592.689845,Malicious
10.0.2.15,54031,119.254.87.201,80,11,1587,6,705,5,882,26225.95052,1.086859,5189.265581,6492.102471,Malicious
10.0.2.15,34885,119.254.87.201,80,11,1587,6,705,5,882,26228.89024,1.224104,4607.451654,5764.216112,Malicious
10.0.2.15,36193,119.254.87.201,80,11,1582,6,705,5,877,26231.28776,8.048953,700.7122541,871.6661658,Malicious
10.0.2.15,56117,119.254.87.201,80,11,1579,6,705,5,874,26255.98918,1.017891,5540.868325,6869.104845,Malicious
10.0.2.15,40890,119.254.87.201,80,11,1582,6,705,5,877,26258.91955,1.287584,4380.296742,5448.964883,Malicious
10.0.2.15,50493,119.254.87.201,80,11,1582,6,705,5,877,26261.31607,1.488167,3789.897236,4714.524647,Malicious
10.0.2.15,33304,119.254.87.201,80,11,1582,6,705,5,877,26286.01317,5.306148,1062.917959,1322.239787,Malicious
10.0.2.15,40037,119.254.87.201,80,11,1582,6,705,5,877,26288.98225,2.179706,2587.50492,3218.782717,Malicious
10.0.2.15,38745,119.254.87.201,80,11,1593,6,705,5,888,26291.34182,5.088085,1108.472048,1396.20309,Malicious
10.0.2.15,54537,119.254.87.201,80,11,1579,6,705,5,874,26316.06629,0.819177,6884.958928,8535.395891,Malicious
10.0.2.15,55976,119.254.87.201,80,11,1582,6,705,5,877,26318.9828,1.360703,4144.916268,5156.158251,Malicious
10.0.2.15,41036,119.254.87.201,80,11,1582,6,705,5,877,26321.37689,0.817707,6897.336087,8580.090424,Malicious
10.0.2.15,58495,119.254.87.201,80,11,1593,6,705,5,888,26346.09268,3.610679,1562.033069,1967.496972,Malicious
10.0.2.15,39809,119.254.87.201,80,11,1582,6,705,5,877,26349.03129,2.018866,2793.647523,3475.218266,Malicious
10.0.2.15,58336,119.254.87.201,80,11,1561,6,705,5,856,26351.43262,2.061671,2735.645018,3321.577497,Malicious
10.0.2.15,33519,119.254.87.201,80,11,1582,6,705,5,877,26376.09659,1.226288,4599.245854,5721.331368,Malicious
10.0.2.15,50667,119.254.87.201,80,11,1582,6,705,5,877,26379.0918,0.894083,6308.139177,7847.146182,Malicious
10.0.2.15,35750,119.254.87.201,80,11,1582,6,705,5,877,26381.49439,1.420613,3970.117125,4938.713077,Malicious
10.0.2.15,58958,119.254.87.201,80,11,1582,6,705,5,877,26406.15146,0.896084,6294.05279,7829.623116,Malicious
10.0.2.15,35985,119.254.87.201,80,11,1582,6,705,5,877,26409.15415,0.82845,6807.89426,8468.827328,Malicious
10.0.2.15,44533,119.254.87.201,80,11,1513,6,705,5,808,26411.5562,0.861466,6546.979219,7503.48824,Malicious
10.0.2.15,52725,119.254.87.201,80,11,1582,6,705,5,877,26436.17692,2.017362,2795.730266,3477.809139,Malicious
10.0.2.15,47534,119.254.87.201,80,11,1582,6,705,5,877,26439.16321,2.084104,2706.198923,3366.434688,Malicious
10.0.2.15,34757,119.254.87.201,80,11,1579,6,705,5,874,26441.61713,2.022235,2788.993366,3457.56057,Malicious
10.0.2.15,50648,119.254.87.201,80,11,1582,6,705,5,877,26466.18356,1.292352,4364.136087,5428.861487,Malicious
10.0.2.15,33812,119.254.87.201,80,11,1582,6,705,5,877,26469.17856,0.832432,6775.328195,8428.316067,Malicious
10.0.2.15,40886,119.254.87.201,80,11,1582,6,705,5,877,26471.64571,1.321344,4268.381285,5309.745229,Malicious
10.0.2.15,58177,119.254.87.201,80,11,1568,6,705,5,863,26496.23898,1.223642,4609.19125,5642.173119,Malicious
10.0.2.15,58712,119.254.87.201,80,11,1579,6,705,5,874,26499.23491,0.947784,5950.72295,7377.208309,Malicious
10.0.2.15,58079,119.254.87.201,80,11,1582,6,705,5,877,26501.6982,0.826656,6822.66868,8487.206287,Malicious
10.0.2.15,35932,119.254.87.201,80,11,1593,6,705,5,888,26526.26826,2.088996,2699.86156,3400.676689,Malicious
10.0.2.15,50749,119.254.87.201,80,11,1579,6,705,5,874,26529.26391,2.033453,2773.607258,3438.486161,Malicious
10.0.2.15,43611,119.254.87.201,80,12,1608,7,779,5,829,26531.73623,5.108214,1219.995873,1298.301128,Malicious
10.0.2.15,33640,119.254.87.201,80,11,1582,6,705,5,877,26556.33413,0.820863,6870.817664,8547.102257,Malicious
